Area of Residence,Year,Age at Death,Female,Male,_Total
Arklow Town,2007,1 - 4 years,0,0,0
Arklow Town,2007,10 - 14 years,0,0,0
Arklow Town,2007,15 - 19 years,0,0,0
Arklow Town,2007,20 - 24 years,0,2,2
Arklow Town,2007,25 - 29 years,1,0,1
Arklow Town,2007,30 - 34 years,0,1,1
Arklow Town,2007,35 - 39 years,1,2,3
Arklow Town,2007,40 - 44 years,0,0,0
Arklow Town,2007,45 - 49 years,1,0,1
Arklow Town,2007,5 - 9 years,0,0,0
Arklow Town,2007,50 - 54 years,0,2,2
Arklow Town,2007,55 - 59 years,2,1,3
Arklow Town,2007,60 - 64 years,1,2,3
Arklow Town,2007,65 - 69 years,4,7,11
Arklow Town,2007,70 - 74 years,8,9,17
Arklow Town,2007,75 - 79 years,7,10,17
Arklow Town,2007,80 - 84 years,10,9,19
Arklow Town,2007,85 years and over,16,8,24
Arklow Town,2007,Under 1 year,0,0,0
Arklow Town,2008,1 - 4 years,0,0,0
Arklow Town,2008,10 - 14 years,0,0,0
Arklow Town,2008,15 - 19 years,0,1,1
Arklow Town,2008,20 - 24 years,1,1,2
Arklow Town,2008,25 - 29 years,1,0,1
Arklow Town,2008,30 - 34 years,0,1,1
Arklow Town,2008,35 - 39 years,2,1,3
Arklow Town,2008,40 - 44 years,3,1,4
Arklow Town,2008,45 - 49 years,1,2,3
Arklow Town,2008,5 - 9 years,0,1,1
Arklow Town,2008,50 - 54 years,2,1,3
Arklow Town,2008,55 - 59 years,4,1,5
Arklow Town,2008,60 - 64 years,1,6,7
Arklow Town,2008,65 - 69 years,4,3,7
Arklow Town,2008,70 - 74 years,1,6,7
Arklow Town,2008,75 - 79 years,2,7,9
Arklow Town,2008,80 - 84 years,7,11,18
Arklow Town,2008,85 years and over,11,8,19
Arklow Town,2008,Under 1 year,0,1,1
Arklow Town,2009,1 - 4 years,0,0,0
Arklow Town,2009,10 - 14 years,0,0,0
Arklow Town,2009,15 - 19 years,1,1,2
Arklow Town,2009,20 - 24 years,1,1,2
Arklow Town,2009,25 - 29 years,1,1,2
Arklow Town,2009,30 - 34 years,0,1,1
Arklow Town,2009,35 - 39 years,2,1,3
Arklow Town,2009,40 - 44 years,3,2,5
Arklow Town,2009,45 - 49 years,3,2,5
Arklow Town,2009,5 - 9 years,0,1,1
Arklow Town,2009,50 - 54 years,1,1,2
Arklow Town,2009,55 - 59 years,4,2,6
Arklow Town,2009,60 - 64 years,1,1,2
Arklow Town,2009,65 - 69 years,1,3,4
Arklow Town,2009,70 - 74 years,2,3,5
Arklow Town,2009,75 - 79 years,10,1,11
Arklow Town,2009,80 - 84 years,8,6,14
Arklow Town,2009,85 years and over,11,8,19
Arklow Town,2009,Under 1 year,1,1,2
Arklow Town,2010,1 - 4 years,0,0,0
Arklow Town,2010,10 - 14 years,0,0,0
Arklow Town,2010,15 - 19 years,1,1,2
Arklow Town,2010,20 - 24 years,1,1,2
Arklow Town,2010,25 - 29 years,1,1,2
Arklow Town,2010,30 - 34 years,0,1,1
Arklow Town,2010,35 - 39 years,2,1,3
Arklow Town,2010,40 - 44 years,3,2,5
Arklow Town,2010,45 - 49 years,3,1,4
Arklow Town,2010,5 - 9 years,0,1,1
Arklow Town,2010,50 - 54 years,1,1,2
Arklow Town,2010,55 - 59 years,4,2,6
Arklow Town,2010,60 - 64 years,1,1,2
Arklow Town,2010,65 - 69 years,1,1,2
Arklow Town,2010,70 - 74 years,2,5,7
Arklow Town,2010,75 - 79 years,4,4,8
Arklow Town,2010,80 - 84 years,4,4,8
Arklow Town,2010,85 years and over,10,2,12
Arklow Town,2010,Under 1 year,2,1,3
Arklow Town,2011,1 - 4 years,0,0,0
Arklow Town,2011,10 - 14 years,0,0,0
Arklow Town,2011,15 - 19 years,0,0,0
Arklow Town,2011,20 - 24 years,0,2,2
Arklow Town,2011,25 - 29 years,0,0,0
Arklow Town,2011,30 - 34 years,2,1,3
Arklow Town,2011,35 - 39 years,0,0,0
Arklow Town,2011,40 - 44 years,1,0,1
Arklow Town,2011,45 - 49 years,0,0,0
Arklow Town,2011,5 - 9 years,0,0,0
Arklow Town,2011,50 - 54 years,3,2,5
Arklow Town,2011,55 - 59 years,1,3,4
Arklow Town,2011,60 - 64 years,2,5,7
Arklow Town,2011,65 - 69 years,3,6,9
Arklow Town,2011,70 - 74 years,4,4,8
Arklow Town,2011,75 - 79 years,1,7,8
Arklow Town,2011,80 - 84 years,6,5,11
Arklow Town,2011,85 years and over,11,1,12
Arklow Town,2011,Under 1 year,0,1,1
Arklow Town,2012,1 - 4 years,0,0,0
Arklow Town,2012,10 - 14 years,0,0,0
Arklow Town,2012,15 - 19 years,0,1,1
Arklow Town,2012,20 - 24 years,0,2,2
Arklow Town,2012,25 - 29 years,0,1,1
Arklow Town,2012,30 - 34 years,2,1,3
Arklow Town,2012,35 - 39 years,0,0,0
Arklow Town,2012,40 - 44 years,1,1,2
Arklow Town,2012,45 - 49 years,1,2,3
Arklow Town,2012,5 - 9 years,0,0,0
Arklow Town,2012,50 - 54 years,2,2,4
Arklow Town,2012,55 - 59 years,2,2,4
Arklow Town,2012,60 - 64 years,2,2,4
Arklow Town,2012,65 - 69 years,4,9,13
Arklow Town,2012,70 - 74 years,4,4,8
Arklow Town,2012,75 - 79 years,5,9,14
Arklow Town,2012,80 - 84 years,7,8,15
Arklow Town,2012,85 years and over,13,7,20
Arklow Town,2012,Under 1 year,0,1,1
Arklow Town,2013,1 - 4 years,0,1,1
Arklow Town,2013,10 - 14 years,0,0,0
Arklow Town,2013,15 - 19 years,0,0,0
Arklow Town,2013,20 - 24 years,0,0,0
Arklow Town,2013,25 - 29 years,0,1,1
Arklow Town,2013,30 - 34 years,0,0,0
Arklow Town,2013,35 - 39 years,0,0,0
Arklow Town,2013,40 - 44 years,1,0,1
Arklow Town,2013,45 - 49 years,1,1,2
Arklow Town,2013,5 - 9 years,0,0,0
Arklow Town,2013,50 - 54 years,2,2,4
Arklow Town,2013,55 - 59 years,2,4,6
Arklow Town,2013,60 - 64 years,2,6,8
Arklow Town,2013,65 - 69 years,4,1,5
Arklow Town,2013,70 - 74 years,6,9,15
Arklow Town,2013,75 - 79 years,3,5,8
Arklow Town,2013,80 - 84 years,7,6,13
Arklow Town,2013,85 years and over,16,2,18
Arklow Town,2013,Under 1 year,0,0,0
Arklow Town,2014,1 - 4 years,0,1,1
Arklow Town,2014,10 - 14 years,0,0,0
Arklow Town,2014,15 - 19 years,0,0,0
Arklow Town,2014,20 - 24 years,1,0,1
Arklow Town,2014,25 - 29 years,1,1,2
Arklow Town,2014,30 - 34 years,0,1,1
Arklow Town,2014,35 - 39 years,0,0,0
Arklow Town,2014,40 - 44 years,1,2,3
Arklow Town,2014,45 - 49 years,1,1,2
Arklow Town,2014,5 - 9 years,0,0,0
Arklow Town,2014,50 - 54 years,1,2,3
Arklow Town,2014,55 - 59 years,2,2,4
Arklow Town,2014,60 - 64 years,2,2,4
Arklow Town,2014,65 - 69 years,4,2,6
Arklow Town,2014,70 - 74 years,1,3,4
Arklow Town,2014,75 - 79 years,7,6,13
Arklow Town,2014,80 - 84 years,4,10,14
Arklow Town,2014,85 years and over,16,10,26
Arklow Town,2014,Under 1 year,1,1,2
Arklow Town,2015,1 - 4 years,0,1,1
Arklow Town,2015,10 - 14 years,0,0,0
Arklow Town,2015,15 - 19 years,0,0,0
Arklow Town,2015,20 - 24 years,1,0,1
Arklow Town,2015,25 - 29 years,1,1,2
Arklow Town,2015,30 - 34 years,0,1,1
Arklow Town,2015,35 - 39 years,0,0,0
Arklow Town,2015,40 - 44 years,1,2,3
Arklow Town,2015,45 - 49 years,1,1,2
Arklow Town,2015,5 - 9 years,0,0,0
Arklow Town,2015,50 - 54 years,1,2,3
Arklow Town,2015,55 - 59 years,2,2,4
Arklow Town,2015,60 - 64 years,2,2,4
Arklow Town,2015,65 - 69 years,4,2,6
Arklow Town,2015,70 - 74 years,1,3,4
Arklow Town,2015,75 - 79 years,7,6,13
Arklow Town,2015,80 - 84 years,4,10,14
Arklow Town,2015,85 years and over,16,10,26
Arklow Town,2015,Under 1 year,1,1,2
Arklow Town,2016,1 - 4 years,0,1,1
Arklow Town,2016,10 - 14 years,0,0,0
Arklow Town,2016,15 - 19 years,0,0,0
Arklow Town,2016,20 - 24 years,1,0,1
Arklow Town,2016,25 - 29 years,1,1,2
Arklow Town,2016,30 - 34 years,0,1,1
Arklow Town,2016,35 - 39 years,0,0,0
Arklow Town,2016,40 - 44 years,1,2,3
Arklow Town,2016,45 - 49 years,1,1,2
Arklow Town,2016,5 - 9 years,0,0,0
Arklow Town,2016,50 - 54 years,1,2,3
Arklow Town,2016,55 - 59 years,2,2,4
Arklow Town,2016,60 - 64 years,2,2,4
Arklow Town,2016,65 - 69 years,4,2,6
Arklow Town,2016,70 - 74 years,1,3,4
Arklow Town,2016,75 - 79 years,7,6,13
Arklow Town,2016,80 - 84 years,4,10,14
Arklow Town,2016,85 years and over,16,10,26
Arklow Town,2016,Under 1 year,1,1,2
Arklow Town,2017,1 - 4 years,0,1,1
Arklow Town,2017,10 - 14 years,0,0,0
Arklow Town,2017,15 - 19 years,0,0,0
Arklow Town,2017,20 - 24 years,1,1,2
Arklow Town,2017,25 - 29 years,1,1,2
Arklow Town,2017,30 - 34 years,0,1,1
Arklow Town,2017,35 - 39 years,1,1,2
Arklow Town,2017,40 - 44 years,1,7,8
Arklow Town,2017,45 - 49 years,1,2,3
Arklow Town,2017,5 - 9 years,0,0,0
Arklow Town,2017,50 - 54 years,1,2,3
Arklow Town,2017,55 - 59 years,2,2,4
Arklow Town,2017,60 - 64 years,3,4,7
Arklow Town,2017,65 - 69 years,2,3,5
Arklow Town,2017,70 - 74 years,1,6,7
Arklow Town,2017,75 - 79 years,3,8,11
Arklow Town,2017,80 - 84 years,12,8,20
Arklow Town,2017,85 years and over,14,8,22
Arklow Town,2017,Under 1 year,2,1,3
Arklow Town,2018,1 - 4 years,0,0,0
Arklow Town,2018,10 - 14 years,0,0,0
Arklow Town,2018,15 - 19 years,0,0,0
Arklow Town,2018,20 - 24 years,0,0,0
Arklow Town,2018,25 - 29 years,1,1,2
Arklow Town,2018,30 - 34 years,0,0,0
Arklow Town,2018,35 - 39 years,0,1,1
Arklow Town,2018,40 - 44 years,0,1,1
Arklow Town,2018,45 - 49 years,1,0,1
Arklow Town,2018,5 - 9 years,0,0,0
Arklow Town,2018,50 - 54 years,3,4,7
Arklow Town,2018,55 - 59 years,1,1,2
Arklow Town,2018,60 - 64 years,1,3,4
Arklow Town,2018,65 - 69 years,3,4,7
Arklow Town,2018,70 - 74 years,5,2,7
Arklow Town,2018,75 - 79 years,5,4,9
Arklow Town,2018,80 - 84 years,3,5,8
Arklow Town,2018,85 years and over,10,15,25
Arklow Town,2018,Under 1 year,1,1,2
Arklow Town,2019,1 - 4 years,0,0,0
Arklow Town,2019,10 - 14 years,0,0,0
Arklow Town,2019,15 - 19 years,0,0,0
Arklow Town,2019,20 - 24 years,0,0,0
Arklow Town,2019,25 - 29 years,1,1,2
Arklow Town,2019,30 - 34 years,0,0,0
Arklow Town,2019,35 - 39 years,0,1,1
Arklow Town,2019,40 - 44 years,0,1,1
Arklow Town,2019,45 - 49 years,1,0,1
Arklow Town,2019,5 - 9 years,0,0,0
Arklow Town,2019,50 - 54 years,3,4,7
Arklow Town,2019,55 - 59 years,1,1,2
Arklow Town,2019,60 - 64 years,1,3,4
Arklow Town,2019,65 - 69 years,3,4,7
Arklow Town,2019,70 - 74 years,5,2,7
Arklow Town,2019,75 - 79 years,5,4,9
Arklow Town,2019,80 - 84 years,3,5,8
Arklow Town,2019,85 years and over,10,15,25
Arklow Town,2019,Under 1 year,1,1,2
Arklow Town,2020,1 - 4 years,0,0,0
Arklow Town,2020,10 - 14 years,0,0,0
Arklow Town,2020,15 - 19 years,0,0,0
Arklow Town,2020,20 - 24 years,0,0,0
Arklow Town,2020,25 - 29 years,1,1,2
Arklow Town,2020,30 - 34 years,0,0,0
Arklow Town,2020,35 - 39 years,0,1,1
Arklow Town,2020,40 - 44 years,0,1,1
Arklow Town,2020,45 - 49 years,1,0,1
Arklow Town,2020,5 - 9 years,0,0,0
Arklow Town,2020,50 - 54 years,3,4,7
Arklow Town,2020,55 - 59 years,1,1,2
Arklow Town,2020,60 - 64 years,1,3,4
Arklow Town,2020,65 - 69 years,3,4,7
Arklow Town,2020,70 - 74 years,5,2,7
Arklow Town,2020,75 - 79 years,5,4,9
Arklow Town,2020,80 - 84 years,3,5,8
Arklow Town,2020,85 years and over,10,15,25
Arklow Town,2020,Under 1 year,1,1,2
Athlone Town,2007,1 - 4 years,0,0,0
Athlone Town,2007,10 - 14 years,0,0,0
Athlone Town,2007,15 - 19 years,0,1,1
Athlone Town,2007,20 - 24 years,0,1,1
Athlone Town,2007,25 - 29 years,1,1,2
Athlone Town,2007,30 - 34 years,0,0,0
Athlone Town,2007,35 - 39 years,0,0,0
Athlone Town,2007,40 - 44 years,0,1,1
Athlone Town,2007,45 - 49 years,0,0,0
Athlone Town,2007,5 - 9 years,0,0,0
Athlone Town,2007,50 - 54 years,4,2,6
Athlone Town,2007,55 - 59 years,4,5,9
Athlone Town,2007,60 - 64 years,3,2,5
Athlone Town,2007,65 - 69 years,4,6,10
Athlone Town,2007,70 - 74 years,5,7,12
Athlone Town,2007,75 - 79 years,12,11,23
Athlone Town,2007,80 - 84 years,13,6,19
Athlone Town,2007,85 years and over,24,13,37
Athlone Town,2007,Under 1 year,0,0,0
Athlone Town,2008,1 - 4 years,0,0,0
Athlone Town,2008,10 - 14 years,0,0,0
Athlone Town,2008,15 - 19 years,0,1,1
Athlone Town,2008,20 - 24 years,0,1,1
Athlone Town,2008,25 - 29 years,1,1,2
Athlone Town,2008,30 - 34 years,0,1,1
Athlone Town,2008,35 - 39 years,0,0,0
Athlone Town,2008,40 - 44 years,2,1,3
Athlone Town,2008,45 - 49 years,4,4,8
Athlone Town,2008,5 - 9 years,0,0,0
Athlone Town,2008,50 - 54 years,1,2,3
Athlone Town,2008,55 - 59 years,2,4,6
Athlone Town,2008,60 - 64 years,4,4,8
Athlone Town,2008,65 - 69 years,1,9,10
Athlone Town,2008,70 - 74 years,7,13,20
Athlone Town,2008,75 - 79 years,7,5,12
Athlone Town,2008,80 - 84 years,18,11,29
Athlone Town,2008,85 years and over,29,15,44
Athlone Town,2008,Under 1 year,0,0,0
Athlone Town,2009,1 - 4 years,0,0,0
Athlone Town,2009,10 - 14 years,0,0,0
Athlone Town,2009,15 - 19 years,0,1,1
Athlone Town,2009,20 - 24 years,1,1,2
Athlone Town,2009,25 - 29 years,1,1,2
Athlone Town,2009,30 - 34 years,0,1,1
Athlone Town,2009,35 - 39 years,0,1,1
Athlone Town,2009,40 - 44 years,1,1,2
Athlone Town,2009,45 - 49 years,2,5,7
Athlone Town,2009,5 - 9 years,0,0,0
Athlone Town,2009,50 - 54 years,1,2,3
Athlone Town,2009,55 - 59 years,4,2,6
Athlone Town,2009,60 - 64 years,1,3,4
Athlone Town,2009,65 - 69 years,1,1,2
Athlone Town,2009,70 - 74 years,4,2,6
Athlone Town,2009,75 - 79 years,9,6,15
Athlone Town,2009,80 - 84 years,8,7,15
Athlone Town,2009,85 years and over,16,4,20
Athlone Town,2009,Under 1 year,0,0,0
Athlone Town,2010,1 - 4 years,0,0,0
Athlone Town,2010,10 - 14 years,0,0,0
Athlone Town,2010,15 - 19 years,0,1,1
Athlone Town,2010,20 - 24 years,1,1,2
Athlone Town,2010,25 - 29 years,1,1,2
Athlone Town,2010,30 - 34 years,0,1,1
Athlone Town,2010,35 - 39 years,0,1,1
Athlone Town,2010,40 - 44 years,1,1,2
Athlone Town,2010,45 - 49 years,2,1,3
Athlone Town,2010,5 - 9 years,0,0,0
Athlone Town,2010,50 - 54 years,1,2,3
Athlone Town,2010,55 - 59 years,1,4,5
Athlone Town,2010,60 - 64 years,3,8,11
Athlone Town,2010,65 - 69 years,4,3,7
Athlone Town,2010,70 - 74 years,6,5,11
Athlone Town,2010,75 - 79 years,7,5,12
Athlone Town,2010,80 - 84 years,11,5,16
Athlone Town,2010,85 years and over,21,12,33
Athlone Town,2010,Under 1 year,1,0,1
Athlone Town,2011,1 - 4 years,0,0,0
Athlone Town,2011,10 - 14 years,0,0,0
Athlone Town,2011,15 - 19 years,0,0,0
Athlone Town,2011,20 - 24 years,0,0,0
Athlone Town,2011,25 - 29 years,1,0,1
Athlone Town,2011,30 - 34 years,0,3,3
Athlone Town,2011,35 - 39 years,0,0,0
Athlone Town,2011,40 - 44 years,2,1,3
Athlone Town,2011,45 - 49 years,1,1,2
Athlone Town,2011,5 - 9 years,0,0,0
Athlone Town,2011,50 - 54 years,2,1,3
Athlone Town,2011,55 - 59 years,2,4,6
Athlone Town,2011,60 - 64 years,3,1,4
Athlone Town,2011,65 - 69 years,3,2,5
Athlone Town,2011,70 - 74 years,4,3,7
Athlone Town,2011,75 - 79 years,9,6,15
Athlone Town,2011,80 - 84 years,7,5,12
Athlone Town,2011,85 years and over,14,9,23
Athlone Town,2011,Under 1 year,0,0,0
Athlone Town,2012,1 - 4 years,0,0,0
Athlone Town,2012,10 - 14 years,0,0,0
Athlone Town,2012,15 - 19 years,0,0,0
Athlone Town,2012,20 - 24 years,0,1,1
Athlone Town,2012,25 - 29 years,1,0,1
Athlone Town,2012,30 - 34 years,0,3,3
Athlone Town,2012,35 - 39 years,0,0,0
Athlone Town,2012,40 - 44 years,2,1,3
Athlone Town,2012,45 - 49 years,1,2,3
Athlone Town,2012,5 - 9 years,0,0,0
Athlone Town,2012,50 - 54 years,2,1,3
Athlone Town,2012,55 - 59 years,3,4,7
Athlone Town,2012,60 - 64 years,3,1,4
Athlone Town,2012,65 - 69 years,7,6,13
Athlone Town,2012,70 - 74 years,9,5,14
Athlone Town,2012,75 - 79 years,7,8,15
Athlone Town,2012,80 - 84 years,8,9,17
Athlone Town,2012,85 years and over,24,12,36
Athlone Town,2012,Under 1 year,0,0,0
Athlone Town,2013,1 - 4 years,0,0,0
Athlone Town,2013,10 - 14 years,0,0,0
Athlone Town,2013,15 - 19 years,0,0,0
Athlone Town,2013,20 - 24 years,0,0,0
Athlone Town,2013,25 - 29 years,0,0,0
Athlone Town,2013,30 - 34 years,1,1,2
Athlone Town,2013,35 - 39 years,1,1,2
Athlone Town,2013,40 - 44 years,0,3,3
Athlone Town,2013,45 - 49 years,1,0,1
Athlone Town,2013,5 - 9 years,0,0,0
Athlone Town,2013,50 - 54 years,2,0,2
Athlone Town,2013,55 - 59 years,3,6,9
Athlone Town,2013,60 - 64 years,2,6,8
Athlone Town,2013,65 - 69 years,5,4,9
Athlone Town,2013,70 - 74 years,2,10,12
Athlone Town,2013,75 - 79 years,8,8,16
Athlone Town,2013,80 - 84 years,10,13,23
Athlone Town,2013,85 years and over,30,14,44
Athlone Town,2013,Under 1 year,0,0,0
Athlone Town,2014,1 - 4 years,0,0,0
Athlone Town,2014,10 - 14 years,0,0,0
Athlone Town,2014,15 - 19 years,0,0,0
Athlone Town,2014,20 - 24 years,0,1,1
Athlone Town,2014,25 - 29 years,0,0,0
Athlone Town,2014,30 - 34 years,1,1,2
Athlone Town,2014,35 - 39 years,1,1,2
Athlone Town,2014,40 - 44 years,0,3,3
Athlone Town,2014,45 - 49 years,1,1,2
Athlone Town,2014,5 - 9 years,0,0,0
Athlone Town,2014,50 - 54 years,2,0,2
Athlone Town,2014,55 - 59 years,3,4,7
Athlone Town,2014,60 - 64 years,1,6,7
Athlone Town,2014,65 - 69 years,2,4,6
Athlone Town,2014,70 - 74 years,4,9,13
Athlone Town,2014,75 - 79 years,9,8,17
Athlone Town,2014,80 - 84 years,17,9,26
Athlone Town,2014,85 years and over,31,10,41
Athlone Town,2014,Under 1 year,0,1,1
Athlone Town,2015,1 - 4 years,0,0,0
Athlone Town,2015,10 - 14 years,0,0,0
Athlone Town,2015,15 - 19 years,0,0,0
Athlone Town,2015,20 - 24 years,0,1,1
Athlone Town,2015,25 - 29 years,0,0,0
Athlone Town,2015,30 - 34 years,1,1,2
Athlone Town,2015,35 - 39 years,1,1,2
Athlone Town,2015,40 - 44 years,0,3,3
Athlone Town,2015,45 - 49 years,1,1,2
Athlone Town,2015,5 - 9 years,0,0,0
Athlone Town,2015,50 - 54 years,2,0,2
Athlone Town,2015,55 - 59 years,3,4,7
Athlone Town,2015,60 - 64 years,1,6,7
Athlone Town,2015,65 - 69 years,2,4,6
Athlone Town,2015,70 - 74 years,4,9,13
Athlone Town,2015,75 - 79 years,9,8,17
Athlone Town,2015,80 - 84 years,17,9,26
Athlone Town,2015,85 years and over,31,10,41
Athlone Town,2015,Under 1 year,0,1,1
Athlone Town,2016,1 - 4 years,0,0,0
Athlone Town,2016,10 - 14 years,0,0,0
Athlone Town,2016,15 - 19 years,0,0,0
Athlone Town,2016,20 - 24 years,0,1,1
Athlone Town,2016,25 - 29 years,0,0,0
Athlone Town,2016,30 - 34 years,1,1,2
Athlone Town,2016,35 - 39 years,1,1,2
Athlone Town,2016,40 - 44 years,0,3,3
Athlone Town,2016,45 - 49 years,1,1,2
Athlone Town,2016,5 - 9 years,0,0,0
Athlone Town,2016,50 - 54 years,2,0,2
Athlone Town,2016,55 - 59 years,3,4,7
Athlone Town,2016,60 - 64 years,1,6,7
Athlone Town,2016,65 - 69 years,2,4,6
Athlone Town,2016,70 - 74 years,4,9,13
Athlone Town,2016,75 - 79 years,9,8,17
Athlone Town,2016,80 - 84 years,17,9,26
Athlone Town,2016,85 years and over,31,10,41
Athlone Town,2016,Under 1 year,0,1,1
Athlone Town,2017,1 - 4 years,0,0,0
Athlone Town,2017,10 - 14 years,0,0,0
Athlone Town,2017,15 - 19 years,0,0,0
Athlone Town,2017,20 - 24 years,0,1,1
Athlone Town,2017,25 - 29 years,0,0,0
Athlone Town,2017,30 - 34 years,1,3,4
Athlone Town,2017,35 - 39 years,1,2,3
Athlone Town,2017,40 - 44 years,0,3,3
Athlone Town,2017,45 - 49 years,1,1,2
Athlone Town,2017,5 - 9 years,0,0,0
Athlone Town,2017,50 - 54 years,1,0,1
Athlone Town,2017,55 - 59 years,3,3,6
Athlone Town,2017,60 - 64 years,4,6,10
Athlone Town,2017,65 - 69 years,8,8,16
Athlone Town,2017,70 - 74 years,6,3,9
Athlone Town,2017,75 - 79 years,5,11,16
Athlone Town,2017,80 - 84 years,11,9,20
Athlone Town,2017,85 years and over,27,13,40
Athlone Town,2017,Under 1 year,1,1,2
Athlone Town,2018,1 - 4 years,0,0,0
Athlone Town,2018,10 - 14 years,0,0,0
Athlone Town,2018,15 - 19 years,0,0,0
Athlone Town,2018,20 - 24 years,0,0,0
Athlone Town,2018,25 - 29 years,0,1,1
Athlone Town,2018,30 - 34 years,0,0,0
Athlone Town,2018,35 - 39 years,0,0,0
Athlone Town,2018,40 - 44 years,0,1,1
Athlone Town,2018,45 - 49 years,2,1,3
Athlone Town,2018,5 - 9 years,0,0,0
Athlone Town,2018,50 - 54 years,1,2,3
Athlone Town,2018,55 - 59 years,0,4,4
Athlone Town,2018,60 - 64 years,4,2,6
Athlone Town,2018,65 - 69 years,4,8,12
Athlone Town,2018,70 - 74 years,8,9,17
Athlone Town,2018,75 - 79 years,7,7,14
Athlone Town,2018,80 - 84 years,11,8,19
Athlone Town,2018,85 years and over,21,12,33
Athlone Town,2018,Under 1 year,0,0,0
Athlone Town,2019,1 - 4 years,0,0,0
Athlone Town,2019,10 - 14 years,0,0,0
Athlone Town,2019,15 - 19 years,0,0,0
Athlone Town,2019,20 - 24 years,0,0,0
Athlone Town,2019,25 - 29 years,0,1,1
Athlone Town,2019,30 - 34 years,0,0,0
Athlone Town,2019,35 - 39 years,0,0,0
Athlone Town,2019,40 - 44 years,0,1,1
Athlone Town,2019,45 - 49 years,2,1,3
Athlone Town,2019,5 - 9 years,0,0,0
Athlone Town,2019,50 - 54 years,1,2,3
Athlone Town,2019,55 - 59 years,0,4,4
Athlone Town,2019,60 - 64 years,4,2,6
Athlone Town,2019,65 - 69 years,4,8,12
Athlone Town,2019,70 - 74 years,8,9,17
Athlone Town,2019,75 - 79 years,7,7,14
Athlone Town,2019,80 - 84 years,11,8,19
Athlone Town,2019,85 years and over,21,12,33
Athlone Town,2019,Under 1 year,0,0,0
Athlone Town,2020,1 - 4 years,0,0,0
Athlone Town,2020,10 - 14 years,0,0,0
Athlone Town,2020,15 - 19 years,0,0,0
Athlone Town,2020,20 - 24 years,0,0,0
Athlone Town,2020,25 - 29 years,0,1,1
Athlone Town,2020,30 - 34 years,0,0,0
Athlone Town,2020,35 - 39 years,0,0,0
Athlone Town,2020,40 - 44 years,0,1,1
Athlone Town,2020,45 - 49 years,2,1,3
Athlone Town,2020,5 - 9 years,0,0,0
Athlone Town,2020,50 - 54 years,1,2,3
Athlone Town,2020,55 - 59 years,0,4,4
Athlone Town,2020,60 - 64 years,4,2,6
Athlone Town,2020,65 - 69 years,4,8,12
Athlone Town,2020,70 - 74 years,8,9,17
Athlone Town,2020,75 - 79 years,7,7,14
Athlone Town,2020,80 - 84 years,11,8,19
Athlone Town,2020,85 years and over,21,12,33
Athlone Town,2020,Under 1 year,0,0,0
Athy Town,2007,1 - 4 years,0,0,0
Athy Town,2007,10 - 14 years,0,0,0
Athy Town,2007,15 - 19 years,0,0,0
Athy Town,2007,20 - 24 years,0,1,1
Athy Town,2007,25 - 29 years,0,1,1
Athy Town,2007,30 - 34 years,0,1,1
Athy Town,2007,35 - 39 years,0,1,1
Athy Town,2007,40 - 44 years,0,2,2
Athy Town,2007,45 - 49 years,0,1,1
Athy Town,2007,5 - 9 years,0,0,0
Athy Town,2007,50 - 54 years,1,2,3
Athy Town,2007,55 - 59 years,1,1,2
Athy Town,2007,60 - 64 years,0,6,6
Athy Town,2007,65 - 69 years,1,3,4
Athy Town,2007,70 - 74 years,0,3,3
Athy Town,2007,75 - 79 years,2,6,8
Athy Town,2007,80 - 84 years,5,8,13
Athy Town,2007,85 years and over,7,6,13
Athy Town,2007,Under 1 year,0,1,1
Athy Town,2008,1 - 4 years,0,0,0
Athy Town,2008,10 - 14 years,0,0,0
Athy Town,2008,15 - 19 years,0,0,0
Athy Town,2008,20 - 24 years,0,1,1
Athy Town,2008,25 - 29 years,0,1,1
Athy Town,2008,30 - 34 years,0,1,1
Athy Town,2008,35 - 39 years,1,1,2
Athy Town,2008,40 - 44 years,0,1,1
Athy Town,2008,45 - 49 years,0,1,1
Athy Town,2008,5 - 9 years,0,1,1
Athy Town,2008,50 - 54 years,2,2,4
Athy Town,2008,55 - 59 years,1,3,4
Athy Town,2008,60 - 64 years,3,5,8
Athy Town,2008,65 - 69 years,1,5,6
Athy Town,2008,70 - 74 years,6,5,11
Athy Town,2008,75 - 79 years,6,7,13
Athy Town,2008,80 - 84 years,6,5,11
Athy Town,2008,85 years and over,18,6,24
Athy Town,2008,Under 1 year,2,1,3
Athy Town,2009,1 - 4 years,1,0,1
Athy Town,2009,10 - 14 years,1,0,1
Athy Town,2009,15 - 19 years,0,1,1
Athy Town,2009,20 - 24 years,0,1,1
Athy Town,2009,25 - 29 years,0,1,1
Athy Town,2009,30 - 34 years,0,1,1
Athy Town,2009,35 - 39 years,1,1,2
Athy Town,2009,40 - 44 years,0,1,1
Athy Town,2009,45 - 49 years,1,2,3
Athy Town,2009,5 - 9 years,0,1,1
Athy Town,2009,50 - 54 years,2,2,4
Athy Town,2009,55 - 59 years,2,3,5
Athy Town,2009,60 - 64 years,2,3,5
Athy Town,2009,65 - 69 years,3,4,7
Athy Town,2009,70 - 74 years,2,5,7
Athy Town,2009,75 - 79 years,5,7,12
Athy Town,2009,80 - 84 years,2,9,11
Athy Town,2009,85 years and over,11,7,18
Athy Town,2009,Under 1 year,1,1,2
Athy Town,2010,1 - 4 years,1,0,1
Athy Town,2010,10 - 14 years,1,0,1
Athy Town,2010,15 - 19 years,0,1,1
Athy Town,2010,20 - 24 years,1,1,2
Athy Town,2010,25 - 29 years,2,1,3
Athy Town,2010,30 - 34 years,0,1,1
Athy Town,2010,35 - 39 years,1,1,2
Athy Town,2010,40 - 44 years,0,1,1
Athy Town,2010,45 - 49 years,1,2,3
Athy Town,2010,5 - 9 years,0,1,1
Athy Town,2010,50 - 54 years,2,3,5
Athy Town,2010,55 - 59 years,2,4,6
Athy Town,2010,60 - 64 years,2,2,4
Athy Town,2010,65 - 69 years,1,5,6
Athy Town,2010,70 - 74 years,2,3,5
Athy Town,2010,75 - 79 years,2,1,3
Athy Town,2010,80 - 84 years,1,1,2
Athy Town,2010,85 years and over,4,5,9
Athy Town,2010,Under 1 year,1,1,2
Athy Town,2011,1 - 4 years,0,0,0
Athy Town,2011,10 - 14 years,0,0,0
Athy Town,2011,15 - 19 years,0,1,1
Athy Town,2011,20 - 24 years,0,0,0
Athy Town,2011,25 - 29 years,0,0,0
Athy Town,2011,30 - 34 years,0,0,0
Athy Town,2011,35 - 39 years,0,0,0
Athy Town,2011,40 - 44 years,1,3,4
Athy Town,2011,45 - 49 years,1,1,2
Athy Town,2011,5 - 9 years,0,0,0
Athy Town,2011,50 - 54 years,1,0,1
Athy Town,2011,55 - 59 years,1,4,5
Athy Town,2011,60 - 64 years,1,2,3
Athy Town,2011,65 - 69 years,6,10,16
Athy Town,2011,70 - 74 years,2,3,5
Athy Town,2011,75 - 79 years,3,5,8
Athy Town,2011,80 - 84 years,4,6,10
Athy Town,2011,85 years and over,8,5,13
Athy Town,2011,Under 1 year,0,0,0
Athy Town,2012,1 - 4 years,0,0,0
Athy Town,2012,10 - 14 years,0,0,0
Athy Town,2012,15 - 19 years,0,1,1
Athy Town,2012,20 - 24 years,0,0,0
Athy Town,2012,25 - 29 years,1,1,2
Athy Town,2012,30 - 34 years,0,0,0
Athy Town,2012,35 - 39 years,2,1,3
Athy Town,2012,40 - 44 years,1,3,4
Athy Town,2012,45 - 49 years,1,1,2
Athy Town,2012,5 - 9 years,0,0,0
Athy Town,2012,50 - 54 years,1,1,2
Athy Town,2012,55 - 59 years,5,2,7
Athy Town,2012,60 - 64 years,1,4,5
Athy Town,2012,65 - 69 years,2,6,8
Athy Town,2012,70 - 74 years,4,7,11
Athy Town,2012,75 - 79 years,8,7,15
Athy Town,2012,80 - 84 years,12,7,19
Athy Town,2012,85 years and over,18,6,24
Athy Town,2012,Under 1 year,0,4,4
Athy Town,2013,1 - 4 years,0,0,0
Athy Town,2013,10 - 14 years,0,0,0
Athy Town,2013,15 - 19 years,0,0,0
Athy Town,2013,20 - 24 years,0,1,1
Athy Town,2013,25 - 29 years,0,1,1
Athy Town,2013,30 - 34 years,0,1,1
Athy Town,2013,35 - 39 years,1,1,2
Athy Town,2013,40 - 44 years,0,0,0
Athy Town,2013,45 - 49 years,0,2,2
Athy Town,2013,5 - 9 years,0,0,0
Athy Town,2013,50 - 54 years,0,1,1
Athy Town,2013,55 - 59 years,1,1,2
Athy Town,2013,60 - 64 years,1,5,6
Athy Town,2013,65 - 69 years,3,5,8
Athy Town,2013,70 - 74 years,2,4,6
Athy Town,2013,75 - 79 years,4,4,8
Athy Town,2013,80 - 84 years,4,5,9
Athy Town,2013,85 years and over,18,2,20
Athy Town,2013,Under 1 year,0,1,1
Athy Town,2014,1 - 4 years,0,0,0
Athy Town,2014,10 - 14 years,0,0,0
Athy Town,2014,15 - 19 years,1,0,1
Athy Town,2014,20 - 24 years,1,1,2
Athy Town,2014,25 - 29 years,0,1,1
Athy Town,2014,30 - 34 years,1,1,2
Athy Town,2014,35 - 39 years,1,3,4
Athy Town,2014,40 - 44 years,0,1,1
Athy Town,2014,45 - 49 years,1,2,3
Athy Town,2014,5 - 9 years,0,0,0
Athy Town,2014,50 - 54 years,0,1,1
Athy Town,2014,55 - 59 years,3,1,4
Athy Town,2014,60 - 64 years,1,4,5
Athy Town,2014,65 - 69 years,1,1,2
Athy Town,2014,70 - 74 years,3,4,7
Athy Town,2014,75 - 79 years,6,3,9
Athy Town,2014,80 - 84 years,7,8,15
Athy Town,2014,85 years and over,13,3,16
Athy Town,2014,Under 1 year,0,1,1
Athy Town,2015,1 - 4 years,0,0,0
Athy Town,2015,10 - 14 years,0,0,0
Athy Town,2015,15 - 19 years,1,0,1
Athy Town,2015,20 - 24 years,1,1,2
Athy Town,2015,25 - 29 years,0,1,1
Athy Town,2015,30 - 34 years,1,1,2
Athy Town,2015,35 - 39 years,1,3,4
Athy Town,2015,40 - 44 years,0,1,1
Athy Town,2015,45 - 49 years,1,2,3
Athy Town,2015,5 - 9 years,0,0,0
Athy Town,2015,50 - 54 years,0,1,1
Athy Town,2015,55 - 59 years,3,1,4
Athy Town,2015,60 - 64 years,1,4,5
Athy Town,2015,65 - 69 years,1,1,2
Athy Town,2015,70 - 74 years,3,4,7
Athy Town,2015,75 - 79 years,6,3,9
Athy Town,2015,80 - 84 years,7,8,15
Athy Town,2015,85 years and over,13,3,16
Athy Town,2015,Under 1 year,0,1,1
Athy Town,2016,1 - 4 years,0,0,0
Athy Town,2016,10 - 14 years,0,0,0
Athy Town,2016,15 - 19 years,1,0,1
Athy Town,2016,20 - 24 years,1,1,2
Athy Town,2016,25 - 29 years,0,1,1
Athy Town,2016,30 - 34 years,1,1,2
Athy Town,2016,35 - 39 years,1,3,4
Athy Town,2016,40 - 44 years,0,1,1
Athy Town,2016,45 - 49 years,1,2,3
Athy Town,2016,5 - 9 years,0,0,0
Athy Town,2016,50 - 54 years,0,1,1
Athy Town,2016,55 - 59 years,3,1,4
Athy Town,2016,60 - 64 years,1,4,5
Athy Town,2016,65 - 69 years,1,1,2
Athy Town,2016,70 - 74 years,3,4,7
Athy Town,2016,75 - 79 years,6,3,9
Athy Town,2016,80 - 84 years,7,8,15
Athy Town,2016,85 years and over,13,3,16
Athy Town,2016,Under 1 year,0,1,1
Athy Town,2017,1 - 4 years,0,0,0
Athy Town,2017,10 - 14 years,0,0,0
Athy Town,2017,15 - 19 years,1,0,1
Athy Town,2017,20 - 24 years,1,1,2
Athy Town,2017,25 - 29 years,0,1,1
Athy Town,2017,30 - 34 years,1,1,2
Athy Town,2017,35 - 39 years,1,1,2
Athy Town,2017,40 - 44 years,1,3,4
Athy Town,2017,45 - 49 years,2,1,3
Athy Town,2017,5 - 9 years,0,0,0
Athy Town,2017,50 - 54 years,1,1,2
Athy Town,2017,55 - 59 years,2,1,3
Athy Town,2017,60 - 64 years,1,7,8
Athy Town,2017,65 - 69 years,3,4,7
Athy Town,2017,70 - 74 years,10,4,14
Athy Town,2017,75 - 79 years,4,6,10
Athy Town,2017,80 - 84 years,3,3,6
Athy Town,2017,85 years and over,13,7,20
Athy Town,2017,Under 1 year,0,2,2
Athy Town,2018,1 - 4 years,0,0,0
Athy Town,2018,10 - 14 years,0,0,0
Athy Town,2018,15 - 19 years,0,0,0
Athy Town,2018,20 - 24 years,0,0,0
Athy Town,2018,25 - 29 years,0,0,0
Athy Town,2018,30 - 34 years,0,1,1
Athy Town,2018,35 - 39 years,1,0,1
Athy Town,2018,40 - 44 years,1,1,2
Athy Town,2018,45 - 49 years,1,3,4
Athy Town,2018,5 - 9 years,0,0,0
Athy Town,2018,50 - 54 years,1,0,1
Athy Town,2018,55 - 59 years,0,0,0
Athy Town,2018,60 - 64 years,1,3,4
Athy Town,2018,65 - 69 years,1,5,6
Athy Town,2018,70 - 74 years,2,8,10
Athy Town,2018,75 - 79 years,4,5,9
Athy Town,2018,80 - 84 years,7,10,17
Athy Town,2018,85 years and over,10,2,12
Athy Town,2018,Under 1 year,0,0,0
Athy Town,2019,1 - 4 years,0,0,0
Athy Town,2019,10 - 14 years,0,0,0
Athy Town,2019,15 - 19 years,0,0,0
Athy Town,2019,20 - 24 years,0,0,0
Athy Town,2019,25 - 29 years,0,0,0
Athy Town,2019,30 - 34 years,0,1,1
Athy Town,2019,35 - 39 years,1,0,1
Athy Town,2019,40 - 44 years,1,1,2
Athy Town,2019,45 - 49 years,1,3,4
Athy Town,2019,5 - 9 years,0,0,0
Athy Town,2019,50 - 54 years,1,0,1
Athy Town,2019,55 - 59 years,0,0,0
Athy Town,2019,60 - 64 years,1,3,4
Athy Town,2019,65 - 69 years,1,5,6
Athy Town,2019,70 - 74 years,2,8,10
Athy Town,2019,75 - 79 years,4,5,9
Athy Town,2019,80 - 84 years,7,10,17
Athy Town,2019,85 years and over,10,2,12
Athy Town,2019,Under 1 year,0,0,0
Athy Town,2020,1 - 4 years,0,0,0
Athy Town,2020,10 - 14 years,0,0,0
Athy Town,2020,15 - 19 years,0,0,0
Athy Town,2020,20 - 24 years,0,0,0
Athy Town,2020,25 - 29 years,0,0,0
Athy Town,2020,30 - 34 years,0,1,1
Athy Town,2020,35 - 39 years,1,0,1
Athy Town,2020,40 - 44 years,1,1,2
Athy Town,2020,45 - 49 years,1,3,4
Athy Town,2020,5 - 9 years,0,0,0
Athy Town,2020,50 - 54 years,1,0,1
Athy Town,2020,55 - 59 years,0,0,0
Athy Town,2020,60 - 64 years,1,3,4
Athy Town,2020,65 - 69 years,1,5,6
Athy Town,2020,70 - 74 years,2,8,10
Athy Town,2020,75 - 79 years,4,5,9
Athy Town,2020,80 - 84 years,7,10,17
Athy Town,2020,85 years and over,10,2,12
Athy Town,2020,Under 1 year,0,0,0
Ballina Town,2007,1 - 4 years,0,0,0
Ballina Town,2007,10 - 14 years,0,0,0
Ballina Town,2007,15 - 19 years,0,0,0
Ballina Town,2007,20 - 24 years,0,1,1
Ballina Town,2007,25 - 29 years,0,1,1
Ballina Town,2007,30 - 34 years,1,1,2
Ballina Town,2007,35 - 39 years,1,2,3
Ballina Town,2007,40 - 44 years,0,1,1
Ballina Town,2007,45 - 49 years,0,3,3
Ballina Town,2007,5 - 9 years,0,0,0
Ballina Town,2007,50 - 54 years,5,2,7
Ballina Town,2007,55 - 59 years,1,6,7
Ballina Town,2007,60 - 64 years,5,6,11
Ballina Town,2007,65 - 69 years,3,12,15
Ballina Town,2007,70 - 74 years,10,7,17
Ballina Town,2007,75 - 79 years,10,6,16
Ballina Town,2007,80 - 84 years,16,10,26
Ballina Town,2007,85 years and over,29,16,45
Ballina Town,2007,Under 1 year,0,0,0
Ballina Town,2008,1 - 4 years,0,1,1
Ballina Town,2008,10 - 14 years,0,0,0
Ballina Town,2008,15 - 19 years,0,0,0
Ballina Town,2008,20 - 24 years,0,1,1
Ballina Town,2008,25 - 29 years,0,2,2
Ballina Town,2008,30 - 34 years,1,1,2
Ballina Town,2008,35 - 39 years,1,1,2
Ballina Town,2008,40 - 44 years,1,2,3
Ballina Town,2008,45 - 49 years,1,4,5
Ballina Town,2008,5 - 9 years,0,0,0
Ballina Town,2008,50 - 54 years,3,2,5
Ballina Town,2008,55 - 59 years,4,8,12
Ballina Town,2008,60 - 64 years,2,6,8
Ballina Town,2008,65 - 69 years,6,9,15
Ballina Town,2008,70 - 74 years,4,15,19
Ballina Town,2008,75 - 79 years,11,9,20
Ballina Town,2008,80 - 84 years,16,12,28
Ballina Town,2008,85 years and over,45,13,58
Ballina Town,2008,Under 1 year,1,0,1
Ballina Town,2009,1 - 4 years,1,1,2
Ballina Town,2009,10 - 14 years,0,0,0
Ballina Town,2009,15 - 19 years,0,0,0
Ballina Town,2009,20 - 24 years,0,1,1
Ballina Town,2009,25 - 29 years,0,1,1
Ballina Town,2009,30 - 34 years,1,1,2
Ballina Town,2009,35 - 39 years,1,1,2
Ballina Town,2009,40 - 44 years,1,2,3
Ballina Town,2009,45 - 49 years,1,2,3
Ballina Town,2009,5 - 9 years,0,0,0
Ballina Town,2009,50 - 54 years,3,1,4
Ballina Town,2009,55 - 59 years,3,3,6
Ballina Town,2009,60 - 64 years,3,3,6
Ballina Town,2009,65 - 69 years,1,5,6
Ballina Town,2009,70 - 74 years,2,2,4
Ballina Town,2009,75 - 79 years,6,6,12
Ballina Town,2009,80 - 84 years,2,9,11
Ballina Town,2009,85 years and over,13,6,19
Ballina Town,2009,Under 1 year,1,0,1
Ballina Town,2010,1 - 4 years,1,1,2
Ballina Town,2010,10 - 14 years,0,0,0
Ballina Town,2010,15 - 19 years,0,1,1
Ballina Town,2010,20 - 24 years,0,1,1
Ballina Town,2010,25 - 29 years,0,1,1
Ballina Town,2010,30 - 34 years,1,1,2
Ballina Town,2010,35 - 39 years,1,1,2
Ballina Town,2010,40 - 44 years,1,2,3
Ballina Town,2010,45 - 49 years,1,2,3
Ballina Town,2010,5 - 9 years,0,0,0
Ballina Town,2010,50 - 54 years,2,2,4
Ballina Town,2010,55 - 59 years,1,2,3
Ballina Town,2010,60 - 64 years,5,4,9
Ballina Town,2010,65 - 69 years,3,8,11
Ballina Town,2010,70 - 74 years,3,2,5
Ballina Town,2010,75 - 79 years,8,8,16
Ballina Town,2010,80 - 84 years,12,7,19
Ballina Town,2010,85 years and over,24,10,34
Ballina Town,2010,Under 1 year,1,1,2
Ballina Town,2011,1 - 4 years,0,0,0
Ballina Town,2011,10 - 14 years,1,0,1
Ballina Town,2011,15 - 19 years,0,1,1
Ballina Town,2011,20 - 24 years,0,0,0
Ballina Town,2011,25 - 29 years,0,0,0
Ballina Town,2011,30 - 34 years,1,1,2
Ballina Town,2011,35 - 39 years,0,1,1
Ballina Town,2011,40 - 44 years,0,0,0
Ballina Town,2011,45 - 49 years,0,0,0
Ballina Town,2011,5 - 9 years,0,0,0
Ballina Town,2011,50 - 54 years,2,2,4
Ballina Town,2011,55 - 59 years,1,1,2
Ballina Town,2011,60 - 64 years,4,2,6
Ballina Town,2011,65 - 69 years,5,3,8
Ballina Town,2011,70 - 74 years,0,8,8
Ballina Town,2011,75 - 79 years,4,5,9
Ballina Town,2011,80 - 84 years,3,6,9
Ballina Town,2011,85 years and over,19,5,24
Ballina Town,2011,Under 1 year,0,0,0
Ballina Town,2012,1 - 4 years,0,0,0
Ballina Town,2012,10 - 14 years,1,0,1
Ballina Town,2012,15 - 19 years,0,1,1
Ballina Town,2012,20 - 24 years,0,0,0
Ballina Town,2012,25 - 29 years,0,1,1
Ballina Town,2012,30 - 34 years,1,1,2
Ballina Town,2012,35 - 39 years,0,1,1
Ballina Town,2012,40 - 44 years,1,1,2
Ballina Town,2012,45 - 49 years,0,1,1
Ballina Town,2012,5 - 9 years,0,0,0
Ballina Town,2012,50 - 54 years,2,2,4
Ballina Town,2012,55 - 59 years,1,1,2
Ballina Town,2012,60 - 64 years,4,2,6
Ballina Town,2012,65 - 69 years,5,4,9
Ballina Town,2012,70 - 74 years,5,10,15
Ballina Town,2012,75 - 79 years,3,11,14
Ballina Town,2012,80 - 84 years,9,9,18
Ballina Town,2012,85 years and over,19,16,35
Ballina Town,2012,Under 1 year,0,2,2
Ballina Town,2013,1 - 4 years,0,0,0
Ballina Town,2013,10 - 14 years,0,0,0
Ballina Town,2013,15 - 19 years,0,0,0
Ballina Town,2013,20 - 24 years,0,0,0
Ballina Town,2013,25 - 29 years,1,1,2
Ballina Town,2013,30 - 34 years,0,1,1
Ballina Town,2013,35 - 39 years,1,0,1
Ballina Town,2013,40 - 44 years,1,1,2
Ballina Town,2013,45 - 49 years,0,1,1
Ballina Town,2013,5 - 9 years,0,0,0
Ballina Town,2013,50 - 54 years,0,1,1
Ballina Town,2013,55 - 59 years,1,1,2
Ballina Town,2013,60 - 64 years,2,5,7
Ballina Town,2013,65 - 69 years,4,5,9
Ballina Town,2013,70 - 74 years,4,7,11
Ballina Town,2013,75 - 79 years,5,5,10
Ballina Town,2013,80 - 84 years,7,5,12
Ballina Town,2013,85 years and over,18,13,31
Ballina Town,2013,Under 1 year,0,0,0
Ballina Town,2014,1 - 4 years,0,0,0
Ballina Town,2014,10 - 14 years,0,0,0
Ballina Town,2014,15 - 19 years,0,0,0
Ballina Town,2014,20 - 24 years,0,1,1
Ballina Town,2014,25 - 29 years,1,1,2
Ballina Town,2014,30 - 34 years,0,1,1
Ballina Town,2014,35 - 39 years,1,0,1
Ballina Town,2014,40 - 44 years,2,2,4
Ballina Town,2014,45 - 49 years,0,1,1
Ballina Town,2014,5 - 9 years,0,1,1
Ballina Town,2014,50 - 54 years,0,2,2
Ballina Town,2014,55 - 59 years,1,2,3
Ballina Town,2014,60 - 64 years,1,2,3
Ballina Town,2014,65 - 69 years,2,4,6
Ballina Town,2014,70 - 74 years,3,5,8
Ballina Town,2014,75 - 79 years,6,2,8
Ballina Town,2014,80 - 84 years,8,7,15
Ballina Town,2014,85 years and over,22,7,29
Ballina Town,2014,Under 1 year,1,1,2
Ballina Town,2015,1 - 4 years,0,0,0
Ballina Town,2015,10 - 14 years,0,0,0
Ballina Town,2015,15 - 19 years,0,0,0
Ballina Town,2015,20 - 24 years,0,1,1
Ballina Town,2015,25 - 29 years,1,1,2
Ballina Town,2015,30 - 34 years,0,1,1
Ballina Town,2015,35 - 39 years,1,0,1
Ballina Town,2015,40 - 44 years,2,2,4
Ballina Town,2015,45 - 49 years,0,1,1
Ballina Town,2015,5 - 9 years,0,1,1
Ballina Town,2015,50 - 54 years,0,2,2
Ballina Town,2015,55 - 59 years,1,2,3
Ballina Town,2015,60 - 64 years,1,2,3
Ballina Town,2015,65 - 69 years,2,4,6
Ballina Town,2015,70 - 74 years,3,5,8
Ballina Town,2015,75 - 79 years,6,2,8
Ballina Town,2015,80 - 84 years,8,7,15
Ballina Town,2015,85 years and over,22,7,29
Ballina Town,2015,Under 1 year,1,1,2
Ballina Town,2016,1 - 4 years,0,0,0
Ballina Town,2016,10 - 14 years,0,0,0
Ballina Town,2016,15 - 19 years,0,0,0
Ballina Town,2016,20 - 24 years,0,1,1
Ballina Town,2016,25 - 29 years,1,1,2
Ballina Town,2016,30 - 34 years,0,1,1
Ballina Town,2016,35 - 39 years,1,0,1
Ballina Town,2016,40 - 44 years,2,2,4
Ballina Town,2016,45 - 49 years,0,1,1
Ballina Town,2016,5 - 9 years,0,1,1
Ballina Town,2016,50 - 54 years,0,2,2
Ballina Town,2016,55 - 59 years,1,2,3
Ballina Town,2016,60 - 64 years,1,2,3
Ballina Town,2016,65 - 69 years,2,4,6
Ballina Town,2016,70 - 74 years,3,5,8
Ballina Town,2016,75 - 79 years,6,2,8
Ballina Town,2016,80 - 84 years,8,7,15
Ballina Town,2016,85 years and over,22,7,29
Ballina Town,2016,Under 1 year,1,1,2
Ballina Town,2017,1 - 4 years,0,1,1
Ballina Town,2017,10 - 14 years,0,0,0
Ballina Town,2017,15 - 19 years,0,1,1
Ballina Town,2017,20 - 24 years,0,1,1
Ballina Town,2017,25 - 29 years,1,1,2
Ballina Town,2017,30 - 34 years,0,1,1
Ballina Town,2017,35 - 39 years,1,0,1
Ballina Town,2017,40 - 44 years,2,1,3
Ballina Town,2017,45 - 49 years,1,1,2
Ballina Town,2017,5 - 9 years,0,1,1
Ballina Town,2017,50 - 54 years,0,2,2
Ballina Town,2017,55 - 59 years,1,3,4
Ballina Town,2017,60 - 64 years,2,2,4
Ballina Town,2017,65 - 69 years,3,3,6
Ballina Town,2017,70 - 74 years,4,7,11
Ballina Town,2017,75 - 79 years,3,8,11
Ballina Town,2017,80 - 84 years,6,5,11
Ballina Town,2017,85 years and over,17,16,33
Ballina Town,2017,Under 1 year,1,1,2
Ballina Town,2018,1 - 4 years,0,0,0
Ballina Town,2018,10 - 14 years,0,0,0
Ballina Town,2018,15 - 19 years,0,0,0
Ballina Town,2018,20 - 24 years,0,1,1
Ballina Town,2018,25 - 29 years,1,0,1
Ballina Town,2018,30 - 34 years,0,1,1
Ballina Town,2018,35 - 39 years,0,2,2
Ballina Town,2018,40 - 44 years,0,1,1
Ballina Town,2018,45 - 49 years,0,1,1
Ballina Town,2018,5 - 9 years,0,0,0
Ballina Town,2018,50 - 54 years,1,0,1
Ballina Town,2018,55 - 59 years,2,3,5
Ballina Town,2018,60 - 64 years,1,3,4
Ballina Town,2018,65 - 69 years,4,8,12
Ballina Town,2018,70 - 74 years,5,9,14
Ballina Town,2018,75 - 79 years,3,6,9
Ballina Town,2018,80 - 84 years,2,7,9
Ballina Town,2018,85 years and over,17,13,30
Ballina Town,2018,Under 1 year,0,0,0
Ballina Town,2019,1 - 4 years,0,0,0
Ballina Town,2019,10 - 14 years,0,0,0
Ballina Town,2019,15 - 19 years,0,0,0
Ballina Town,2019,20 - 24 years,0,1,1
Ballina Town,2019,25 - 29 years,1,0,1
Ballina Town,2019,30 - 34 years,0,1,1
Ballina Town,2019,35 - 39 years,0,2,2
Ballina Town,2019,40 - 44 years,0,1,1
Ballina Town,2019,45 - 49 years,0,1,1
Ballina Town,2019,5 - 9 years,0,0,0
Ballina Town,2019,50 - 54 years,1,0,1
Ballina Town,2019,55 - 59 years,2,3,5
Ballina Town,2019,60 - 64 years,1,3,4
Ballina Town,2019,65 - 69 years,4,8,12
Ballina Town,2019,70 - 74 years,5,9,14
Ballina Town,2019,75 - 79 years,3,6,9
Ballina Town,2019,80 - 84 years,2,7,9
Ballina Town,2019,85 years and over,17,13,30
Ballina Town,2019,Under 1 year,0,0,0
Ballina Town,2020,1 - 4 years,0,0,0
Ballina Town,2020,10 - 14 years,0,0,0
Ballina Town,2020,15 - 19 years,0,0,0
Ballina Town,2020,20 - 24 years,0,1,1
Ballina Town,2020,25 - 29 years,1,0,1
Ballina Town,2020,30 - 34 years,0,1,1
Ballina Town,2020,35 - 39 years,0,2,2
Ballina Town,2020,40 - 44 years,0,1,1
Ballina Town,2020,45 - 49 years,0,1,1
Ballina Town,2020,5 - 9 years,0,0,0
Ballina Town,2020,50 - 54 years,1,0,1
Ballina Town,2020,55 - 59 years,2,3,5
Ballina Town,2020,60 - 64 years,1,3,4
Ballina Town,2020,65 - 69 years,4,8,12
Ballina Town,2020,70 - 74 years,5,9,14
Ballina Town,2020,75 - 79 years,3,6,9
Ballina Town,2020,80 - 84 years,2,7,9
Ballina Town,2020,85 years and over,17,13,30
Ballina Town,2020,Under 1 year,0,0,0
Ballinasloe Town,2007,1 - 4 years,0,0,0
Ballinasloe Town,2007,10 - 14 years,0,0,0
Ballinasloe Town,2007,15 - 19 years,0,0,0
Ballinasloe Town,2007,20 - 24 years,0,1,1
Ballinasloe Town,2007,25 - 29 years,1,0,1
Ballinasloe Town,2007,30 - 34 years,0,2,2
Ballinasloe Town,2007,35 - 39 years,0,0,0
Ballinasloe Town,2007,40 - 44 years,1,1,2
Ballinasloe Town,2007,45 - 49 years,0,1,1
Ballinasloe Town,2007,5 - 9 years,0,0,0
Ballinasloe Town,2007,50 - 54 years,0,2,2
Ballinasloe Town,2007,55 - 59 years,1,3,4
Ballinasloe Town,2007,60 - 64 years,3,7,10
Ballinasloe Town,2007,65 - 69 years,2,9,11
Ballinasloe Town,2007,70 - 74 years,7,8,15
Ballinasloe Town,2007,75 - 79 years,9,16,25
Ballinasloe Town,2007,80 - 84 years,11,12,23
Ballinasloe Town,2007,85 years and over,22,17,39
Ballinasloe Town,2007,Under 1 year,0,1,1
Ballinasloe Town,2008,1 - 4 years,0,0,0
Ballinasloe Town,2008,10 - 14 years,0,0,0
Ballinasloe Town,2008,15 - 19 years,0,1,1
Ballinasloe Town,2008,20 - 24 years,0,1,1
Ballinasloe Town,2008,25 - 29 years,1,2,3
Ballinasloe Town,2008,30 - 34 years,0,1,1
Ballinasloe Town,2008,35 - 39 years,2,2,4
Ballinasloe Town,2008,40 - 44 years,1,2,3
Ballinasloe Town,2008,45 - 49 years,1,5,6
Ballinasloe Town,2008,5 - 9 years,0,0,0
Ballinasloe Town,2008,50 - 54 years,2,1,3
Ballinasloe Town,2008,55 - 59 years,2,1,3
Ballinasloe Town,2008,60 - 64 years,1,5,6
Ballinasloe Town,2008,65 - 69 years,6,6,12
Ballinasloe Town,2008,70 - 74 years,4,12,16
Ballinasloe Town,2008,75 - 79 years,16,20,36
Ballinasloe Town,2008,80 - 84 years,13,22,35
Ballinasloe Town,2008,85 years and over,39,21,60
Ballinasloe Town,2008,Under 1 year,0,1,1
Ballinasloe Town,2009,1 - 4 years,0,0,0
Ballinasloe Town,2009,10 - 14 years,0,0,0
Ballinasloe Town,2009,15 - 19 years,0,1,1
Ballinasloe Town,2009,20 - 24 years,0,1,1
Ballinasloe Town,2009,25 - 29 years,1,2,3
Ballinasloe Town,2009,30 - 34 years,1,1,2
Ballinasloe Town,2009,35 - 39 years,2,2,4
Ballinasloe Town,2009,40 - 44 years,1,2,3
Ballinasloe Town,2009,45 - 49 years,1,5,6
Ballinasloe Town,2009,5 - 9 years,0,1,1
Ballinasloe Town,2009,50 - 54 years,1,3,4
Ballinasloe Town,2009,55 - 59 years,1,2,3
Ballinasloe Town,2009,60 - 64 years,1,3,4
Ballinasloe Town,2009,65 - 69 years,5,3,8
Ballinasloe Town,2009,70 - 74 years,4,2,6
Ballinasloe Town,2009,75 - 79 years,1,7,8
Ballinasloe Town,2009,80 - 84 years,10,4,14
Ballinasloe Town,2009,85 years and over,9,10,19
Ballinasloe Town,2009,Under 1 year,1,1,2
Ballinasloe Town,2010,1 - 4 years,0,0,0
Ballinasloe Town,2010,10 - 14 years,0,0,0
Ballinasloe Town,2010,15 - 19 years,0,1,1
Ballinasloe Town,2010,20 - 24 years,0,1,1
Ballinasloe Town,2010,25 - 29 years,1,2,3
Ballinasloe Town,2010,30 - 34 years,1,1,2
Ballinasloe Town,2010,35 - 39 years,2,1,3
Ballinasloe Town,2010,40 - 44 years,1,2,3
Ballinasloe Town,2010,45 - 49 years,1,1,2
Ballinasloe Town,2010,5 - 9 years,0,1,1
Ballinasloe Town,2010,50 - 54 years,1,1,2
Ballinasloe Town,2010,55 - 59 years,1,2,3
Ballinasloe Town,2010,60 - 64 years,3,2,5
Ballinasloe Town,2010,65 - 69 years,2,3,5
Ballinasloe Town,2010,70 - 74 years,4,6,10
Ballinasloe Town,2010,75 - 79 years,10,6,16
Ballinasloe Town,2010,80 - 84 years,1,7,8
Ballinasloe Town,2010,85 years and over,13,10,23
Ballinasloe Town,2010,Under 1 year,1,1,2
Ballinasloe Town,2011,1 - 4 years,0,0,0
Ballinasloe Town,2011,10 - 14 years,0,0,0
Ballinasloe Town,2011,15 - 19 years,0,0,0
Ballinasloe Town,2011,20 - 24 years,0,0,0
Ballinasloe Town,2011,25 - 29 years,0,0,0
Ballinasloe Town,2011,30 - 34 years,0,1,1
Ballinasloe Town,2011,35 - 39 years,0,0,0
Ballinasloe Town,2011,40 - 44 years,0,0,0
Ballinasloe Town,2011,45 - 49 years,1,0,1
Ballinasloe Town,2011,5 - 9 years,0,0,0
Ballinasloe Town,2011,50 - 54 years,0,1,1
Ballinasloe Town,2011,55 - 59 years,1,4,5
Ballinasloe Town,2011,60 - 64 years,1,0,1
Ballinasloe Town,2011,65 - 69 years,5,2,7
Ballinasloe Town,2011,70 - 74 years,0,0,0
Ballinasloe Town,2011,75 - 79 years,1,6,7
Ballinasloe Town,2011,80 - 84 years,1,3,4
Ballinasloe Town,2011,85 years and over,10,4,14
Ballinasloe Town,2011,Under 1 year,0,0,0
Ballinasloe Town,2012,1 - 4 years,0,0,0
Ballinasloe Town,2012,10 - 14 years,0,0,0
Ballinasloe Town,2012,15 - 19 years,0,0,0
Ballinasloe Town,2012,20 - 24 years,0,1,1
Ballinasloe Town,2012,25 - 29 years,0,0,0
Ballinasloe Town,2012,30 - 34 years,1,1,2
Ballinasloe Town,2012,35 - 39 years,0,2,2
Ballinasloe Town,2012,40 - 44 years,0,0,0
Ballinasloe Town,2012,45 - 49 years,2,3,5
Ballinasloe Town,2012,5 - 9 years,0,0,0
Ballinasloe Town,2012,50 - 54 years,2,5,7
Ballinasloe Town,2012,55 - 59 years,1,1,2
Ballinasloe Town,2012,60 - 64 years,4,0,4
Ballinasloe Town,2012,65 - 69 years,2,5,7
Ballinasloe Town,2012,70 - 74 years,5,7,12
Ballinasloe Town,2012,75 - 79 years,6,6,12
Ballinasloe Town,2012,80 - 84 years,11,4,15
Ballinasloe Town,2012,85 years and over,31,20,51
Ballinasloe Town,2012,Under 1 year,0,0,0
Ballinasloe Town,2013,1 - 4 years,0,0,0
Ballinasloe Town,2013,10 - 14 years,0,0,0
Ballinasloe Town,2013,15 - 19 years,0,0,0
Ballinasloe Town,2013,20 - 24 years,0,0,0
Ballinasloe Town,2013,25 - 29 years,0,0,0
Ballinasloe Town,2013,30 - 34 years,0,0,0
Ballinasloe Town,2013,35 - 39 years,0,0,0
Ballinasloe Town,2013,40 - 44 years,1,1,2
Ballinasloe Town,2013,45 - 49 years,0,2,2
Ballinasloe Town,2013,5 - 9 years,0,0,0
Ballinasloe Town,2013,50 - 54 years,1,2,3
Ballinasloe Town,2013,55 - 59 years,3,2,5
Ballinasloe Town,2013,60 - 64 years,0,0,0
Ballinasloe Town,2013,65 - 69 years,3,3,6
Ballinasloe Town,2013,70 - 74 years,4,6,10
Ballinasloe Town,2013,75 - 79 years,5,5,10
Ballinasloe Town,2013,80 - 84 years,8,9,17
Ballinasloe Town,2013,85 years and over,24,7,31
Ballinasloe Town,2013,Under 1 year,1,1,2
Ballinasloe Town,2014,1 - 4 years,0,0,0
Ballinasloe Town,2014,10 - 14 years,0,0,0
Ballinasloe Town,2014,15 - 19 years,0,0,0
Ballinasloe Town,2014,20 - 24 years,0,0,0
Ballinasloe Town,2014,25 - 29 years,0,1,1
Ballinasloe Town,2014,30 - 34 years,0,0,0
Ballinasloe Town,2014,35 - 39 years,0,0,0
Ballinasloe Town,2014,40 - 44 years,1,1,2
Ballinasloe Town,2014,45 - 49 years,1,2,3
Ballinasloe Town,2014,5 - 9 years,0,1,1
Ballinasloe Town,2014,50 - 54 years,1,1,2
Ballinasloe Town,2014,55 - 59 years,2,1,3
Ballinasloe Town,2014,60 - 64 years,3,2,5
Ballinasloe Town,2014,65 - 69 years,7,3,10
Ballinasloe Town,2014,70 - 74 years,2,2,4
Ballinasloe Town,2014,75 - 79 years,3,1,4
Ballinasloe Town,2014,80 - 84 years,7,6,13
Ballinasloe Town,2014,85 years and over,13,9,22
Ballinasloe Town,2014,Under 1 year,1,1,2
Ballinasloe Town,2015,1 - 4 years,0,0,0
Ballinasloe Town,2015,10 - 14 years,0,0,0
Ballinasloe Town,2015,15 - 19 years,0,0,0
Ballinasloe Town,2015,20 - 24 years,0,0,0
Ballinasloe Town,2015,25 - 29 years,0,1,1
Ballinasloe Town,2015,30 - 34 years,0,0,0
Ballinasloe Town,2015,35 - 39 years,0,0,0
Ballinasloe Town,2015,40 - 44 years,1,1,2
Ballinasloe Town,2015,45 - 49 years,1,2,3
Ballinasloe Town,2015,5 - 9 years,0,1,1
Ballinasloe Town,2015,50 - 54 years,1,1,2
Ballinasloe Town,2015,55 - 59 years,2,1,3
Ballinasloe Town,2015,60 - 64 years,3,2,5
Ballinasloe Town,2015,65 - 69 years,7,3,10
Ballinasloe Town,2015,70 - 74 years,2,2,4
Ballinasloe Town,2015,75 - 79 years,3,1,4
Ballinasloe Town,2015,80 - 84 years,7,6,13
Ballinasloe Town,2015,85 years and over,13,9,22
Ballinasloe Town,2015,Under 1 year,1,1,2
Ballinasloe Town,2016,1 - 4 years,0,0,0
Ballinasloe Town,2016,10 - 14 years,0,0,0
Ballinasloe Town,2016,15 - 19 years,0,0,0
Ballinasloe Town,2016,20 - 24 years,0,0,0
Ballinasloe Town,2016,25 - 29 years,0,1,1
Ballinasloe Town,2016,30 - 34 years,0,0,0
Ballinasloe Town,2016,35 - 39 years,0,0,0
Ballinasloe Town,2016,40 - 44 years,1,1,2
Ballinasloe Town,2016,45 - 49 years,1,2,3
Ballinasloe Town,2016,5 - 9 years,0,1,1
Ballinasloe Town,2016,50 - 54 years,1,1,2
Ballinasloe Town,2016,55 - 59 years,2,1,3
Ballinasloe Town,2016,60 - 64 years,3,2,5
Ballinasloe Town,2016,65 - 69 years,7,3,10
Ballinasloe Town,2016,70 - 74 years,2,2,4
Ballinasloe Town,2016,75 - 79 years,3,1,4
Ballinasloe Town,2016,80 - 84 years,7,6,13
Ballinasloe Town,2016,85 years and over,13,9,22
Ballinasloe Town,2016,Under 1 year,1,1,2
Ballinasloe Town,2017,1 - 4 years,0,0,0
Ballinasloe Town,2017,10 - 14 years,0,0,0
Ballinasloe Town,2017,15 - 19 years,0,0,0
Ballinasloe Town,2017,20 - 24 years,0,1,1
Ballinasloe Town,2017,25 - 29 years,0,1,1
Ballinasloe Town,2017,30 - 34 years,0,0,0
Ballinasloe Town,2017,35 - 39 years,1,0,1
Ballinasloe Town,2017,40 - 44 years,1,1,2
Ballinasloe Town,2017,45 - 49 years,1,4,5
Ballinasloe Town,2017,5 - 9 years,0,1,1
Ballinasloe Town,2017,50 - 54 years,1,1,2
Ballinasloe Town,2017,55 - 59 years,2,4,6
Ballinasloe Town,2017,60 - 64 years,1,2,3
Ballinasloe Town,2017,65 - 69 years,1,5,6
Ballinasloe Town,2017,70 - 74 years,1,3,4
Ballinasloe Town,2017,75 - 79 years,5,3,8
Ballinasloe Town,2017,80 - 84 years,10,6,16
Ballinasloe Town,2017,85 years and over,18,8,26
Ballinasloe Town,2017,Under 1 year,1,1,2
Ballinasloe Town,2018,1 - 4 years,0,0,0
Ballinasloe Town,2018,10 - 14 years,0,0,0
Ballinasloe Town,2018,15 - 19 years,0,0,0
Ballinasloe Town,2018,20 - 24 years,0,0,0
Ballinasloe Town,2018,25 - 29 years,0,0,0
Ballinasloe Town,2018,30 - 34 years,0,0,0
Ballinasloe Town,2018,35 - 39 years,0,1,1
Ballinasloe Town,2018,40 - 44 years,0,0,0
Ballinasloe Town,2018,45 - 49 years,0,0,0
Ballinasloe Town,2018,5 - 9 years,0,0,0
Ballinasloe Town,2018,50 - 54 years,1,1,2
Ballinasloe Town,2018,55 - 59 years,2,2,4
Ballinasloe Town,2018,60 - 64 years,1,2,3
Ballinasloe Town,2018,65 - 69 years,0,3,3
Ballinasloe Town,2018,70 - 74 years,4,5,9
Ballinasloe Town,2018,75 - 79 years,6,1,7
Ballinasloe Town,2018,80 - 84 years,5,9,14
Ballinasloe Town,2018,85 years and over,24,10,34
Ballinasloe Town,2018,Under 1 year,0,1,1
Ballinasloe Town,2019,1 - 4 years,0,0,0
Ballinasloe Town,2019,10 - 14 years,0,0,0
Ballinasloe Town,2019,15 - 19 years,0,0,0
Ballinasloe Town,2019,20 - 24 years,0,0,0
Ballinasloe Town,2019,25 - 29 years,0,0,0
Ballinasloe Town,2019,30 - 34 years,0,0,0
Ballinasloe Town,2019,35 - 39 years,0,1,1
Ballinasloe Town,2019,40 - 44 years,0,0,0
Ballinasloe Town,2019,45 - 49 years,0,0,0
Ballinasloe Town,2019,5 - 9 years,0,0,0
Ballinasloe Town,2019,50 - 54 years,1,1,2
Ballinasloe Town,2019,55 - 59 years,2,2,4
Ballinasloe Town,2019,60 - 64 years,1,2,3
Ballinasloe Town,2019,65 - 69 years,0,3,3
Ballinasloe Town,2019,70 - 74 years,4,5,9
Ballinasloe Town,2019,75 - 79 years,6,1,7
Ballinasloe Town,2019,80 - 84 years,5,9,14
Ballinasloe Town,2019,85 years and over,24,10,34
Ballinasloe Town,2019,Under 1 year,0,1,1
Ballinasloe Town,2020,1 - 4 years,0,0,0
Ballinasloe Town,2020,10 - 14 years,0,0,0
Ballinasloe Town,2020,15 - 19 years,0,0,0
Ballinasloe Town,2020,20 - 24 years,0,0,0
Ballinasloe Town,2020,25 - 29 years,0,0,0
Ballinasloe Town,2020,30 - 34 years,0,0,0
Ballinasloe Town,2020,35 - 39 years,0,1,1
Ballinasloe Town,2020,40 - 44 years,0,0,0
Ballinasloe Town,2020,45 - 49 years,0,0,0
Ballinasloe Town,2020,5 - 9 years,0,0,0
Ballinasloe Town,2020,50 - 54 years,1,1,2
Ballinasloe Town,2020,55 - 59 years,2,2,4
Ballinasloe Town,2020,60 - 64 years,1,2,3
Ballinasloe Town,2020,65 - 69 years,0,3,3
Ballinasloe Town,2020,70 - 74 years,4,5,9
Ballinasloe Town,2020,75 - 79 years,6,1,7
Ballinasloe Town,2020,80 - 84 years,5,9,14
Ballinasloe Town,2020,85 years and over,24,10,34
Ballinasloe Town,2020,Under 1 year,0,1,1
Birr Town,2007,1 - 4 years,0,0,0
Birr Town,2007,10 - 14 years,0,0,0
Birr Town,2007,15 - 19 years,0,1,1
Birr Town,2007,20 - 24 years,0,0,0
Birr Town,2007,25 - 29 years,0,0,0
Birr Town,2007,30 - 34 years,0,1,1
Birr Town,2007,35 - 39 years,0,0,0
Birr Town,2007,40 - 44 years,0,1,1
Birr Town,2007,45 - 49 years,0,1,1
Birr Town,2007,5 - 9 years,0,0,0
Birr Town,2007,50 - 54 years,0,1,1
Birr Town,2007,55 - 59 years,1,3,4
Birr Town,2007,60 - 64 years,2,2,4
Birr Town,2007,65 - 69 years,1,4,5
Birr Town,2007,70 - 74 years,2,5,7
Birr Town,2007,75 - 79 years,3,4,7
Birr Town,2007,80 - 84 years,4,9,13
Birr Town,2007,85 years and over,21,7,28
Birr Town,2007,Under 1 year,0,1,1
Birr Town,2008,1 - 4 years,0,0,0
Birr Town,2008,10 - 14 years,0,0,0
Birr Town,2008,15 - 19 years,0,1,1
Birr Town,2008,20 - 24 years,0,0,0
Birr Town,2008,25 - 29 years,0,1,1
Birr Town,2008,30 - 34 years,0,1,1
Birr Town,2008,35 - 39 years,0,1,1
Birr Town,2008,40 - 44 years,1,1,2
Birr Town,2008,45 - 49 years,3,1,4
Birr Town,2008,5 - 9 years,0,0,0
Birr Town,2008,50 - 54 years,1,2,3
Birr Town,2008,55 - 59 years,1,1,2
Birr Town,2008,60 - 64 years,2,1,3
Birr Town,2008,65 - 69 years,1,1,2
Birr Town,2008,70 - 74 years,2,2,4
Birr Town,2008,75 - 79 years,2,11,13
Birr Town,2008,80 - 84 years,6,10,16
Birr Town,2008,85 years and over,18,9,27
Birr Town,2008,Under 1 year,0,1,1
Birr Town,2009,1 - 4 years,0,0,0
Birr Town,2009,10 - 14 years,0,0,0
Birr Town,2009,15 - 19 years,0,1,1
Birr Town,2009,20 - 24 years,0,0,0
Birr Town,2009,25 - 29 years,0,1,1
Birr Town,2009,30 - 34 years,1,1,2
Birr Town,2009,35 - 39 years,0,1,1
Birr Town,2009,40 - 44 years,1,1,2
Birr Town,2009,45 - 49 years,3,2,5
Birr Town,2009,5 - 9 years,0,0,0
Birr Town,2009,50 - 54 years,1,1,2
Birr Town,2009,55 - 59 years,1,1,2
Birr Town,2009,60 - 64 years,2,2,4
Birr Town,2009,65 - 69 years,1,3,4
Birr Town,2009,70 - 74 years,1,3,4
Birr Town,2009,75 - 79 years,4,2,6
Birr Town,2009,80 - 84 years,7,1,8
Birr Town,2009,85 years and over,8,6,14
Birr Town,2009,Under 1 year,1,1,2
Birr Town,2010,1 - 4 years,0,0,0
Birr Town,2010,10 - 14 years,0,0,0
Birr Town,2010,15 - 19 years,2,1,3
Birr Town,2010,20 - 24 years,0,0,0
Birr Town,2010,25 - 29 years,0,1,1
Birr Town,2010,30 - 34 years,1,1,2
Birr Town,2010,35 - 39 years,0,1,1
Birr Town,2010,40 - 44 years,1,1,2
Birr Town,2010,45 - 49 years,1,2,3
Birr Town,2010,5 - 9 years,0,0,0
Birr Town,2010,50 - 54 years,1,1,2
Birr Town,2010,55 - 59 years,1,1,2
Birr Town,2010,60 - 64 years,2,1,3
Birr Town,2010,65 - 69 years,1,1,2
Birr Town,2010,70 - 74 years,1,1,2
Birr Town,2010,75 - 79 years,1,4,5
Birr Town,2010,80 - 84 years,3,6,9
Birr Town,2010,85 years and over,8,5,13
Birr Town,2010,Under 1 year,1,1,2
Birr Town,2011,1 - 4 years,0,0,0
Birr Town,2011,10 - 14 years,0,0,0
Birr Town,2011,15 - 19 years,0,0,0
Birr Town,2011,20 - 24 years,0,0,0
Birr Town,2011,25 - 29 years,0,0,0
Birr Town,2011,30 - 34 years,0,0,0
Birr Town,2011,35 - 39 years,0,1,1
Birr Town,2011,40 - 44 years,0,0,0
Birr Town,2011,45 - 49 years,0,0,0
Birr Town,2011,5 - 9 years,0,0,0
Birr Town,2011,50 - 54 years,1,1,2
Birr Town,2011,55 - 59 years,0,2,2
Birr Town,2011,60 - 64 years,0,1,1
Birr Town,2011,65 - 69 years,1,2,3
Birr Town,2011,70 - 74 years,0,1,1
Birr Town,2011,75 - 79 years,1,2,3
Birr Town,2011,80 - 84 years,3,1,4
Birr Town,2011,85 years and over,6,7,13
Birr Town,2011,Under 1 year,0,0,0
Birr Town,2012,1 - 4 years,0,0,0
Birr Town,2012,10 - 14 years,0,0,0
Birr Town,2012,15 - 19 years,0,0,0
Birr Town,2012,20 - 24 years,0,0,0
Birr Town,2012,25 - 29 years,0,0,0
Birr Town,2012,30 - 34 years,1,0,1
Birr Town,2012,35 - 39 years,0,1,1
Birr Town,2012,40 - 44 years,0,0,0
Birr Town,2012,45 - 49 years,0,0,0
Birr Town,2012,5 - 9 years,0,0,0
Birr Town,2012,50 - 54 years,1,1,2
Birr Town,2012,55 - 59 years,1,2,3
Birr Town,2012,60 - 64 years,1,1,2
Birr Town,2012,65 - 69 years,2,2,4
Birr Town,2012,70 - 74 years,3,4,7
Birr Town,2012,75 - 79 years,1,4,5
Birr Town,2012,80 - 84 years,1,2,3
Birr Town,2012,85 years and over,12,4,16
Birr Town,2012,Under 1 year,0,0,0
Birr Town,2013,1 - 4 years,0,0,0
Birr Town,2013,10 - 14 years,0,0,0
Birr Town,2013,15 - 19 years,0,0,0
Birr Town,2013,20 - 24 years,0,0,0
Birr Town,2013,25 - 29 years,0,0,0
Birr Town,2013,30 - 34 years,0,0,0
Birr Town,2013,35 - 39 years,0,0,0
Birr Town,2013,40 - 44 years,0,1,1
Birr Town,2013,45 - 49 years,0,1,1
Birr Town,2013,5 - 9 years,0,0,0
Birr Town,2013,50 - 54 years,0,0,0
Birr Town,2013,55 - 59 years,1,0,1
Birr Town,2013,60 - 64 years,1,1,2
Birr Town,2013,65 - 69 years,1,1,2
Birr Town,2013,70 - 74 years,2,0,2
Birr Town,2013,75 - 79 years,1,1,2
Birr Town,2013,80 - 84 years,3,7,10
Birr Town,2013,85 years and over,9,1,10
Birr Town,2013,Under 1 year,0,0,0
Birr Town,2014,1 - 4 years,0,0,0
Birr Town,2014,10 - 14 years,0,0,0
Birr Town,2014,15 - 19 years,0,0,0
Birr Town,2014,20 - 24 years,0,0,0
Birr Town,2014,25 - 29 years,0,0,0
Birr Town,2014,30 - 34 years,0,0,0
Birr Town,2014,35 - 39 years,0,0,0
Birr Town,2014,40 - 44 years,0,1,1
Birr Town,2014,45 - 49 years,0,1,1
Birr Town,2014,5 - 9 years,0,0,0
Birr Town,2014,50 - 54 years,0,1,1
Birr Town,2014,55 - 59 years,1,0,1
Birr Town,2014,60 - 64 years,1,1,2
Birr Town,2014,65 - 69 years,2,1,3
Birr Town,2014,70 - 74 years,2,1,3
Birr Town,2014,75 - 79 years,4,2,6
Birr Town,2014,80 - 84 years,2,2,4
Birr Town,2014,85 years and over,12,6,18
Birr Town,2014,Under 1 year,0,0,0
Birr Town,2015,1 - 4 years,0,0,0
Birr Town,2015,10 - 14 years,0,0,0
Birr Town,2015,15 - 19 years,0,0,0
Birr Town,2015,20 - 24 years,0,0,0
Birr Town,2015,25 - 29 years,0,0,0
Birr Town,2015,30 - 34 years,0,0,0
Birr Town,2015,35 - 39 years,0,0,0
Birr Town,2015,40 - 44 years,0,1,1
Birr Town,2015,45 - 49 years,0,1,1
Birr Town,2015,5 - 9 years,0,0,0
Birr Town,2015,50 - 54 years,0,1,1
Birr Town,2015,55 - 59 years,1,0,1
Birr Town,2015,60 - 64 years,1,1,2
Birr Town,2015,65 - 69 years,2,1,3
Birr Town,2015,70 - 74 years,2,1,3
Birr Town,2015,75 - 79 years,4,2,6
Birr Town,2015,80 - 84 years,2,2,4
Birr Town,2015,85 years and over,12,6,18
Birr Town,2015,Under 1 year,0,0,0
Birr Town,2016,1 - 4 years,0,0,0
Birr Town,2016,10 - 14 years,0,0,0
Birr Town,2016,15 - 19 years,0,0,0
Birr Town,2016,20 - 24 years,0,0,0
Birr Town,2016,25 - 29 years,0,0,0
Birr Town,2016,30 - 34 years,0,0,0
Birr Town,2016,35 - 39 years,0,0,0
Birr Town,2016,40 - 44 years,0,1,1
Birr Town,2016,45 - 49 years,0,1,1
Birr Town,2016,5 - 9 years,0,0,0
Birr Town,2016,50 - 54 years,0,1,1
Birr Town,2016,55 - 59 years,1,0,1
Birr Town,2016,60 - 64 years,1,1,2
Birr Town,2016,65 - 69 years,2,1,3
Birr Town,2016,70 - 74 years,2,1,3
Birr Town,2016,75 - 79 years,4,2,6
Birr Town,2016,80 - 84 years,2,2,4
Birr Town,2016,85 years and over,12,6,18
Birr Town,2016,Under 1 year,0,0,0
Birr Town,2017,1 - 4 years,0,0,0
Birr Town,2017,10 - 14 years,0,0,0
Birr Town,2017,15 - 19 years,0,0,0
Birr Town,2017,20 - 24 years,1,0,1
Birr Town,2017,25 - 29 years,0,1,1
Birr Town,2017,30 - 34 years,0,0,0
Birr Town,2017,35 - 39 years,0,0,0
Birr Town,2017,40 - 44 years,0,1,1
Birr Town,2017,45 - 49 years,0,1,1
Birr Town,2017,5 - 9 years,0,1,1
Birr Town,2017,50 - 54 years,1,2,3
Birr Town,2017,55 - 59 years,1,0,1
Birr Town,2017,60 - 64 years,4,1,5
Birr Town,2017,65 - 69 years,1,2,3
Birr Town,2017,70 - 74 years,1,3,4
Birr Town,2017,75 - 79 years,1,4,5
Birr Town,2017,80 - 84 years,7,6,13
Birr Town,2017,85 years and over,7,8,15
Birr Town,2017,Under 1 year,1,0,1
Birr Town,2018,1 - 4 years,0,0,0
Birr Town,2018,10 - 14 years,0,0,0
Birr Town,2018,15 - 19 years,0,0,0
Birr Town,2018,20 - 24 years,0,0,0
Birr Town,2018,25 - 29 years,0,0,0
Birr Town,2018,30 - 34 years,0,0,0
Birr Town,2018,35 - 39 years,0,0,0
Birr Town,2018,40 - 44 years,0,0,0
Birr Town,2018,45 - 49 years,0,0,0
Birr Town,2018,5 - 9 years,0,0,0
Birr Town,2018,50 - 54 years,1,3,4
Birr Town,2018,55 - 59 years,0,3,3
Birr Town,2018,60 - 64 years,2,0,2
Birr Town,2018,65 - 69 years,0,2,2
Birr Town,2018,70 - 74 years,1,2,3
Birr Town,2018,75 - 79 years,0,5,5
Birr Town,2018,80 - 84 years,2,3,5
Birr Town,2018,85 years and over,6,2,8
Birr Town,2018,Under 1 year,0,0,0
Birr Town,2019,1 - 4 years,0,0,0
Birr Town,2019,10 - 14 years,0,0,0
Birr Town,2019,15 - 19 years,0,0,0
Birr Town,2019,20 - 24 years,0,0,0
Birr Town,2019,25 - 29 years,0,0,0
Birr Town,2019,30 - 34 years,0,0,0
Birr Town,2019,35 - 39 years,0,0,0
Birr Town,2019,40 - 44 years,0,0,0
Birr Town,2019,45 - 49 years,0,0,0
Birr Town,2019,5 - 9 years,0,0,0
Birr Town,2019,50 - 54 years,1,3,4
Birr Town,2019,55 - 59 years,0,3,3
Birr Town,2019,60 - 64 years,2,0,2
Birr Town,2019,65 - 69 years,0,2,2
Birr Town,2019,70 - 74 years,1,2,3
Birr Town,2019,75 - 79 years,0,5,5
Birr Town,2019,80 - 84 years,2,3,5
Birr Town,2019,85 years and over,6,2,8
Birr Town,2019,Under 1 year,0,0,0
Birr Town,2020,1 - 4 years,0,0,0
Birr Town,2020,10 - 14 years,0,0,0
Birr Town,2020,15 - 19 years,0,0,0
Birr Town,2020,20 - 24 years,0,0,0
Birr Town,2020,25 - 29 years,0,0,0
Birr Town,2020,30 - 34 years,0,0,0
Birr Town,2020,35 - 39 years,0,0,0
Birr Town,2020,40 - 44 years,0,0,0
Birr Town,2020,45 - 49 years,0,0,0
Birr Town,2020,5 - 9 years,0,0,0
Birr Town,2020,50 - 54 years,1,3,4
Birr Town,2020,55 - 59 years,0,3,3
Birr Town,2020,60 - 64 years,2,0,2
Birr Town,2020,65 - 69 years,0,2,2
Birr Town,2020,70 - 74 years,1,2,3
Birr Town,2020,75 - 79 years,0,5,5
Birr Town,2020,80 - 84 years,2,3,5
Birr Town,2020,85 years and over,6,2,8
Birr Town,2020,Under 1 year,0,0,0
Bray Town,2007,1 - 4 years,0,0,0
Bray Town,2007,10 - 14 years,0,0,0
Bray Town,2007,15 - 19 years,1,1,2
Bray Town,2007,20 - 24 years,1,1,2
Bray Town,2007,25 - 29 years,0,1,1
Bray Town,2007,30 - 34 years,0,2,2
Bray Town,2007,35 - 39 years,3,0,3
Bray Town,2007,40 - 44 years,2,1,3
Bray Town,2007,45 - 49 years,2,3,5
Bray Town,2007,5 - 9 years,0,0,0
Bray Town,2007,50 - 54 years,3,1,4
Bray Town,2007,55 - 59 years,4,7,11
Bray Town,2007,60 - 64 years,8,5,13
Bray Town,2007,65 - 69 years,4,12,16
Bray Town,2007,70 - 74 years,9,11,20
Bray Town,2007,75 - 79 years,23,8,31
Bray Town,2007,80 - 84 years,18,14,32
Bray Town,2007,85 years and over,43,12,55
Bray Town,2007,Under 1 year,0,2,2
Bray Town,2008,1 - 4 years,0,0,0
Bray Town,2008,10 - 14 years,0,0,0
Bray Town,2008,15 - 19 years,1,1,2
Bray Town,2008,20 - 24 years,1,1,2
Bray Town,2008,25 - 29 years,0,1,1
Bray Town,2008,30 - 34 years,1,2,3
Bray Town,2008,35 - 39 years,3,0,3
Bray Town,2008,40 - 44 years,1,5,6
Bray Town,2008,45 - 49 years,5,3,8
Bray Town,2008,5 - 9 years,0,0,0
Bray Town,2008,50 - 54 years,3,3,6
Bray Town,2008,55 - 59 years,3,3,6
Bray Town,2008,60 - 64 years,5,6,11
Bray Town,2008,65 - 69 years,7,7,14
Bray Town,2008,70 - 74 years,10,10,20
Bray Town,2008,75 - 79 years,13,15,28
Bray Town,2008,80 - 84 years,22,12,34
Bray Town,2008,85 years and over,36,16,52
Bray Town,2008,Under 1 year,1,2,3
Bray Town,2009,1 - 4 years,0,0,0
Bray Town,2009,10 - 14 years,0,0,0
Bray Town,2009,15 - 19 years,1,1,2
Bray Town,2009,20 - 24 years,1,2,3
Bray Town,2009,25 - 29 years,0,1,1
Bray Town,2009,30 - 34 years,1,1,2
Bray Town,2009,35 - 39 years,3,1,4
Bray Town,2009,40 - 44 years,2,2,4
Bray Town,2009,45 - 49 years,3,1,4
Bray Town,2009,5 - 9 years,0,0,0
Bray Town,2009,50 - 54 years,4,4,8
Bray Town,2009,55 - 59 years,2,4,6
Bray Town,2009,60 - 64 years,3,13,16
Bray Town,2009,65 - 69 years,3,9,12
Bray Town,2009,70 - 74 years,9,18,27
Bray Town,2009,75 - 79 years,13,12,25
Bray Town,2009,80 - 84 years,21,13,34
Bray Town,2009,85 years and over,40,24,64
Bray Town,2009,Under 1 year,1,1,2
Bray Town,2010,1 - 4 years,0,0,0
Bray Town,2010,10 - 14 years,0,1,1
Bray Town,2010,15 - 19 years,1,1,2
Bray Town,2010,20 - 24 years,1,2,3
Bray Town,2010,25 - 29 years,0,1,1
Bray Town,2010,30 - 34 years,1,4,5
Bray Town,2010,35 - 39 years,1,3,4
Bray Town,2010,40 - 44 years,2,1,3
Bray Town,2010,45 - 49 years,3,4,7
Bray Town,2010,5 - 9 years,0,0,0
Bray Town,2010,50 - 54 years,2,7,9
Bray Town,2010,55 - 59 years,2,5,7
Bray Town,2010,60 - 64 years,5,10,15
Bray Town,2010,65 - 69 years,5,11,16
Bray Town,2010,70 - 74 years,11,15,26
Bray Town,2010,75 - 79 years,14,12,26
Bray Town,2010,80 - 84 years,14,18,32
Bray Town,2010,85 years and over,42,15,57
Bray Town,2010,Under 1 year,1,2,3
Bray Town,2011,1 - 4 years,0,0,0
Bray Town,2011,10 - 14 years,0,0,0
Bray Town,2011,15 - 19 years,0,0,0
Bray Town,2011,20 - 24 years,1,2,3
Bray Town,2011,25 - 29 years,0,2,2
Bray Town,2011,30 - 34 years,0,1,1
Bray Town,2011,35 - 39 years,0,3,3
Bray Town,2011,40 - 44 years,1,1,2
Bray Town,2011,45 - 49 years,1,0,1
Bray Town,2011,5 - 9 years,0,0,0
Bray Town,2011,50 - 54 years,2,2,4
Bray Town,2011,55 - 59 years,5,7,12
Bray Town,2011,60 - 64 years,2,9,11
Bray Town,2011,65 - 69 years,8,9,17
Bray Town,2011,70 - 74 years,6,10,16
Bray Town,2011,75 - 79 years,9,10,19
Bray Town,2011,80 - 84 years,24,14,38
Bray Town,2011,85 years and over,49,27,76
Bray Town,2011,Under 1 year,1,4,5
Bray Town,2012,1 - 4 years,0,0,0
Bray Town,2012,10 - 14 years,0,0,0
Bray Town,2012,15 - 19 years,0,1,1
Bray Town,2012,20 - 24 years,1,1,2
Bray Town,2012,25 - 29 years,1,2,3
Bray Town,2012,30 - 34 years,2,2,4
Bray Town,2012,35 - 39 years,1,1,2
Bray Town,2012,40 - 44 years,1,1,2
Bray Town,2012,45 - 49 years,2,3,5
Bray Town,2012,5 - 9 years,0,0,0
Bray Town,2012,50 - 54 years,4,3,7
Bray Town,2012,55 - 59 years,2,8,10
Bray Town,2012,60 - 64 years,8,7,15
Bray Town,2012,65 - 69 years,10,12,22
Bray Town,2012,70 - 74 years,10,12,22
Bray Town,2012,75 - 79 years,13,13,26
Bray Town,2012,80 - 84 years,15,16,31
Bray Town,2012,85 years and over,53,16,69
Bray Town,2012,Under 1 year,1,4,5
Bray Town,2013,1 - 4 years,0,0,0
Bray Town,2013,10 - 14 years,0,0,0
Bray Town,2013,15 - 19 years,0,0,0
Bray Town,2013,20 - 24 years,0,0,0
Bray Town,2013,25 - 29 years,0,0,0
Bray Town,2013,30 - 34 years,0,1,1
Bray Town,2013,35 - 39 years,0,3,3
Bray Town,2013,40 - 44 years,2,0,2
Bray Town,2013,45 - 49 years,3,3,6
Bray Town,2013,5 - 9 years,0,0,0
Bray Town,2013,50 - 54 years,0,3,3
Bray Town,2013,55 - 59 years,5,5,10
Bray Town,2013,60 - 64 years,7,11,18
Bray Town,2013,65 - 69 years,9,18,27
Bray Town,2013,70 - 74 years,5,10,15
Bray Town,2013,75 - 79 years,6,11,17
Bray Town,2013,80 - 84 years,12,23,35
Bray Town,2013,85 years and over,57,14,71
Bray Town,2013,Under 1 year,1,0,1
Bray Town,2014,1 - 4 years,0,0,0
Bray Town,2014,10 - 14 years,0,0,0
Bray Town,2014,15 - 19 years,0,1,1
Bray Town,2014,20 - 24 years,0,2,2
Bray Town,2014,25 - 29 years,0,0,0
Bray Town,2014,30 - 34 years,0,1,1
Bray Town,2014,35 - 39 years,1,2,3
Bray Town,2014,40 - 44 years,2,2,4
Bray Town,2014,45 - 49 years,3,4,7
Bray Town,2014,5 - 9 years,0,0,0
Bray Town,2014,50 - 54 years,3,1,4
Bray Town,2014,55 - 59 years,6,3,9
Bray Town,2014,60 - 64 years,5,3,8
Bray Town,2014,65 - 69 years,4,12,16
Bray Town,2014,70 - 74 years,8,9,17
Bray Town,2014,75 - 79 years,7,15,22
Bray Town,2014,80 - 84 years,15,23,38
Bray Town,2014,85 years and over,42,21,63
Bray Town,2014,Under 1 year,1,1,2
Bray Town,2015,1 - 4 years,0,0,0
Bray Town,2015,10 - 14 years,0,0,0
Bray Town,2015,15 - 19 years,0,1,1
Bray Town,2015,20 - 24 years,0,2,2
Bray Town,2015,25 - 29 years,0,0,0
Bray Town,2015,30 - 34 years,0,1,1
Bray Town,2015,35 - 39 years,1,2,3
Bray Town,2015,40 - 44 years,2,2,4
Bray Town,2015,45 - 49 years,3,4,7
Bray Town,2015,5 - 9 years,0,0,0
Bray Town,2015,50 - 54 years,3,1,4
Bray Town,2015,55 - 59 years,6,3,9
Bray Town,2015,60 - 64 years,5,3,8
Bray Town,2015,65 - 69 years,4,12,16
Bray Town,2015,70 - 74 years,8,9,17
Bray Town,2015,75 - 79 years,7,15,22
Bray Town,2015,80 - 84 years,15,23,38
Bray Town,2015,85 years and over,42,21,63
Bray Town,2015,Under 1 year,1,1,2
Bray Town,2016,1 - 4 years,0,0,0
Bray Town,2016,10 - 14 years,0,0,0
Bray Town,2016,15 - 19 years,0,1,1
Bray Town,2016,20 - 24 years,0,2,2
Bray Town,2016,25 - 29 years,0,0,0
Bray Town,2016,30 - 34 years,0,1,1
Bray Town,2016,35 - 39 years,1,2,3
Bray Town,2016,40 - 44 years,2,2,4
Bray Town,2016,45 - 49 years,3,4,7
Bray Town,2016,5 - 9 years,0,0,0
Bray Town,2016,50 - 54 years,3,1,4
Bray Town,2016,55 - 59 years,6,3,9
Bray Town,2016,60 - 64 years,5,3,8
Bray Town,2016,65 - 69 years,4,12,16
Bray Town,2016,70 - 74 years,8,9,17
Bray Town,2016,75 - 79 years,7,15,22
Bray Town,2016,80 - 84 years,15,23,38
Bray Town,2016,85 years and over,42,21,63
Bray Town,2016,Under 1 year,1,1,2
Bray Town,2017,1 - 4 years,1,0,1
Bray Town,2017,10 - 14 years,0,0,0
Bray Town,2017,15 - 19 years,0,1,1
Bray Town,2017,20 - 24 years,1,2,3
Bray Town,2017,25 - 29 years,0,1,1
Bray Town,2017,30 - 34 years,1,1,2
Bray Town,2017,35 - 39 years,1,2,3
Bray Town,2017,40 - 44 years,2,2,4
Bray Town,2017,45 - 49 years,3,1,4
Bray Town,2017,5 - 9 years,0,0,0
Bray Town,2017,50 - 54 years,1,4,5
Bray Town,2017,55 - 59 years,4,8,12
Bray Town,2017,60 - 64 years,6,9,15
Bray Town,2017,65 - 69 years,7,10,17
Bray Town,2017,70 - 74 years,7,16,23
Bray Town,2017,75 - 79 years,10,24,34
Bray Town,2017,80 - 84 years,23,21,44
Bray Town,2017,85 years and over,49,28,77
Bray Town,2017,Under 1 year,1,1,2
Bray Town,2018,1 - 4 years,0,0,0
Bray Town,2018,10 - 14 years,0,1,1
Bray Town,2018,15 - 19 years,0,0,0
Bray Town,2018,20 - 24 years,0,0,0
Bray Town,2018,25 - 29 years,2,0,2
Bray Town,2018,30 - 34 years,3,1,4
Bray Town,2018,35 - 39 years,1,0,1
Bray Town,2018,40 - 44 years,1,1,2
Bray Town,2018,45 - 49 years,2,0,2
Bray Town,2018,5 - 9 years,0,0,0
Bray Town,2018,50 - 54 years,3,3,6
Bray Town,2018,55 - 59 years,6,5,11
Bray Town,2018,60 - 64 years,4,12,16
Bray Town,2018,65 - 69 years,9,16,25
Bray Town,2018,70 - 74 years,11,15,26
Bray Town,2018,75 - 79 years,13,12,25
Bray Town,2018,80 - 84 years,16,19,35
Bray Town,2018,85 years and over,46,22,68
Bray Town,2018,Under 1 year,0,0,0
Bray Town,2019,1 - 4 years,0,0,0
Bray Town,2019,10 - 14 years,0,1,1
Bray Town,2019,15 - 19 years,0,0,0
Bray Town,2019,20 - 24 years,0,0,0
Bray Town,2019,25 - 29 years,2,0,2
Bray Town,2019,30 - 34 years,3,1,4
Bray Town,2019,35 - 39 years,1,0,1
Bray Town,2019,40 - 44 years,1,1,2
Bray Town,2019,45 - 49 years,2,0,2
Bray Town,2019,5 - 9 years,0,0,0
Bray Town,2019,50 - 54 years,3,3,6
Bray Town,2019,55 - 59 years,6,5,11
Bray Town,2019,60 - 64 years,4,12,16
Bray Town,2019,65 - 69 years,9,16,25
Bray Town,2019,70 - 74 years,11,15,26
Bray Town,2019,75 - 79 years,13,12,25
Bray Town,2019,80 - 84 years,16,19,35
Bray Town,2019,85 years and over,46,22,68
Bray Town,2019,Under 1 year,0,0,0
Bray Town,2020,1 - 4 years,0,0,0
Bray Town,2020,10 - 14 years,0,1,1
Bray Town,2020,15 - 19 years,0,0,0
Bray Town,2020,20 - 24 years,0,0,0
Bray Town,2020,25 - 29 years,2,0,2
Bray Town,2020,30 - 34 years,3,1,4
Bray Town,2020,35 - 39 years,1,0,1
Bray Town,2020,40 - 44 years,1,1,2
Bray Town,2020,45 - 49 years,2,0,2
Bray Town,2020,5 - 9 years,0,0,0
Bray Town,2020,50 - 54 years,3,3,6
Bray Town,2020,55 - 59 years,6,5,11
Bray Town,2020,60 - 64 years,4,12,16
Bray Town,2020,65 - 69 years,9,16,25
Bray Town,2020,70 - 74 years,11,15,26
Bray Town,2020,75 - 79 years,13,12,25
Bray Town,2020,80 - 84 years,16,19,35
Bray Town,2020,85 years and over,46,22,68
Bray Town,2020,Under 1 year,0,0,0
Buncrana Town,2007,1 - 4 years,0,0,0
Buncrana Town,2007,10 - 14 years,0,0,0
Buncrana Town,2007,15 - 19 years,0,1,1
Buncrana Town,2007,20 - 24 years,0,0,0
Buncrana Town,2007,25 - 29 years,0,1,1
Buncrana Town,2007,30 - 34 years,0,0,0
Buncrana Town,2007,35 - 39 years,0,0,0
Buncrana Town,2007,40 - 44 years,0,0,0
Buncrana Town,2007,45 - 49 years,1,0,1
Buncrana Town,2007,5 - 9 years,0,0,0
Buncrana Town,2007,50 - 54 years,0,0,0
Buncrana Town,2007,55 - 59 years,1,0,1
Buncrana Town,2007,60 - 64 years,0,2,2
Buncrana Town,2007,65 - 69 years,2,1,3
Buncrana Town,2007,70 - 74 years,1,1,2
Buncrana Town,2007,75 - 79 years,2,1,3
Buncrana Town,2007,80 - 84 years,5,2,7
Buncrana Town,2007,85 years and over,7,7,14
Buncrana Town,2007,Under 1 year,0,0,0
Buncrana Town,2008,1 - 4 years,0,0,0
Buncrana Town,2008,10 - 14 years,0,0,0
Buncrana Town,2008,15 - 19 years,1,1,2
Buncrana Town,2008,20 - 24 years,0,0,0
Buncrana Town,2008,25 - 29 years,1,1,2
Buncrana Town,2008,30 - 34 years,0,0,0
Buncrana Town,2008,35 - 39 years,0,0,0
Buncrana Town,2008,40 - 44 years,0,0,0
Buncrana Town,2008,45 - 49 years,1,0,1
Buncrana Town,2008,5 - 9 years,0,0,0
Buncrana Town,2008,50 - 54 years,0,2,2
Buncrana Town,2008,55 - 59 years,1,1,2
Buncrana Town,2008,60 - 64 years,0,1,1
Buncrana Town,2008,65 - 69 years,2,1,3
Buncrana Town,2008,70 - 74 years,1,1,2
Buncrana Town,2008,75 - 79 years,5,4,9
Buncrana Town,2008,80 - 84 years,3,2,5
Buncrana Town,2008,85 years and over,9,5,14
Buncrana Town,2008,Under 1 year,0,0,0
Buncrana Town,2009,1 - 4 years,0,0,0
Buncrana Town,2009,10 - 14 years,0,0,0
Buncrana Town,2009,15 - 19 years,1,1,2
Buncrana Town,2009,20 - 24 years,0,0,0
Buncrana Town,2009,25 - 29 years,1,1,2
Buncrana Town,2009,30 - 34 years,0,1,1
Buncrana Town,2009,35 - 39 years,0,0,0
Buncrana Town,2009,40 - 44 years,0,0,0
Buncrana Town,2009,45 - 49 years,2,0,2
Buncrana Town,2009,5 - 9 years,0,0,0
Buncrana Town,2009,50 - 54 years,0,2,2
Buncrana Town,2009,55 - 59 years,1,1,2
Buncrana Town,2009,60 - 64 years,1,1,2
Buncrana Town,2009,65 - 69 years,2,1,3
Buncrana Town,2009,70 - 74 years,1,1,2
Buncrana Town,2009,75 - 79 years,4,1,5
Buncrana Town,2009,80 - 84 years,4,2,6
Buncrana Town,2009,85 years and over,10,4,14
Buncrana Town,2009,Under 1 year,1,1,2
Buncrana Town,2010,1 - 4 years,0,0,0
Buncrana Town,2010,10 - 14 years,0,0,0
Buncrana Town,2010,15 - 19 years,1,1,2
Buncrana Town,2010,20 - 24 years,0,0,0
Buncrana Town,2010,25 - 29 years,1,1,2
Buncrana Town,2010,30 - 34 years,0,1,1
Buncrana Town,2010,35 - 39 years,0,0,0
Buncrana Town,2010,40 - 44 years,0,0,0
Buncrana Town,2010,45 - 49 years,2,2,4
Buncrana Town,2010,5 - 9 years,0,0,0
Buncrana Town,2010,50 - 54 years,0,2,2
Buncrana Town,2010,55 - 59 years,1,1,2
Buncrana Town,2010,60 - 64 years,2,2,4
Buncrana Town,2010,65 - 69 years,2,1,3
Buncrana Town,2010,70 - 74 years,1,1,2
Buncrana Town,2010,75 - 79 years,2,2,4
Buncrana Town,2010,80 - 84 years,3,3,6
Buncrana Town,2010,85 years and over,7,2,9
Buncrana Town,2010,Under 1 year,1,1,2
Buncrana Town,2011,1 - 4 years,0,0,0
Buncrana Town,2011,10 - 14 years,0,0,0
Buncrana Town,2011,15 - 19 years,0,0,0
Buncrana Town,2011,20 - 24 years,0,0,0
Buncrana Town,2011,25 - 29 years,0,0,0
Buncrana Town,2011,30 - 34 years,0,0,0
Buncrana Town,2011,35 - 39 years,0,0,0
Buncrana Town,2011,40 - 44 years,0,1,1
Buncrana Town,2011,45 - 49 years,1,2,3
Buncrana Town,2011,5 - 9 years,0,0,0
Buncrana Town,2011,50 - 54 years,0,1,1
Buncrana Town,2011,55 - 59 years,0,1,1
Buncrana Town,2011,60 - 64 years,1,1,2
Buncrana Town,2011,65 - 69 years,1,1,2
Buncrana Town,2011,70 - 74 years,2,1,3
Buncrana Town,2011,75 - 79 years,1,7,8
Buncrana Town,2011,80 - 84 years,2,3,5
Buncrana Town,2011,85 years and over,9,3,12
Buncrana Town,2011,Under 1 year,0,0,0
Buncrana Town,2012,1 - 4 years,0,0,0
Buncrana Town,2012,10 - 14 years,0,0,0
Buncrana Town,2012,15 - 19 years,0,0,0
Buncrana Town,2012,20 - 24 years,0,0,0
Buncrana Town,2012,25 - 29 years,0,0,0
Buncrana Town,2012,30 - 34 years,0,0,0
Buncrana Town,2012,35 - 39 years,0,0,0
Buncrana Town,2012,40 - 44 years,0,1,1
Buncrana Town,2012,45 - 49 years,1,2,3
Buncrana Town,2012,5 - 9 years,0,0,0
Buncrana Town,2012,50 - 54 years,1,1,2
Buncrana Town,2012,55 - 59 years,0,1,1
Buncrana Town,2012,60 - 64 years,4,3,7
Buncrana Town,2012,65 - 69 years,2,1,3
Buncrana Town,2012,70 - 74 years,3,2,5
Buncrana Town,2012,75 - 79 years,2,8,10
Buncrana Town,2012,80 - 84 years,9,3,12
Buncrana Town,2012,85 years and over,8,5,13
Buncrana Town,2012,Under 1 year,0,0,0
Buncrana Town,2013,1 - 4 years,0,0,0
Buncrana Town,2013,10 - 14 years,0,0,0
Buncrana Town,2013,15 - 19 years,0,0,0
Buncrana Town,2013,20 - 24 years,0,0,0
Buncrana Town,2013,25 - 29 years,0,0,0
Buncrana Town,2013,30 - 34 years,0,0,0
Buncrana Town,2013,35 - 39 years,0,0,0
Buncrana Town,2013,40 - 44 years,1,0,1
Buncrana Town,2013,45 - 49 years,0,1,1
Buncrana Town,2013,5 - 9 years,0,0,0
Buncrana Town,2013,50 - 54 years,0,0,0
Buncrana Town,2013,55 - 59 years,1,1,2
Buncrana Town,2013,60 - 64 years,1,1,2
Buncrana Town,2013,65 - 69 years,1,2,3
Buncrana Town,2013,70 - 74 years,3,3,6
Buncrana Town,2013,75 - 79 years,1,2,3
Buncrana Town,2013,80 - 84 years,5,3,8
Buncrana Town,2013,85 years and over,4,3,7
Buncrana Town,2013,Under 1 year,0,0,0
Buncrana Town,2014,1 - 4 years,0,0,0
Buncrana Town,2014,10 - 14 years,0,0,0
Buncrana Town,2014,15 - 19 years,0,0,0
Buncrana Town,2014,20 - 24 years,0,0,0
Buncrana Town,2014,25 - 29 years,0,0,0
Buncrana Town,2014,30 - 34 years,0,0,0
Buncrana Town,2014,35 - 39 years,0,1,1
Buncrana Town,2014,40 - 44 years,1,0,1
Buncrana Town,2014,45 - 49 years,1,1,2
Buncrana Town,2014,5 - 9 years,0,0,0
Buncrana Town,2014,50 - 54 years,1,0,1
Buncrana Town,2014,55 - 59 years,1,1,2
Buncrana Town,2014,60 - 64 years,1,5,6
Buncrana Town,2014,65 - 69 years,2,5,7
Buncrana Town,2014,70 - 74 years,3,1,4
Buncrana Town,2014,75 - 79 years,3,2,5
Buncrana Town,2014,80 - 84 years,3,1,4
Buncrana Town,2014,85 years and over,9,4,13
Buncrana Town,2014,Under 1 year,0,0,0
Buncrana Town,2015,1 - 4 years,0,0,0
Buncrana Town,2015,10 - 14 years,0,0,0
Buncrana Town,2015,15 - 19 years,0,0,0
Buncrana Town,2015,20 - 24 years,0,0,0
Buncrana Town,2015,25 - 29 years,0,0,0
Buncrana Town,2015,30 - 34 years,0,0,0
Buncrana Town,2015,35 - 39 years,0,1,1
Buncrana Town,2015,40 - 44 years,1,0,1
Buncrana Town,2015,45 - 49 years,1,1,2
Buncrana Town,2015,5 - 9 years,0,0,0
Buncrana Town,2015,50 - 54 years,1,0,1
Buncrana Town,2015,55 - 59 years,1,1,2
Buncrana Town,2015,60 - 64 years,1,5,6
Buncrana Town,2015,65 - 69 years,2,5,7
Buncrana Town,2015,70 - 74 years,3,1,4
Buncrana Town,2015,75 - 79 years,3,2,5
Buncrana Town,2015,80 - 84 years,3,1,4
Buncrana Town,2015,85 years and over,9,4,13
Buncrana Town,2015,Under 1 year,0,0,0
Buncrana Town,2016,1 - 4 years,0,0,0
Buncrana Town,2016,10 - 14 years,0,0,0
Buncrana Town,2016,15 - 19 years,0,0,0
Buncrana Town,2016,20 - 24 years,0,0,0
Buncrana Town,2016,25 - 29 years,0,0,0
Buncrana Town,2016,30 - 34 years,0,0,0
Buncrana Town,2016,35 - 39 years,0,1,1
Buncrana Town,2016,40 - 44 years,1,0,1
Buncrana Town,2016,45 - 49 years,1,1,2
Buncrana Town,2016,5 - 9 years,0,0,0
Buncrana Town,2016,50 - 54 years,1,0,1
Buncrana Town,2016,55 - 59 years,1,1,2
Buncrana Town,2016,60 - 64 years,1,5,6
Buncrana Town,2016,65 - 69 years,2,5,7
Buncrana Town,2016,70 - 74 years,3,1,4
Buncrana Town,2016,75 - 79 years,3,2,5
Buncrana Town,2016,80 - 84 years,3,1,4
Buncrana Town,2016,85 years and over,9,4,13
Buncrana Town,2016,Under 1 year,0,0,0
Buncrana Town,2017,1 - 4 years,0,0,0
Buncrana Town,2017,10 - 14 years,0,0,0
Buncrana Town,2017,15 - 19 years,0,0,0
Buncrana Town,2017,20 - 24 years,0,0,0
Buncrana Town,2017,25 - 29 years,0,0,0
Buncrana Town,2017,30 - 34 years,0,0,0
Buncrana Town,2017,35 - 39 years,0,1,1
Buncrana Town,2017,40 - 44 years,1,0,1
Buncrana Town,2017,45 - 49 years,1,1,2
Buncrana Town,2017,5 - 9 years,0,0,0
Buncrana Town,2017,50 - 54 years,1,0,1
Buncrana Town,2017,55 - 59 years,1,1,2
Buncrana Town,2017,60 - 64 years,1,1,2
Buncrana Town,2017,65 - 69 years,1,1,2
Buncrana Town,2017,70 - 74 years,3,4,7
Buncrana Town,2017,75 - 79 years,1,2,3
Buncrana Town,2017,80 - 84 years,1,2,3
Buncrana Town,2017,85 years and over,6,5,11
Buncrana Town,2017,Under 1 year,0,0,0
Buncrana Town,2018,1 - 4 years,0,0,0
Buncrana Town,2018,10 - 14 years,0,0,0
Buncrana Town,2018,15 - 19 years,0,0,0
Buncrana Town,2018,20 - 24 years,0,0,0
Buncrana Town,2018,25 - 29 years,0,0,0
Buncrana Town,2018,30 - 34 years,0,0,0
Buncrana Town,2018,35 - 39 years,0,0,0
Buncrana Town,2018,40 - 44 years,0,0,0
Buncrana Town,2018,45 - 49 years,0,0,0
Buncrana Town,2018,5 - 9 years,0,0,0
Buncrana Town,2018,50 - 54 years,0,0,0
Buncrana Town,2018,55 - 59 years,0,0,0
Buncrana Town,2018,60 - 64 years,0,1,1
Buncrana Town,2018,65 - 69 years,1,0,1
Buncrana Town,2018,70 - 74 years,0,3,3
Buncrana Town,2018,75 - 79 years,2,2,4
Buncrana Town,2018,80 - 84 years,4,2,6
Buncrana Town,2018,85 years and over,6,3,9
Buncrana Town,2018,Under 1 year,0,0,0
Buncrana Town,2019,1 - 4 years,0,0,0
Buncrana Town,2019,10 - 14 years,0,0,0
Buncrana Town,2019,15 - 19 years,0,0,0
Buncrana Town,2019,20 - 24 years,0,0,0
Buncrana Town,2019,25 - 29 years,0,0,0
Buncrana Town,2019,30 - 34 years,0,0,0
Buncrana Town,2019,35 - 39 years,0,0,0
Buncrana Town,2019,40 - 44 years,0,0,0
Buncrana Town,2019,45 - 49 years,0,0,0
Buncrana Town,2019,5 - 9 years,0,0,0
Buncrana Town,2019,50 - 54 years,0,0,0
Buncrana Town,2019,55 - 59 years,0,0,0
Buncrana Town,2019,60 - 64 years,0,1,1
Buncrana Town,2019,65 - 69 years,1,0,1
Buncrana Town,2019,70 - 74 years,0,3,3
Buncrana Town,2019,75 - 79 years,2,2,4
Buncrana Town,2019,80 - 84 years,4,2,6
Buncrana Town,2019,85 years and over,6,3,9
Buncrana Town,2019,Under 1 year,0,0,0
Buncrana Town,2020,1 - 4 years,0,0,0
Buncrana Town,2020,10 - 14 years,0,0,0
Buncrana Town,2020,15 - 19 years,0,0,0
Buncrana Town,2020,20 - 24 years,0,0,0
Buncrana Town,2020,25 - 29 years,0,0,0
Buncrana Town,2020,30 - 34 years,0,0,0
Buncrana Town,2020,35 - 39 years,0,0,0
Buncrana Town,2020,40 - 44 years,0,0,0
Buncrana Town,2020,45 - 49 years,0,0,0
Buncrana Town,2020,5 - 9 years,0,0,0
Buncrana Town,2020,50 - 54 years,0,0,0
Buncrana Town,2020,55 - 59 years,0,0,0
Buncrana Town,2020,60 - 64 years,0,1,1
Buncrana Town,2020,65 - 69 years,1,0,1
Buncrana Town,2020,70 - 74 years,0,3,3
Buncrana Town,2020,75 - 79 years,2,2,4
Buncrana Town,2020,80 - 84 years,4,2,6
Buncrana Town,2020,85 years and over,6,3,9
Buncrana Town,2020,Under 1 year,0,0,0
Bundoran Town,2007,1 - 4 years,0,0,0
Bundoran Town,2007,10 - 14 years,0,0,0
Bundoran Town,2007,15 - 19 years,0,0,0
Bundoran Town,2007,20 - 24 years,0,0,0
Bundoran Town,2007,25 - 29 years,0,0,0
Bundoran Town,2007,30 - 34 years,0,0,0
Bundoran Town,2007,35 - 39 years,0,0,0
Bundoran Town,2007,40 - 44 years,0,0,0
Bundoran Town,2007,45 - 49 years,0,0,0
Bundoran Town,2007,5 - 9 years,0,0,0
Bundoran Town,2007,50 - 54 years,0,1,1
Bundoran Town,2007,55 - 59 years,0,1,1
Bundoran Town,2007,60 - 64 years,1,0,1
Bundoran Town,2007,65 - 69 years,0,2,2
Bundoran Town,2007,70 - 74 years,1,0,1
Bundoran Town,2007,75 - 79 years,2,2,4
Bundoran Town,2007,80 - 84 years,3,5,8
Bundoran Town,2007,85 years and over,8,2,10
Bundoran Town,2007,Under 1 year,0,0,0
Bundoran Town,2008,1 - 4 years,0,0,0
Bundoran Town,2008,10 - 14 years,0,0,0
Bundoran Town,2008,15 - 19 years,0,1,1
Bundoran Town,2008,20 - 24 years,0,0,0
Bundoran Town,2008,25 - 29 years,1,0,1
Bundoran Town,2008,30 - 34 years,0,0,0
Bundoran Town,2008,35 - 39 years,1,0,1
Bundoran Town,2008,40 - 44 years,0,0,0
Bundoran Town,2008,45 - 49 years,0,0,0
Bundoran Town,2008,5 - 9 years,0,0,0
Bundoran Town,2008,50 - 54 years,0,2,2
Bundoran Town,2008,55 - 59 years,1,3,4
Bundoran Town,2008,60 - 64 years,1,0,1
Bundoran Town,2008,65 - 69 years,1,2,3
Bundoran Town,2008,70 - 74 years,4,0,4
Bundoran Town,2008,75 - 79 years,4,2,6
Bundoran Town,2008,80 - 84 years,1,1,2
Bundoran Town,2008,85 years and over,14,5,19
Bundoran Town,2008,Under 1 year,0,1,1
Bundoran Town,2009,1 - 4 years,0,0,0
Bundoran Town,2009,10 - 14 years,0,0,0
Bundoran Town,2009,15 - 19 years,0,1,1
Bundoran Town,2009,20 - 24 years,0,0,0
Bundoran Town,2009,25 - 29 years,1,0,1
Bundoran Town,2009,30 - 34 years,0,0,0
Bundoran Town,2009,35 - 39 years,1,1,2
Bundoran Town,2009,40 - 44 years,0,2,2
Bundoran Town,2009,45 - 49 years,1,0,1
Bundoran Town,2009,5 - 9 years,0,0,0
Bundoran Town,2009,50 - 54 years,0,1,1
Bundoran Town,2009,55 - 59 years,1,2,3
Bundoran Town,2009,60 - 64 years,3,1,4
Bundoran Town,2009,65 - 69 years,1,2,3
Bundoran Town,2009,70 - 74 years,2,0,2
Bundoran Town,2009,75 - 79 years,1,2,3
Bundoran Town,2009,80 - 84 years,3,1,4
Bundoran Town,2009,85 years and over,6,5,11
Bundoran Town,2009,Under 1 year,0,1,1
Bundoran Town,2010,1 - 4 years,0,0,0
Bundoran Town,2010,10 - 14 years,0,0,0
Bundoran Town,2010,15 - 19 years,0,1,1
Bundoran Town,2010,20 - 24 years,0,0,0
Bundoran Town,2010,25 - 29 years,1,0,1
Bundoran Town,2010,30 - 34 years,0,0,0
Bundoran Town,2010,35 - 39 years,1,1,2
Bundoran Town,2010,40 - 44 years,0,1,1
Bundoran Town,2010,45 - 49 years,1,0,1
Bundoran Town,2010,5 - 9 years,0,0,0
Bundoran Town,2010,50 - 54 years,0,1,1
Bundoran Town,2010,55 - 59 years,1,2,3
Bundoran Town,2010,60 - 64 years,1,1,2
Bundoran Town,2010,65 - 69 years,1,2,3
Bundoran Town,2010,70 - 74 years,1,2,3
Bundoran Town,2010,75 - 79 years,1,1,2
Bundoran Town,2010,80 - 84 years,2,2,4
Bundoran Town,2010,85 years and over,12,3,15
Bundoran Town,2010,Under 1 year,0,1,1
Bundoran Town,2011,1 - 4 years,0,0,0
Bundoran Town,2011,10 - 14 years,0,0,0
Bundoran Town,2011,15 - 19 years,0,0,0
Bundoran Town,2011,20 - 24 years,0,1,1
Bundoran Town,2011,25 - 29 years,0,0,0
Bundoran Town,2011,30 - 34 years,0,0,0
Bundoran Town,2011,35 - 39 years,1,0,1
Bundoran Town,2011,40 - 44 years,0,0,0
Bundoran Town,2011,45 - 49 years,0,1,1
Bundoran Town,2011,5 - 9 years,0,0,0
Bundoran Town,2011,50 - 54 years,1,0,1
Bundoran Town,2011,55 - 59 years,0,0,0
Bundoran Town,2011,60 - 64 years,0,1,1
Bundoran Town,2011,65 - 69 years,0,0,0
Bundoran Town,2011,70 - 74 years,4,2,6
Bundoran Town,2011,75 - 79 years,2,0,2
Bundoran Town,2011,80 - 84 years,1,0,1
Bundoran Town,2011,85 years and over,3,3,6
Bundoran Town,2011,Under 1 year,0,0,0
Bundoran Town,2012,1 - 4 years,0,0,0
Bundoran Town,2012,10 - 14 years,0,0,0
Bundoran Town,2012,15 - 19 years,0,0,0
Bundoran Town,2012,20 - 24 years,0,1,1
Bundoran Town,2012,25 - 29 years,0,0,0
Bundoran Town,2012,30 - 34 years,0,0,0
Bundoran Town,2012,35 - 39 years,1,0,1
Bundoran Town,2012,40 - 44 years,1,0,1
Bundoran Town,2012,45 - 49 years,0,1,1
Bundoran Town,2012,5 - 9 years,0,0,0
Bundoran Town,2012,50 - 54 years,1,1,2
Bundoran Town,2012,55 - 59 years,0,2,2
Bundoran Town,2012,60 - 64 years,1,4,5
Bundoran Town,2012,65 - 69 years,2,3,5
Bundoran Town,2012,70 - 74 years,3,2,5
Bundoran Town,2012,75 - 79 years,4,5,9
Bundoran Town,2012,80 - 84 years,3,3,6
Bundoran Town,2012,85 years and over,8,3,11
Bundoran Town,2012,Under 1 year,0,0,0
Bundoran Town,2013,1 - 4 years,0,0,0
Bundoran Town,2013,10 - 14 years,0,0,0
Bundoran Town,2013,15 - 19 years,0,0,0
Bundoran Town,2013,20 - 24 years,0,0,0
Bundoran Town,2013,25 - 29 years,0,0,0
Bundoran Town,2013,30 - 34 years,0,0,0
Bundoran Town,2013,35 - 39 years,0,0,0
Bundoran Town,2013,40 - 44 years,0,0,0
Bundoran Town,2013,45 - 49 years,0,0,0
Bundoran Town,2013,5 - 9 years,0,0,0
Bundoran Town,2013,50 - 54 years,0,0,0
Bundoran Town,2013,55 - 59 years,0,1,1
Bundoran Town,2013,60 - 64 years,1,0,1
Bundoran Town,2013,65 - 69 years,0,1,1
Bundoran Town,2013,70 - 74 years,0,0,0
Bundoran Town,2013,75 - 79 years,2,1,3
Bundoran Town,2013,80 - 84 years,0,0,0
Bundoran Town,2013,85 years and over,1,3,4
Bundoran Town,2013,Under 1 year,0,0,0
Bundoran Town,2014,1 - 4 years,0,0,0
Bundoran Town,2014,10 - 14 years,0,0,0
Bundoran Town,2014,15 - 19 years,0,0,0
Bundoran Town,2014,20 - 24 years,0,0,0
Bundoran Town,2014,25 - 29 years,0,0,0
Bundoran Town,2014,30 - 34 years,0,0,0
Bundoran Town,2014,35 - 39 years,0,1,1
Bundoran Town,2014,40 - 44 years,0,0,0
Bundoran Town,2014,45 - 49 years,0,0,0
Bundoran Town,2014,5 - 9 years,0,0,0
Bundoran Town,2014,50 - 54 years,2,0,2
Bundoran Town,2014,55 - 59 years,0,1,1
Bundoran Town,2014,60 - 64 years,1,1,2
Bundoran Town,2014,65 - 69 years,0,1,1
Bundoran Town,2014,70 - 74 years,0,2,2
Bundoran Town,2014,75 - 79 years,2,1,3
Bundoran Town,2014,80 - 84 years,3,1,4
Bundoran Town,2014,85 years and over,1,2,3
Bundoran Town,2014,Under 1 year,0,2,2
Bundoran Town,2015,1 - 4 years,0,0,0
Bundoran Town,2015,10 - 14 years,0,0,0
Bundoran Town,2015,15 - 19 years,0,0,0
Bundoran Town,2015,20 - 24 years,0,0,0
Bundoran Town,2015,25 - 29 years,0,0,0
Bundoran Town,2015,30 - 34 years,0,0,0
Bundoran Town,2015,35 - 39 years,0,1,1
Bundoran Town,2015,40 - 44 years,0,0,0
Bundoran Town,2015,45 - 49 years,0,0,0
Bundoran Town,2015,5 - 9 years,0,0,0
Bundoran Town,2015,50 - 54 years,2,0,2
Bundoran Town,2015,55 - 59 years,0,1,1
Bundoran Town,2015,60 - 64 years,1,1,2
Bundoran Town,2015,65 - 69 years,0,1,1
Bundoran Town,2015,70 - 74 years,0,2,2
Bundoran Town,2015,75 - 79 years,2,1,3
Bundoran Town,2015,80 - 84 years,3,1,4
Bundoran Town,2015,85 years and over,1,2,3
Bundoran Town,2015,Under 1 year,0,2,2
Bundoran Town,2016,1 - 4 years,0,0,0
Bundoran Town,2016,10 - 14 years,0,0,0
Bundoran Town,2016,15 - 19 years,0,0,0
Bundoran Town,2016,20 - 24 years,0,0,0
Bundoran Town,2016,25 - 29 years,0,0,0
Bundoran Town,2016,30 - 34 years,0,0,0
Bundoran Town,2016,35 - 39 years,0,1,1
Bundoran Town,2016,40 - 44 years,0,0,0
Bundoran Town,2016,45 - 49 years,0,0,0
Bundoran Town,2016,5 - 9 years,0,0,0
Bundoran Town,2016,50 - 54 years,2,0,2
Bundoran Town,2016,55 - 59 years,0,1,1
Bundoran Town,2016,60 - 64 years,1,1,2
Bundoran Town,2016,65 - 69 years,0,1,1
Bundoran Town,2016,70 - 74 years,0,2,2
Bundoran Town,2016,75 - 79 years,2,1,3
Bundoran Town,2016,80 - 84 years,3,1,4
Bundoran Town,2016,85 years and over,1,2,3
Bundoran Town,2016,Under 1 year,0,2,2
Bundoran Town,2017,1 - 4 years,0,0,0
Bundoran Town,2017,10 - 14 years,0,0,0
Bundoran Town,2017,15 - 19 years,0,0,0
Bundoran Town,2017,20 - 24 years,0,0,0
Bundoran Town,2017,25 - 29 years,0,0,0
Bundoran Town,2017,30 - 34 years,0,0,0
Bundoran Town,2017,35 - 39 years,0,1,1
Bundoran Town,2017,40 - 44 years,1,0,1
Bundoran Town,2017,45 - 49 years,0,0,0
Bundoran Town,2017,5 - 9 years,0,0,0
Bundoran Town,2017,50 - 54 years,2,0,2
Bundoran Town,2017,55 - 59 years,0,1,1
Bundoran Town,2017,60 - 64 years,1,1,2
Bundoran Town,2017,65 - 69 years,0,1,1
Bundoran Town,2017,70 - 74 years,1,1,2
Bundoran Town,2017,75 - 79 years,1,1,2
Bundoran Town,2017,80 - 84 years,3,4,7
Bundoran Town,2017,85 years and over,5,2,7
Bundoran Town,2017,Under 1 year,0,2,2
Bundoran Town,2018,1 - 4 years,0,0,0
Bundoran Town,2018,10 - 14 years,0,0,0
Bundoran Town,2018,15 - 19 years,0,0,0
Bundoran Town,2018,20 - 24 years,0,0,0
Bundoran Town,2018,25 - 29 years,0,0,0
Bundoran Town,2018,30 - 34 years,0,0,0
Bundoran Town,2018,35 - 39 years,0,0,0
Bundoran Town,2018,40 - 44 years,0,0,0
Bundoran Town,2018,45 - 49 years,1,0,1
Bundoran Town,2018,5 - 9 years,0,0,0
Bundoran Town,2018,50 - 54 years,0,0,0
Bundoran Town,2018,55 - 59 years,0,1,1
Bundoran Town,2018,60 - 64 years,0,0,0
Bundoran Town,2018,65 - 69 years,2,1,3
Bundoran Town,2018,70 - 74 years,1,1,2
Bundoran Town,2018,75 - 79 years,1,3,4
Bundoran Town,2018,80 - 84 years,2,0,2
Bundoran Town,2018,85 years and over,3,3,6
Bundoran Town,2018,Under 1 year,0,0,0
Bundoran Town,2019,1 - 4 years,0,0,0
Bundoran Town,2019,10 - 14 years,0,0,0
Bundoran Town,2019,15 - 19 years,0,0,0
Bundoran Town,2019,20 - 24 years,0,0,0
Bundoran Town,2019,25 - 29 years,0,0,0
Bundoran Town,2019,30 - 34 years,0,0,0
Bundoran Town,2019,35 - 39 years,0,0,0
Bundoran Town,2019,40 - 44 years,0,0,0
Bundoran Town,2019,45 - 49 years,1,0,1
Bundoran Town,2019,5 - 9 years,0,0,0
Bundoran Town,2019,50 - 54 years,0,0,0
Bundoran Town,2019,55 - 59 years,0,1,1
Bundoran Town,2019,60 - 64 years,0,0,0
Bundoran Town,2019,65 - 69 years,2,1,3
Bundoran Town,2019,70 - 74 years,1,1,2
Bundoran Town,2019,75 - 79 years,1,3,4
Bundoran Town,2019,80 - 84 years,2,0,2
Bundoran Town,2019,85 years and over,3,3,6
Bundoran Town,2019,Under 1 year,0,0,0
Bundoran Town,2020,1 - 4 years,0,0,0
Bundoran Town,2020,10 - 14 years,0,0,0
Bundoran Town,2020,15 - 19 years,0,0,0
Bundoran Town,2020,20 - 24 years,0,0,0
Bundoran Town,2020,25 - 29 years,0,0,0
Bundoran Town,2020,30 - 34 years,0,0,0
Bundoran Town,2020,35 - 39 years,0,0,0
Bundoran Town,2020,40 - 44 years,0,0,0
Bundoran Town,2020,45 - 49 years,1,0,1
Bundoran Town,2020,5 - 9 years,0,0,0
Bundoran Town,2020,50 - 54 years,0,0,0
Bundoran Town,2020,55 - 59 years,0,1,1
Bundoran Town,2020,60 - 64 years,0,0,0
Bundoran Town,2020,65 - 69 years,2,1,3
Bundoran Town,2020,70 - 74 years,1,1,2
Bundoran Town,2020,75 - 79 years,1,3,4
Bundoran Town,2020,80 - 84 years,2,0,2
Bundoran Town,2020,85 years and over,3,3,6
Bundoran Town,2020,Under 1 year,0,0,0
Carlow,2007,1 - 4 years,0,3,3
Carlow,2007,10 - 14 years,0,0,0
Carlow,2007,15 - 19 years,0,1,1
Carlow,2007,20 - 24 years,0,5,5
Carlow,2007,25 - 29 years,0,5,5
Carlow,2007,30 - 34 years,0,2,2
Carlow,2007,35 - 39 years,0,3,3
Carlow,2007,40 - 44 years,0,5,5
Carlow,2007,45 - 49 years,3,2,5
Carlow,2007,5 - 9 years,0,0,0
Carlow,2007,50 - 54 years,6,8,14
Carlow,2007,55 - 59 years,7,10,17
Carlow,2007,60 - 64 years,9,9,18
Carlow,2007,65 - 69 years,8,15,23
Carlow,2007,70 - 74 years,13,17,30
Carlow,2007,75 - 79 years,25,30,55
Carlow,2007,80 - 84 years,31,20,51
Carlow,2007,85 years and over,52,34,86
Carlow,2007,Under 1 year,1,1,2
Carlow,2008,1 - 4 years,1,1,2
Carlow,2008,10 - 14 years,0,0,0
Carlow,2008,15 - 19 years,0,2,2
Carlow,2008,20 - 24 years,0,2,2
Carlow,2008,25 - 29 years,1,1,2
Carlow,2008,30 - 34 years,0,2,2
Carlow,2008,35 - 39 years,1,1,2
Carlow,2008,40 - 44 years,2,4,6
Carlow,2008,45 - 49 years,5,7,12
Carlow,2008,5 - 9 years,0,0,0
Carlow,2008,50 - 54 years,4,2,6
Carlow,2008,55 - 59 years,8,11,19
Carlow,2008,60 - 64 years,10,12,22
Carlow,2008,65 - 69 years,8,20,28
Carlow,2008,70 - 74 years,13,14,27
Carlow,2008,75 - 79 years,18,31,49
Carlow,2008,80 - 84 years,32,33,65
Carlow,2008,85 years and over,55,23,78
Carlow,2008,Under 1 year,1,3,4
Carlow,2009,1 - 4 years,1,1,2
Carlow,2009,10 - 14 years,0,0,0
Carlow,2009,15 - 19 years,0,2,2
Carlow,2009,20 - 24 years,2,2,4
Carlow,2009,25 - 29 years,2,2,4
Carlow,2009,30 - 34 years,0,1,1
Carlow,2009,35 - 39 years,1,4,5
Carlow,2009,40 - 44 years,1,4,5
Carlow,2009,45 - 49 years,5,4,9
Carlow,2009,5 - 9 years,0,0,0
Carlow,2009,50 - 54 years,4,6,10
Carlow,2009,55 - 59 years,3,8,11
Carlow,2009,60 - 64 years,8,14,22
Carlow,2009,65 - 69 years,12,21,33
Carlow,2009,70 - 74 years,14,19,33
Carlow,2009,75 - 79 years,17,36,53
Carlow,2009,80 - 84 years,41,26,67
Carlow,2009,85 years and over,59,45,104
Carlow,2009,Under 1 year,3,1,4
Carlow,2010,1 - 4 years,1,1,2
Carlow,2010,10 - 14 years,0,1,1
Carlow,2010,15 - 19 years,0,2,2
Carlow,2010,20 - 24 years,2,3,5
Carlow,2010,25 - 29 years,2,2,4
Carlow,2010,30 - 34 years,0,1,1
Carlow,2010,35 - 39 years,2,3,5
Carlow,2010,40 - 44 years,1,7,8
Carlow,2010,45 - 49 years,3,3,6
Carlow,2010,5 - 9 years,1,0,1
Carlow,2010,50 - 54 years,3,8,11
Carlow,2010,55 - 59 years,4,10,14
Carlow,2010,60 - 64 years,5,11,16
Carlow,2010,65 - 69 years,10,11,21
Carlow,2010,70 - 74 years,18,27,45
Carlow,2010,75 - 79 years,21,14,35
Carlow,2010,80 - 84 years,20,29,49
Carlow,2010,85 years and over,58,39,97
Carlow,2010,Under 1 year,3,3,6
Carlow,2011,1 - 4 years,0,0,0
Carlow,2011,10 - 14 years,0,0,0
Carlow,2011,15 - 19 years,1,0,1
Carlow,2011,20 - 24 years,0,3,3
Carlow,2011,25 - 29 years,2,0,2
Carlow,2011,30 - 34 years,2,2,4
Carlow,2011,35 - 39 years,3,8,11
Carlow,2011,40 - 44 years,3,2,5
Carlow,2011,45 - 49 years,2,5,7
Carlow,2011,5 - 9 years,0,0,0
Carlow,2011,50 - 54 years,6,4,10
Carlow,2011,55 - 59 years,6,9,15
Carlow,2011,60 - 64 years,9,11,20
Carlow,2011,65 - 69 years,15,9,24
Carlow,2011,70 - 74 years,13,29,42
Carlow,2011,75 - 79 years,18,36,54
Carlow,2011,80 - 84 years,31,28,59
Carlow,2011,85 years and over,67,30,97
Carlow,2011,Under 1 year,1,1,2
Carlow,2012,1 - 4 years,0,0,0
Carlow,2012,10 - 14 years,0,1,1
Carlow,2012,15 - 19 years,1,0,1
Carlow,2012,20 - 24 years,0,3,3
Carlow,2012,25 - 29 years,2,2,4
Carlow,2012,30 - 34 years,1,2,3
Carlow,2012,35 - 39 years,2,2,4
Carlow,2012,40 - 44 years,5,3,8
Carlow,2012,45 - 49 years,2,6,8
Carlow,2012,5 - 9 years,0,1,1
Carlow,2012,50 - 54 years,5,6,11
Carlow,2012,55 - 59 years,7,10,17
Carlow,2012,60 - 64 years,8,13,21
Carlow,2012,65 - 69 years,10,14,24
Carlow,2012,70 - 74 years,4,27,31
Carlow,2012,75 - 79 years,17,29,46
Carlow,2012,80 - 84 years,24,41,65
Carlow,2012,85 years and over,65,38,103
Carlow,2012,Under 1 year,1,1,2
Carlow,2013,1 - 4 years,0,1,1
Carlow,2013,10 - 14 years,0,0,0
Carlow,2013,15 - 19 years,1,2,3
Carlow,2013,20 - 24 years,1,0,1
Carlow,2013,25 - 29 years,0,3,3
Carlow,2013,30 - 34 years,0,1,1
Carlow,2013,35 - 39 years,1,3,4
Carlow,2013,40 - 44 years,3,6,9
Carlow,2013,45 - 49 years,0,2,2
Carlow,2013,5 - 9 years,1,1,2
Carlow,2013,50 - 54 years,4,7,11
Carlow,2013,55 - 59 years,7,9,16
Carlow,2013,60 - 64 years,9,19,28
Carlow,2013,65 - 69 years,7,21,28
Carlow,2013,70 - 74 years,13,27,40
Carlow,2013,75 - 79 years,28,29,57
Carlow,2013,80 - 84 years,24,36,60
Carlow,2013,85 years and over,64,36,100
Carlow,2013,Under 1 year,1,0,1
Carlow,2014,1 - 4 years,0,1,1
Carlow,2014,10 - 14 years,0,0,0
Carlow,2014,15 - 19 years,1,1,2
Carlow,2014,20 - 24 years,1,3,4
Carlow,2014,25 - 29 years,2,4,6
Carlow,2014,30 - 34 years,3,1,4
Carlow,2014,35 - 39 years,2,1,3
Carlow,2014,40 - 44 years,2,2,4
Carlow,2014,45 - 49 years,4,10,14
Carlow,2014,5 - 9 years,1,1,2
Carlow,2014,50 - 54 years,2,5,7
Carlow,2014,55 - 59 years,9,2,11
Carlow,2014,60 - 64 years,7,12,19
Carlow,2014,65 - 69 years,14,18,32
Carlow,2014,70 - 74 years,17,25,42
Carlow,2014,75 - 79 years,22,26,48
Carlow,2014,80 - 84 years,29,24,53
Carlow,2014,85 years and over,66,51,117
Carlow,2014,Under 1 year,2,2,4
Carlow,2015,1 - 4 years,0,1,1
Carlow,2015,10 - 14 years,0,0,0
Carlow,2015,15 - 19 years,2,2,4
Carlow,2015,20 - 24 years,1,3,4
Carlow,2015,25 - 29 years,2,3,5
Carlow,2015,30 - 34 years,3,3,6
Carlow,2015,35 - 39 years,1,5,6
Carlow,2015,40 - 44 years,4,5,9
Carlow,2015,45 - 49 years,1,3,4
Carlow,2015,5 - 9 years,1,1,2
Carlow,2015,50 - 54 years,3,10,13
Carlow,2015,55 - 59 years,6,5,11
Carlow,2015,60 - 64 years,7,14,21
Carlow,2015,65 - 69 years,13,18,31
Carlow,2015,70 - 74 years,14,28,42
Carlow,2015,75 - 79 years,21,31,52
Carlow,2015,80 - 84 years,27,36,63
Carlow,2015,85 years and over,71,57,128
Carlow,2015,Under 1 year,2,3,5
Carlow,2016,1 - 4 years,0,1,1
Carlow,2016,10 - 14 years,2,2,4
Carlow,2016,15 - 19 years,1,2,3
Carlow,2016,20 - 24 years,1,1,2
Carlow,2016,25 - 29 years,1,3,4
Carlow,2016,30 - 34 years,3,2,5
Carlow,2016,35 - 39 years,4,1,5
Carlow,2016,40 - 44 years,3,4,7
Carlow,2016,45 - 49 years,5,3,8
Carlow,2016,5 - 9 years,1,1,2
Carlow,2016,50 - 54 years,5,17,22
Carlow,2016,55 - 59 years,7,9,16
Carlow,2016,60 - 64 years,8,14,22
Carlow,2016,65 - 69 years,15,15,30
Carlow,2016,70 - 74 years,16,23,39
Carlow,2016,75 - 79 years,15,21,36
Carlow,2016,80 - 84 years,32,31,63
Carlow,2016,85 years and over,63,55,118
Carlow,2016,Under 1 year,2,1,3
Carlow,2017,1 - 4 years,0,1,1
Carlow,2017,10 - 14 years,2,2,4
Carlow,2017,15 - 19 years,1,1,2
Carlow,2017,20 - 24 years,1,1,2
Carlow,2017,25 - 29 years,1,3,4
Carlow,2017,30 - 34 years,3,1,4
Carlow,2017,35 - 39 years,1,2,3
Carlow,2017,40 - 44 years,1,2,3
Carlow,2017,45 - 49 years,3,4,7
Carlow,2017,5 - 9 years,1,1,2
Carlow,2017,50 - 54 years,4,6,10
Carlow,2017,55 - 59 years,4,11,15
Carlow,2017,60 - 64 years,8,8,16
Carlow,2017,65 - 69 years,13,21,34
Carlow,2017,70 - 74 years,15,18,33
Carlow,2017,75 - 79 years,19,31,50
Carlow,2017,80 - 84 years,21,26,47
Carlow,2017,85 years and over,68,52,120
Carlow,2017,Under 1 year,4,1,5
Carlow,2018,1 - 4 years,0,0,0
Carlow,2018,10 - 14 years,1,1,2
Carlow,2018,15 - 19 years,0,0,0
Carlow,2018,20 - 24 years,0,0,0
Carlow,2018,25 - 29 years,0,0,0
Carlow,2018,30 - 34 years,2,1,3
Carlow,2018,35 - 39 years,4,1,5
Carlow,2018,40 - 44 years,1,4,5
Carlow,2018,45 - 49 years,3,4,7
Carlow,2018,5 - 9 years,0,0,0
Carlow,2018,50 - 54 years,4,3,7
Carlow,2018,55 - 59 years,5,12,17
Carlow,2018,60 - 64 years,9,12,21
Carlow,2018,65 - 69 years,17,19,36
Carlow,2018,70 - 74 years,18,15,33
Carlow,2018,75 - 79 years,18,26,44
Carlow,2018,80 - 84 years,29,32,61
Carlow,2018,85 years and over,72,55,127
Carlow,2018,Under 1 year,0,1,1
Carlow,2019,1 - 4 years,0,0,0
Carlow,2019,10 - 14 years,0,0,0
Carlow,2019,15 - 19 years,0,1,1
Carlow,2019,20 - 24 years,0,0,0
Carlow,2019,25 - 29 years,1,0,1
Carlow,2019,30 - 34 years,1,1,2
Carlow,2019,35 - 39 years,3,0,3
Carlow,2019,40 - 44 years,1,3,4
Carlow,2019,45 - 49 years,5,4,9
Carlow,2019,5 - 9 years,0,0,0
Carlow,2019,50 - 54 years,2,4,6
Carlow,2019,55 - 59 years,10,11,21
Carlow,2019,60 - 64 years,4,15,19
Carlow,2019,65 - 69 years,8,20,28
Carlow,2019,70 - 74 years,20,19,39
Carlow,2019,75 - 79 years,20,21,41
Carlow,2019,80 - 84 years,27,32,59
Carlow,2019,85 years and over,64,55,119
Carlow,2019,Under 1 year,2,0,2
Carlow,2020,1 - 4 years,0,0,0
Carlow,2020,10 - 14 years,0,1,1
Carlow,2020,15 - 19 years,0,1,1
Carlow,2020,20 - 24 years,0,3,3
Carlow,2020,25 - 29 years,1,1,2
Carlow,2020,30 - 34 years,5,4,9
Carlow,2020,35 - 39 years,1,1,2
Carlow,2020,40 - 44 years,3,5,8
Carlow,2020,45 - 49 years,5,5,10
Carlow,2020,5 - 9 years,0,0,0
Carlow,2020,50 - 54 years,9,6,15
Carlow,2020,55 - 59 years,4,7,11
Carlow,2020,60 - 64 years,11,22,33
Carlow,2020,65 - 69 years,12,12,24
Carlow,2020,70 - 74 years,13,23,36
Carlow,2020,75 - 79 years,33,30,63
Carlow,2020,80 - 84 years,35,39,74
Carlow,2020,85 years and over,73,62,135
Carlow,2020,Under 1 year,2,0,2
Carlow Town,2007,1 - 4 years,0,2,2
Carlow Town,2007,10 - 14 years,0,0,0
Carlow Town,2007,15 - 19 years,0,0,0
Carlow Town,2007,20 - 24 years,0,1,1
Carlow Town,2007,25 - 29 years,0,2,2
Carlow Town,2007,30 - 34 years,0,1,1
Carlow Town,2007,35 - 39 years,0,0,0
Carlow Town,2007,40 - 44 years,0,1,1
Carlow Town,2007,45 - 49 years,1,1,2
Carlow Town,2007,5 - 9 years,0,0,0
Carlow Town,2007,50 - 54 years,3,1,4
Carlow Town,2007,55 - 59 years,1,2,3
Carlow Town,2007,60 - 64 years,2,4,6
Carlow Town,2007,65 - 69 years,3,4,7
Carlow Town,2007,70 - 74 years,3,2,5
Carlow Town,2007,75 - 79 years,5,7,12
Carlow Town,2007,80 - 84 years,6,6,12
Carlow Town,2007,85 years and over,11,9,20
Carlow Town,2007,Under 1 year,0,0,0
Carlow Town,2008,1 - 4 years,0,2,2
Carlow Town,2008,10 - 14 years,0,0,0
Carlow Town,2008,15 - 19 years,0,0,0
Carlow Town,2008,20 - 24 years,0,1,1
Carlow Town,2008,25 - 29 years,0,2,2
Carlow Town,2008,30 - 34 years,0,1,1
Carlow Town,2008,35 - 39 years,0,1,1
Carlow Town,2008,40 - 44 years,0,1,1
Carlow Town,2008,45 - 49 years,1,3,4
Carlow Town,2008,5 - 9 years,0,0,0
Carlow Town,2008,50 - 54 years,3,1,4
Carlow Town,2008,55 - 59 years,4,7,11
Carlow Town,2008,60 - 64 years,3,7,10
Carlow Town,2008,65 - 69 years,2,6,8
Carlow Town,2008,70 - 74 years,3,6,9
Carlow Town,2008,75 - 79 years,7,12,19
Carlow Town,2008,80 - 84 years,5,9,14
Carlow Town,2008,85 years and over,15,5,20
Carlow Town,2008,Under 1 year,0,1,1
Carlow Town,2009,1 - 4 years,1,2,3
Carlow Town,2009,10 - 14 years,0,0,0
Carlow Town,2009,15 - 19 years,0,1,1
Carlow Town,2009,20 - 24 years,0,1,1
Carlow Town,2009,25 - 29 years,1,1,2
Carlow Town,2009,30 - 34 years,0,1,1
Carlow Town,2009,35 - 39 years,0,1,1
Carlow Town,2009,40 - 44 years,0,2,2
Carlow Town,2009,45 - 49 years,2,1,3
Carlow Town,2009,5 - 9 years,0,0,0
Carlow Town,2009,50 - 54 years,1,4,5
Carlow Town,2009,55 - 59 years,1,1,2
Carlow Town,2009,60 - 64 years,3,1,4
Carlow Town,2009,65 - 69 years,4,6,10
Carlow Town,2009,70 - 74 years,7,5,12
Carlow Town,2009,75 - 79 years,9,9,18
Carlow Town,2009,80 - 84 years,13,6,19
Carlow Town,2009,85 years and over,20,8,28
Carlow Town,2009,Under 1 year,1,1,2
Carlow Town,2010,1 - 4 years,1,2,3
Carlow Town,2010,10 - 14 years,0,0,0
Carlow Town,2010,15 - 19 years,0,1,1
Carlow Town,2010,20 - 24 years,0,2,2
Carlow Town,2010,25 - 29 years,1,1,2
Carlow Town,2010,30 - 34 years,0,1,1
Carlow Town,2010,35 - 39 years,1,1,2
Carlow Town,2010,40 - 44 years,0,3,3
Carlow Town,2010,45 - 49 years,2,1,3
Carlow Town,2010,5 - 9 years,0,0,0
Carlow Town,2010,50 - 54 years,1,3,4
Carlow Town,2010,55 - 59 years,1,4,5
Carlow Town,2010,60 - 64 years,2,2,4
Carlow Town,2010,65 - 69 years,1,2,3
Carlow Town,2010,70 - 74 years,6,2,8
Carlow Town,2010,75 - 79 years,7,1,8
Carlow Town,2010,80 - 84 years,8,4,12
Carlow Town,2010,85 years and over,18,13,31
Carlow Town,2010,Under 1 year,1,1,2
Carlow Town,2011,1 - 4 years,0,0,0
Carlow Town,2011,10 - 14 years,0,0,0
Carlow Town,2011,15 - 19 years,0,0,0
Carlow Town,2011,20 - 24 years,0,1,1
Carlow Town,2011,25 - 29 years,1,0,1
Carlow Town,2011,30 - 34 years,0,0,0
Carlow Town,2011,35 - 39 years,1,4,5
Carlow Town,2011,40 - 44 years,1,2,3
Carlow Town,2011,45 - 49 years,0,4,4
Carlow Town,2011,5 - 9 years,0,0,0
Carlow Town,2011,50 - 54 years,4,0,4
Carlow Town,2011,55 - 59 years,1,5,6
Carlow Town,2011,60 - 64 years,3,7,10
Carlow Town,2011,65 - 69 years,6,2,8
Carlow Town,2011,70 - 74 years,4,9,13
Carlow Town,2011,75 - 79 years,4,8,12
Carlow Town,2011,80 - 84 years,9,7,16
Carlow Town,2011,85 years and over,21,5,26
Carlow Town,2011,Under 1 year,0,0,0
Carlow Town,2012,1 - 4 years,0,0,0
Carlow Town,2012,10 - 14 years,0,0,0
Carlow Town,2012,15 - 19 years,0,0,0
Carlow Town,2012,20 - 24 years,0,1,1
Carlow Town,2012,25 - 29 years,1,1,2
Carlow Town,2012,30 - 34 years,0,0,0
Carlow Town,2012,35 - 39 years,2,1,3
Carlow Town,2012,40 - 44 years,2,3,5
Carlow Town,2012,45 - 49 years,2,2,4
Carlow Town,2012,5 - 9 years,0,0,0
Carlow Town,2012,50 - 54 years,2,2,4
Carlow Town,2012,55 - 59 years,5,3,8
Carlow Town,2012,60 - 64 years,4,2,6
Carlow Town,2012,65 - 69 years,4,6,10
Carlow Town,2012,70 - 74 years,2,11,13
Carlow Town,2012,75 - 79 years,7,10,17
Carlow Town,2012,80 - 84 years,12,11,23
Carlow Town,2012,85 years and over,17,12,29
Carlow Town,2012,Under 1 year,0,1,1
Carlow Town,2013,1 - 4 years,0,0,0
Carlow Town,2013,10 - 14 years,0,0,0
Carlow Town,2013,15 - 19 years,1,2,3
Carlow Town,2013,20 - 24 years,0,0,0
Carlow Town,2013,25 - 29 years,0,1,1
Carlow Town,2013,30 - 34 years,0,0,0
Carlow Town,2013,35 - 39 years,0,2,2
Carlow Town,2013,40 - 44 years,3,3,6
Carlow Town,2013,45 - 49 years,0,1,1
Carlow Town,2013,5 - 9 years,0,0,0
Carlow Town,2013,50 - 54 years,0,1,1
Carlow Town,2013,55 - 59 years,3,4,7
Carlow Town,2013,60 - 64 years,2,4,6
Carlow Town,2013,65 - 69 years,2,7,9
Carlow Town,2013,70 - 74 years,7,10,17
Carlow Town,2013,75 - 79 years,9,14,23
Carlow Town,2013,80 - 84 years,9,17,26
Carlow Town,2013,85 years and over,15,5,20
Carlow Town,2013,Under 1 year,1,0,1
Carlow Town,2014,1 - 4 years,0,0,0
Carlow Town,2014,10 - 14 years,0,0,0
Carlow Town,2014,15 - 19 years,1,2,3
Carlow Town,2014,20 - 24 years,0,1,1
Carlow Town,2014,25 - 29 years,2,2,4
Carlow Town,2014,30 - 34 years,2,1,3
Carlow Town,2014,35 - 39 years,2,1,3
Carlow Town,2014,40 - 44 years,1,1,2
Carlow Town,2014,45 - 49 years,4,2,6
Carlow Town,2014,5 - 9 years,0,0,0
Carlow Town,2014,50 - 54 years,1,2,3
Carlow Town,2014,55 - 59 years,4,1,5
Carlow Town,2014,60 - 64 years,3,2,5
Carlow Town,2014,65 - 69 years,4,6,10
Carlow Town,2014,70 - 74 years,5,7,12
Carlow Town,2014,75 - 79 years,9,13,22
Carlow Town,2014,80 - 84 years,10,4,14
Carlow Town,2014,85 years and over,21,14,35
Carlow Town,2014,Under 1 year,1,0,1
Carlow Town,2015,1 - 4 years,0,0,0
Carlow Town,2015,10 - 14 years,0,0,0
Carlow Town,2015,15 - 19 years,1,2,3
Carlow Town,2015,20 - 24 years,0,1,1
Carlow Town,2015,25 - 29 years,2,2,4
Carlow Town,2015,30 - 34 years,2,1,3
Carlow Town,2015,35 - 39 years,2,1,3
Carlow Town,2015,40 - 44 years,1,1,2
Carlow Town,2015,45 - 49 years,4,2,6
Carlow Town,2015,5 - 9 years,0,0,0
Carlow Town,2015,50 - 54 years,1,2,3
Carlow Town,2015,55 - 59 years,4,1,5
Carlow Town,2015,60 - 64 years,3,2,5
Carlow Town,2015,65 - 69 years,4,6,10
Carlow Town,2015,70 - 74 years,5,7,12
Carlow Town,2015,75 - 79 years,9,13,22
Carlow Town,2015,80 - 84 years,10,4,14
Carlow Town,2015,85 years and over,21,14,35
Carlow Town,2015,Under 1 year,1,0,1
Carlow Town,2016,1 - 4 years,0,0,0
Carlow Town,2016,10 - 14 years,0,0,0
Carlow Town,2016,15 - 19 years,1,2,3
Carlow Town,2016,20 - 24 years,0,1,1
Carlow Town,2016,25 - 29 years,2,2,4
Carlow Town,2016,30 - 34 years,2,1,3
Carlow Town,2016,35 - 39 years,2,1,3
Carlow Town,2016,40 - 44 years,1,1,2
Carlow Town,2016,45 - 49 years,4,2,6
Carlow Town,2016,5 - 9 years,0,0,0
Carlow Town,2016,50 - 54 years,1,2,3
Carlow Town,2016,55 - 59 years,4,1,5
Carlow Town,2016,60 - 64 years,3,2,5
Carlow Town,2016,65 - 69 years,4,6,10
Carlow Town,2016,70 - 74 years,5,7,12
Carlow Town,2016,75 - 79 years,9,13,22
Carlow Town,2016,80 - 84 years,10,4,14
Carlow Town,2016,85 years and over,21,14,35
Carlow Town,2016,Under 1 year,1,0,1
Carlow Town,2017,1 - 4 years,0,0,0
Carlow Town,2017,10 - 14 years,0,0,0
Carlow Town,2017,15 - 19 years,1,2,3
Carlow Town,2017,20 - 24 years,0,1,1
Carlow Town,2017,25 - 29 years,2,2,4
Carlow Town,2017,30 - 34 years,2,1,3
Carlow Town,2017,35 - 39 years,1,2,3
Carlow Town,2017,40 - 44 years,1,1,2
Carlow Town,2017,45 - 49 years,2,3,5
Carlow Town,2017,5 - 9 years,0,0,0
Carlow Town,2017,50 - 54 years,1,2,3
Carlow Town,2017,55 - 59 years,3,5,8
Carlow Town,2017,60 - 64 years,3,4,7
Carlow Town,2017,65 - 69 years,5,6,11
Carlow Town,2017,70 - 74 years,6,5,11
Carlow Town,2017,75 - 79 years,6,11,17
Carlow Town,2017,80 - 84 years,6,7,13
Carlow Town,2017,85 years and over,14,21,35
Carlow Town,2017,Under 1 year,4,0,4
Carlow Town,2018,1 - 4 years,0,0,0
Carlow Town,2018,10 - 14 years,1,0,1
Carlow Town,2018,15 - 19 years,0,0,0
Carlow Town,2018,20 - 24 years,0,0,0
Carlow Town,2018,25 - 29 years,0,0,0
Carlow Town,2018,30 - 34 years,1,0,1
Carlow Town,2018,35 - 39 years,1,1,2
Carlow Town,2018,40 - 44 years,0,2,2
Carlow Town,2018,45 - 49 years,1,1,2
Carlow Town,2018,5 - 9 years,0,0,0
Carlow Town,2018,50 - 54 years,1,1,2
Carlow Town,2018,55 - 59 years,1,4,5
Carlow Town,2018,60 - 64 years,2,1,3
Carlow Town,2018,65 - 69 years,6,8,14
Carlow Town,2018,70 - 74 years,7,6,13
Carlow Town,2018,75 - 79 years,5,8,13
Carlow Town,2018,80 - 84 years,11,12,23
Carlow Town,2018,85 years and over,25,22,47
Carlow Town,2018,Under 1 year,0,0,0
Carlow Town,2019,1 - 4 years,0,0,0
Carlow Town,2019,10 - 14 years,1,0,1
Carlow Town,2019,15 - 19 years,0,0,0
Carlow Town,2019,20 - 24 years,0,0,0
Carlow Town,2019,25 - 29 years,0,0,0
Carlow Town,2019,30 - 34 years,1,0,1
Carlow Town,2019,35 - 39 years,1,1,2
Carlow Town,2019,40 - 44 years,0,2,2
Carlow Town,2019,45 - 49 years,1,1,2
Carlow Town,2019,5 - 9 years,0,0,0
Carlow Town,2019,50 - 54 years,1,1,2
Carlow Town,2019,55 - 59 years,1,4,5
Carlow Town,2019,60 - 64 years,2,1,3
Carlow Town,2019,65 - 69 years,6,8,14
Carlow Town,2019,70 - 74 years,7,6,13
Carlow Town,2019,75 - 79 years,5,8,13
Carlow Town,2019,80 - 84 years,11,12,23
Carlow Town,2019,85 years and over,25,22,47
Carlow Town,2019,Under 1 year,0,0,0
Carlow Town,2020,1 - 4 years,0,0,0
Carlow Town,2020,10 - 14 years,1,0,1
Carlow Town,2020,15 - 19 years,0,0,0
Carlow Town,2020,20 - 24 years,0,0,0
Carlow Town,2020,25 - 29 years,0,0,0
Carlow Town,2020,30 - 34 years,1,0,1
Carlow Town,2020,35 - 39 years,1,1,2
Carlow Town,2020,40 - 44 years,0,2,2
Carlow Town,2020,45 - 49 years,1,1,2
Carlow Town,2020,5 - 9 years,0,0,0
Carlow Town,2020,50 - 54 years,1,1,2
Carlow Town,2020,55 - 59 years,1,4,5
Carlow Town,2020,60 - 64 years,2,1,3
Carlow Town,2020,65 - 69 years,6,8,14
Carlow Town,2020,70 - 74 years,7,6,13
Carlow Town,2020,75 - 79 years,5,8,13
Carlow Town,2020,80 - 84 years,11,12,23
Carlow Town,2020,85 years and over,25,22,47
Carlow Town,2020,Under 1 year,0,0,0
Carrick-on-Suir Town,2007,1 - 4 years,0,0,0
Carrick-on-Suir Town,2007,10 - 14 years,0,0,0
Carrick-on-Suir Town,2007,15 - 19 years,0,0,0
Carrick-on-Suir Town,2007,20 - 24 years,0,0,0
Carrick-on-Suir Town,2007,25 - 29 years,0,0,0
Carrick-on-Suir Town,2007,30 - 34 years,0,0,0
Carrick-on-Suir Town,2007,35 - 39 years,0,0,0
Carrick-on-Suir Town,2007,40 - 44 years,2,1,3
Carrick-on-Suir Town,2007,45 - 49 years,0,3,3
Carrick-on-Suir Town,2007,5 - 9 years,0,0,0
Carrick-on-Suir Town,2007,50 - 54 years,1,1,2
Carrick-on-Suir Town,2007,55 - 59 years,0,2,2
Carrick-on-Suir Town,2007,60 - 64 years,0,2,2
Carrick-on-Suir Town,2007,65 - 69 years,1,3,4
Carrick-on-Suir Town,2007,70 - 74 years,6,6,12
Carrick-on-Suir Town,2007,75 - 79 years,6,4,10
Carrick-on-Suir Town,2007,80 - 84 years,7,3,10
Carrick-on-Suir Town,2007,85 years and over,11,4,15
Carrick-on-Suir Town,2007,Under 1 year,0,0,0
Carrick-on-Suir Town,2008,1 - 4 years,0,0,0
Carrick-on-Suir Town,2008,10 - 14 years,0,0,0
Carrick-on-Suir Town,2008,15 - 19 years,0,0,0
Carrick-on-Suir Town,2008,20 - 24 years,1,0,1
Carrick-on-Suir Town,2008,25 - 29 years,0,0,0
Carrick-on-Suir Town,2008,30 - 34 years,0,0,0
Carrick-on-Suir Town,2008,35 - 39 years,1,2,3
Carrick-on-Suir Town,2008,40 - 44 years,3,1,4
Carrick-on-Suir Town,2008,45 - 49 years,0,3,3
Carrick-on-Suir Town,2008,5 - 9 years,0,0,0
Carrick-on-Suir Town,2008,50 - 54 years,1,1,2
Carrick-on-Suir Town,2008,55 - 59 years,1,2,3
Carrick-on-Suir Town,2008,60 - 64 years,2,2,4
Carrick-on-Suir Town,2008,65 - 69 years,1,4,5
Carrick-on-Suir Town,2008,70 - 74 years,1,3,4
Carrick-on-Suir Town,2008,75 - 79 years,6,2,8
Carrick-on-Suir Town,2008,80 - 84 years,5,4,9
Carrick-on-Suir Town,2008,85 years and over,7,2,9
Carrick-on-Suir Town,2008,Under 1 year,0,1,1
Carrick-on-Suir Town,2009,1 - 4 years,0,0,0
Carrick-on-Suir Town,2009,10 - 14 years,0,0,0
Carrick-on-Suir Town,2009,15 - 19 years,0,1,1
Carrick-on-Suir Town,2009,20 - 24 years,1,0,1
Carrick-on-Suir Town,2009,25 - 29 years,0,0,0
Carrick-on-Suir Town,2009,30 - 34 years,1,1,2
Carrick-on-Suir Town,2009,35 - 39 years,1,2,3
Carrick-on-Suir Town,2009,40 - 44 years,3,1,4
Carrick-on-Suir Town,2009,45 - 49 years,1,3,4
Carrick-on-Suir Town,2009,5 - 9 years,0,0,0
Carrick-on-Suir Town,2009,50 - 54 years,1,1,2
Carrick-on-Suir Town,2009,55 - 59 years,1,2,3
Carrick-on-Suir Town,2009,60 - 64 years,4,3,7
Carrick-on-Suir Town,2009,65 - 69 years,2,5,7
Carrick-on-Suir Town,2009,70 - 74 years,4,2,6
Carrick-on-Suir Town,2009,75 - 79 years,4,2,6
Carrick-on-Suir Town,2009,80 - 84 years,9,7,16
Carrick-on-Suir Town,2009,85 years and over,9,5,14
Carrick-on-Suir Town,2009,Under 1 year,0,1,1
Carrick-on-Suir Town,2010,1 - 4 years,0,0,0
Carrick-on-Suir Town,2010,10 - 14 years,0,0,0
Carrick-on-Suir Town,2010,15 - 19 years,1,1,2
Carrick-on-Suir Town,2010,20 - 24 years,1,0,1
Carrick-on-Suir Town,2010,25 - 29 years,0,0,0
Carrick-on-Suir Town,2010,30 - 34 years,1,1,2
Carrick-on-Suir Town,2010,35 - 39 years,1,2,3
Carrick-on-Suir Town,2010,40 - 44 years,1,1,2
Carrick-on-Suir Town,2010,45 - 49 years,1,1,2
Carrick-on-Suir Town,2010,5 - 9 years,1,0,1
Carrick-on-Suir Town,2010,50 - 54 years,1,1,2
Carrick-on-Suir Town,2010,55 - 59 years,1,2,3
Carrick-on-Suir Town,2010,60 - 64 years,4,2,6
Carrick-on-Suir Town,2010,65 - 69 years,2,2,4
Carrick-on-Suir Town,2010,70 - 74 years,2,2,4
Carrick-on-Suir Town,2010,75 - 79 years,4,6,10
Carrick-on-Suir Town,2010,80 - 84 years,4,4,8
Carrick-on-Suir Town,2010,85 years and over,17,6,23
Carrick-on-Suir Town,2010,Under 1 year,0,1,1
Carrick-on-Suir Town,2011,1 - 4 years,0,0,0
Carrick-on-Suir Town,2011,10 - 14 years,0,0,0
Carrick-on-Suir Town,2011,15 - 19 years,0,0,0
Carrick-on-Suir Town,2011,20 - 24 years,0,1,1
Carrick-on-Suir Town,2011,25 - 29 years,1,0,1
Carrick-on-Suir Town,2011,30 - 34 years,0,0,0
Carrick-on-Suir Town,2011,35 - 39 years,0,0,0
Carrick-on-Suir Town,2011,40 - 44 years,0,0,0
Carrick-on-Suir Town,2011,45 - 49 years,0,0,0
Carrick-on-Suir Town,2011,5 - 9 years,0,0,0
Carrick-on-Suir Town,2011,50 - 54 years,0,4,4
Carrick-on-Suir Town,2011,55 - 59 years,1,4,5
Carrick-on-Suir Town,2011,60 - 64 years,2,1,3
Carrick-on-Suir Town,2011,65 - 69 years,0,3,3
Carrick-on-Suir Town,2011,70 - 74 years,1,4,5
Carrick-on-Suir Town,2011,75 - 79 years,1,1,2
Carrick-on-Suir Town,2011,80 - 84 years,6,7,13
Carrick-on-Suir Town,2011,85 years and over,7,1,8
Carrick-on-Suir Town,2011,Under 1 year,0,1,1
Carrick-on-Suir Town,2012,1 - 4 years,0,0,0
Carrick-on-Suir Town,2012,10 - 14 years,0,0,0
Carrick-on-Suir Town,2012,15 - 19 years,0,1,1
Carrick-on-Suir Town,2012,20 - 24 years,0,1,1
Carrick-on-Suir Town,2012,25 - 29 years,1,0,1
Carrick-on-Suir Town,2012,30 - 34 years,0,0,0
Carrick-on-Suir Town,2012,35 - 39 years,0,0,0
Carrick-on-Suir Town,2012,40 - 44 years,0,1,1
Carrick-on-Suir Town,2012,45 - 49 years,0,0,0
Carrick-on-Suir Town,2012,5 - 9 years,0,0,0
Carrick-on-Suir Town,2012,50 - 54 years,0,1,1
Carrick-on-Suir Town,2012,55 - 59 years,1,1,2
Carrick-on-Suir Town,2012,60 - 64 years,1,1,2
Carrick-on-Suir Town,2012,65 - 69 years,3,2,5
Carrick-on-Suir Town,2012,70 - 74 years,1,6,7
Carrick-on-Suir Town,2012,75 - 79 years,3,5,8
Carrick-on-Suir Town,2012,80 - 84 years,2,4,6
Carrick-on-Suir Town,2012,85 years and over,5,4,9
Carrick-on-Suir Town,2012,Under 1 year,0,1,1
Carrick-on-Suir Town,2013,1 - 4 years,0,0,0
Carrick-on-Suir Town,2013,10 - 14 years,0,0,0
Carrick-on-Suir Town,2013,15 - 19 years,0,0,0
Carrick-on-Suir Town,2013,20 - 24 years,0,1,1
Carrick-on-Suir Town,2013,25 - 29 years,0,0,0
Carrick-on-Suir Town,2013,30 - 34 years,0,0,0
Carrick-on-Suir Town,2013,35 - 39 years,1,0,1
Carrick-on-Suir Town,2013,40 - 44 years,0,0,0
Carrick-on-Suir Town,2013,45 - 49 years,0,1,1
Carrick-on-Suir Town,2013,5 - 9 years,0,0,0
Carrick-on-Suir Town,2013,50 - 54 years,0,1,1
Carrick-on-Suir Town,2013,55 - 59 years,3,1,4
Carrick-on-Suir Town,2013,60 - 64 years,1,3,4
Carrick-on-Suir Town,2013,65 - 69 years,1,3,4
Carrick-on-Suir Town,2013,70 - 74 years,3,2,5
Carrick-on-Suir Town,2013,75 - 79 years,3,6,9
Carrick-on-Suir Town,2013,80 - 84 years,10,7,17
Carrick-on-Suir Town,2013,85 years and over,12,5,17
Carrick-on-Suir Town,2013,Under 1 year,0,0,0
Carrick-on-Suir Town,2014,1 - 4 years,0,0,0
Carrick-on-Suir Town,2014,10 - 14 years,0,0,0
Carrick-on-Suir Town,2014,15 - 19 years,0,0,0
Carrick-on-Suir Town,2014,20 - 24 years,0,1,1
Carrick-on-Suir Town,2014,25 - 29 years,1,0,1
Carrick-on-Suir Town,2014,30 - 34 years,0,0,0
Carrick-on-Suir Town,2014,35 - 39 years,1,0,1
Carrick-on-Suir Town,2014,40 - 44 years,0,0,0
Carrick-on-Suir Town,2014,45 - 49 years,1,1,2
Carrick-on-Suir Town,2014,5 - 9 years,0,0,0
Carrick-on-Suir Town,2014,50 - 54 years,1,1,2
Carrick-on-Suir Town,2014,55 - 59 years,1,1,2
Carrick-on-Suir Town,2014,60 - 64 years,5,2,7
Carrick-on-Suir Town,2014,65 - 69 years,4,3,7
Carrick-on-Suir Town,2014,70 - 74 years,6,3,9
Carrick-on-Suir Town,2014,75 - 79 years,3,5,8
Carrick-on-Suir Town,2014,80 - 84 years,4,7,11
Carrick-on-Suir Town,2014,85 years and over,8,7,15
Carrick-on-Suir Town,2014,Under 1 year,0,0,0
Carrick-on-Suir Town,2015,1 - 4 years,0,0,0
Carrick-on-Suir Town,2015,10 - 14 years,0,0,0
Carrick-on-Suir Town,2015,15 - 19 years,0,0,0
Carrick-on-Suir Town,2015,20 - 24 years,0,1,1
Carrick-on-Suir Town,2015,25 - 29 years,1,0,1
Carrick-on-Suir Town,2015,30 - 34 years,0,0,0
Carrick-on-Suir Town,2015,35 - 39 years,1,0,1
Carrick-on-Suir Town,2015,40 - 44 years,0,0,0
Carrick-on-Suir Town,2015,45 - 49 years,1,1,2
Carrick-on-Suir Town,2015,5 - 9 years,0,0,0
Carrick-on-Suir Town,2015,50 - 54 years,1,1,2
Carrick-on-Suir Town,2015,55 - 59 years,1,1,2
Carrick-on-Suir Town,2015,60 - 64 years,5,2,7
Carrick-on-Suir Town,2015,65 - 69 years,4,3,7
Carrick-on-Suir Town,2015,70 - 74 years,6,3,9
Carrick-on-Suir Town,2015,75 - 79 years,3,5,8
Carrick-on-Suir Town,2015,80 - 84 years,4,7,11
Carrick-on-Suir Town,2015,85 years and over,8,7,15
Carrick-on-Suir Town,2015,Under 1 year,0,0,0
Carrick-on-Suir Town,2016,1 - 4 years,0,0,0
Carrick-on-Suir Town,2016,10 - 14 years,0,0,0
Carrick-on-Suir Town,2016,15 - 19 years,0,0,0
Carrick-on-Suir Town,2016,20 - 24 years,0,1,1
Carrick-on-Suir Town,2016,25 - 29 years,1,0,1
Carrick-on-Suir Town,2016,30 - 34 years,0,0,0
Carrick-on-Suir Town,2016,35 - 39 years,1,0,1
Carrick-on-Suir Town,2016,40 - 44 years,0,0,0
Carrick-on-Suir Town,2016,45 - 49 years,1,1,2
Carrick-on-Suir Town,2016,5 - 9 years,0,0,0
Carrick-on-Suir Town,2016,50 - 54 years,1,1,2
Carrick-on-Suir Town,2016,55 - 59 years,1,1,2
Carrick-on-Suir Town,2016,60 - 64 years,5,2,7
Carrick-on-Suir Town,2016,65 - 69 years,4,3,7
Carrick-on-Suir Town,2016,70 - 74 years,6,3,9
Carrick-on-Suir Town,2016,75 - 79 years,3,5,8
Carrick-on-Suir Town,2016,80 - 84 years,4,7,11
Carrick-on-Suir Town,2016,85 years and over,8,7,15
Carrick-on-Suir Town,2016,Under 1 year,0,0,0
Carrick-on-Suir Town,2017,1 - 4 years,0,0,0
Carrick-on-Suir Town,2017,10 - 14 years,0,0,0
Carrick-on-Suir Town,2017,15 - 19 years,0,0,0
Carrick-on-Suir Town,2017,20 - 24 years,0,1,1
Carrick-on-Suir Town,2017,25 - 29 years,1,2,3
Carrick-on-Suir Town,2017,30 - 34 years,0,1,1
Carrick-on-Suir Town,2017,35 - 39 years,1,0,1
Carrick-on-Suir Town,2017,40 - 44 years,1,0,1
Carrick-on-Suir Town,2017,45 - 49 years,1,1,2
Carrick-on-Suir Town,2017,5 - 9 years,0,0,0
Carrick-on-Suir Town,2017,50 - 54 years,1,1,2
Carrick-on-Suir Town,2017,55 - 59 years,1,1,2
Carrick-on-Suir Town,2017,60 - 64 years,5,2,7
Carrick-on-Suir Town,2017,65 - 69 years,1,3,4
Carrick-on-Suir Town,2017,70 - 74 years,1,5,6
Carrick-on-Suir Town,2017,75 - 79 years,2,4,6
Carrick-on-Suir Town,2017,80 - 84 years,6,2,8
Carrick-on-Suir Town,2017,85 years and over,21,3,24
Carrick-on-Suir Town,2017,Under 1 year,0,1,1
Carrick-on-Suir Town,2018,1 - 4 years,0,0,0
Carrick-on-Suir Town,2018,10 - 14 years,1,0,1
Carrick-on-Suir Town,2018,15 - 19 years,0,1,1
Carrick-on-Suir Town,2018,20 - 24 years,0,0,0
Carrick-on-Suir Town,2018,25 - 29 years,0,1,1
Carrick-on-Suir Town,2018,30 - 34 years,0,1,1
Carrick-on-Suir Town,2018,35 - 39 years,0,0,0
Carrick-on-Suir Town,2018,40 - 44 years,0,0,0
Carrick-on-Suir Town,2018,45 - 49 years,1,1,2
Carrick-on-Suir Town,2018,5 - 9 years,0,0,0
Carrick-on-Suir Town,2018,50 - 54 years,2,0,2
Carrick-on-Suir Town,2018,55 - 59 years,3,1,4
Carrick-on-Suir Town,2018,60 - 64 years,2,4,6
Carrick-on-Suir Town,2018,65 - 69 years,3,3,6
Carrick-on-Suir Town,2018,70 - 74 years,2,3,5
Carrick-on-Suir Town,2018,75 - 79 years,4,6,10
Carrick-on-Suir Town,2018,80 - 84 years,4,6,10
Carrick-on-Suir Town,2018,85 years and over,12,4,16
Carrick-on-Suir Town,2018,Under 1 year,0,0,0
Carrick-on-Suir Town,2019,1 - 4 years,0,0,0
Carrick-on-Suir Town,2019,10 - 14 years,1,0,1
Carrick-on-Suir Town,2019,15 - 19 years,0,1,1
Carrick-on-Suir Town,2019,20 - 24 years,0,0,0
Carrick-on-Suir Town,2019,25 - 29 years,0,1,1
Carrick-on-Suir Town,2019,30 - 34 years,0,1,1
Carrick-on-Suir Town,2019,35 - 39 years,0,0,0
Carrick-on-Suir Town,2019,40 - 44 years,0,0,0
Carrick-on-Suir Town,2019,45 - 49 years,1,1,2
Carrick-on-Suir Town,2019,5 - 9 years,0,0,0
Carrick-on-Suir Town,2019,50 - 54 years,2,0,2
Carrick-on-Suir Town,2019,55 - 59 years,3,1,4
Carrick-on-Suir Town,2019,60 - 64 years,2,4,6
Carrick-on-Suir Town,2019,65 - 69 years,3,3,6
Carrick-on-Suir Town,2019,70 - 74 years,2,3,5
Carrick-on-Suir Town,2019,75 - 79 years,4,6,10
Carrick-on-Suir Town,2019,80 - 84 years,4,6,10
Carrick-on-Suir Town,2019,85 years and over,12,4,16
Carrick-on-Suir Town,2019,Under 1 year,0,0,0
Carrick-on-Suir Town,2020,1 - 4 years,0,0,0
Carrick-on-Suir Town,2020,10 - 14 years,1,0,1
Carrick-on-Suir Town,2020,15 - 19 years,0,1,1
Carrick-on-Suir Town,2020,20 - 24 years,0,0,0
Carrick-on-Suir Town,2020,25 - 29 years,0,1,1
Carrick-on-Suir Town,2020,30 - 34 years,0,1,1
Carrick-on-Suir Town,2020,35 - 39 years,0,0,0
Carrick-on-Suir Town,2020,40 - 44 years,0,0,0
Carrick-on-Suir Town,2020,45 - 49 years,1,1,2
Carrick-on-Suir Town,2020,5 - 9 years,0,0,0
Carrick-on-Suir Town,2020,50 - 54 years,2,0,2
Carrick-on-Suir Town,2020,55 - 59 years,3,1,4
Carrick-on-Suir Town,2020,60 - 64 years,2,4,6
Carrick-on-Suir Town,2020,65 - 69 years,3,3,6
Carrick-on-Suir Town,2020,70 - 74 years,2,3,5
Carrick-on-Suir Town,2020,75 - 79 years,4,6,10
Carrick-on-Suir Town,2020,80 - 84 years,4,6,10
Carrick-on-Suir Town,2020,85 years and over,12,4,16
Carrick-on-Suir Town,2020,Under 1 year,0,0,0
Carrickmacross Town,2007,1 - 4 years,0,1,1
Carrickmacross Town,2007,10 - 14 years,0,0,0
Carrickmacross Town,2007,15 - 19 years,0,0,0
Carrickmacross Town,2007,20 - 24 years,0,0,0
Carrickmacross Town,2007,25 - 29 years,0,0,0
Carrickmacross Town,2007,30 - 34 years,0,0,0
Carrickmacross Town,2007,35 - 39 years,0,0,0
Carrickmacross Town,2007,40 - 44 years,0,0,0
Carrickmacross Town,2007,45 - 49 years,0,1,1
Carrickmacross Town,2007,5 - 9 years,0,1,1
Carrickmacross Town,2007,50 - 54 years,1,1,2
Carrickmacross Town,2007,55 - 59 years,0,0,0
Carrickmacross Town,2007,60 - 64 years,1,3,4
Carrickmacross Town,2007,65 - 69 years,0,1,1
Carrickmacross Town,2007,70 - 74 years,2,0,2
Carrickmacross Town,2007,75 - 79 years,4,5,9
Carrickmacross Town,2007,80 - 84 years,8,7,15
Carrickmacross Town,2007,85 years and over,13,7,20
Carrickmacross Town,2007,Under 1 year,0,0,0
Carrickmacross Town,2008,1 - 4 years,0,1,1
Carrickmacross Town,2008,10 - 14 years,0,0,0
Carrickmacross Town,2008,15 - 19 years,0,2,2
Carrickmacross Town,2008,20 - 24 years,0,0,0
Carrickmacross Town,2008,25 - 29 years,1,0,1
Carrickmacross Town,2008,30 - 34 years,0,0,0
Carrickmacross Town,2008,35 - 39 years,0,0,0
Carrickmacross Town,2008,40 - 44 years,1,1,2
Carrickmacross Town,2008,45 - 49 years,0,1,1
Carrickmacross Town,2008,5 - 9 years,0,1,1
Carrickmacross Town,2008,50 - 54 years,1,1,2
Carrickmacross Town,2008,55 - 59 years,0,0,0
Carrickmacross Town,2008,60 - 64 years,2,2,4
Carrickmacross Town,2008,65 - 69 years,0,3,3
Carrickmacross Town,2008,70 - 74 years,3,3,6
Carrickmacross Town,2008,75 - 79 years,4,3,7
Carrickmacross Town,2008,80 - 84 years,5,4,9
Carrickmacross Town,2008,85 years and over,7,3,10
Carrickmacross Town,2008,Under 1 year,0,0,0
Carrickmacross Town,2009,1 - 4 years,0,1,1
Carrickmacross Town,2009,10 - 14 years,0,0,0
Carrickmacross Town,2009,15 - 19 years,0,2,2
Carrickmacross Town,2009,20 - 24 years,0,0,0
Carrickmacross Town,2009,25 - 29 years,1,0,1
Carrickmacross Town,2009,30 - 34 years,0,0,0
Carrickmacross Town,2009,35 - 39 years,0,1,1
Carrickmacross Town,2009,40 - 44 years,1,1,2
Carrickmacross Town,2009,45 - 49 years,0,2,2
Carrickmacross Town,2009,5 - 9 years,0,1,1
Carrickmacross Town,2009,50 - 54 years,1,1,2
Carrickmacross Town,2009,55 - 59 years,3,1,4
Carrickmacross Town,2009,60 - 64 years,2,1,3
Carrickmacross Town,2009,65 - 69 years,2,3,5
Carrickmacross Town,2009,70 - 74 years,1,2,3
Carrickmacross Town,2009,75 - 79 years,4,4,8
Carrickmacross Town,2009,80 - 84 years,2,3,5
Carrickmacross Town,2009,85 years and over,2,4,6
Carrickmacross Town,2009,Under 1 year,0,0,0
Carrickmacross Town,2010,1 - 4 years,0,1,1
Carrickmacross Town,2010,10 - 14 years,0,0,0
Carrickmacross Town,2010,15 - 19 years,0,2,2
Carrickmacross Town,2010,20 - 24 years,0,0,0
Carrickmacross Town,2010,25 - 29 years,1,0,1
Carrickmacross Town,2010,30 - 34 years,0,0,0
Carrickmacross Town,2010,35 - 39 years,0,1,1
Carrickmacross Town,2010,40 - 44 years,1,1,2
Carrickmacross Town,2010,45 - 49 years,1,1,2
Carrickmacross Town,2010,5 - 9 years,0,1,1
Carrickmacross Town,2010,50 - 54 years,1,1,2
Carrickmacross Town,2010,55 - 59 years,3,2,5
Carrickmacross Town,2010,60 - 64 years,2,3,5
Carrickmacross Town,2010,65 - 69 years,2,2,4
Carrickmacross Town,2010,70 - 74 years,2,2,4
Carrickmacross Town,2010,75 - 79 years,2,4,6
Carrickmacross Town,2010,80 - 84 years,4,2,6
Carrickmacross Town,2010,85 years and over,9,3,12
Carrickmacross Town,2010,Under 1 year,0,0,0
Carrickmacross Town,2011,1 - 4 years,0,0,0
Carrickmacross Town,2011,10 - 14 years,0,0,0
Carrickmacross Town,2011,15 - 19 years,0,0,0
Carrickmacross Town,2011,20 - 24 years,0,1,1
Carrickmacross Town,2011,25 - 29 years,1,0,1
Carrickmacross Town,2011,30 - 34 years,1,0,1
Carrickmacross Town,2011,35 - 39 years,0,0,0
Carrickmacross Town,2011,40 - 44 years,0,0,0
Carrickmacross Town,2011,45 - 49 years,0,1,1
Carrickmacross Town,2011,5 - 9 years,0,0,0
Carrickmacross Town,2011,50 - 54 years,0,1,1
Carrickmacross Town,2011,55 - 59 years,0,0,0
Carrickmacross Town,2011,60 - 64 years,1,2,3
Carrickmacross Town,2011,65 - 69 years,2,1,3
Carrickmacross Town,2011,70 - 74 years,1,2,3
Carrickmacross Town,2011,75 - 79 years,1,2,3
Carrickmacross Town,2011,80 - 84 years,1,1,2
Carrickmacross Town,2011,85 years and over,0,1,1
Carrickmacross Town,2011,Under 1 year,0,0,0
Carrickmacross Town,2012,1 - 4 years,0,0,0
Carrickmacross Town,2012,10 - 14 years,0,0,0
Carrickmacross Town,2012,15 - 19 years,0,0,0
Carrickmacross Town,2012,20 - 24 years,0,1,1
Carrickmacross Town,2012,25 - 29 years,1,1,2
Carrickmacross Town,2012,30 - 34 years,1,0,1
Carrickmacross Town,2012,35 - 39 years,0,0,0
Carrickmacross Town,2012,40 - 44 years,0,0,0
Carrickmacross Town,2012,45 - 49 years,0,1,1
Carrickmacross Town,2012,5 - 9 years,0,0,0
Carrickmacross Town,2012,50 - 54 years,1,1,2
Carrickmacross Town,2012,55 - 59 years,2,0,2
Carrickmacross Town,2012,60 - 64 years,1,1,2
Carrickmacross Town,2012,65 - 69 years,2,1,3
Carrickmacross Town,2012,70 - 74 years,1,3,4
Carrickmacross Town,2012,75 - 79 years,1,4,5
Carrickmacross Town,2012,80 - 84 years,3,5,8
Carrickmacross Town,2012,85 years and over,11,4,15
Carrickmacross Town,2012,Under 1 year,0,0,0
Carrickmacross Town,2013,1 - 4 years,0,0,0
Carrickmacross Town,2013,10 - 14 years,0,0,0
Carrickmacross Town,2013,15 - 19 years,0,0,0
Carrickmacross Town,2013,20 - 24 years,0,0,0
Carrickmacross Town,2013,25 - 29 years,0,0,0
Carrickmacross Town,2013,30 - 34 years,0,0,0
Carrickmacross Town,2013,35 - 39 years,0,1,1
Carrickmacross Town,2013,40 - 44 years,0,2,2
Carrickmacross Town,2013,45 - 49 years,0,0,0
Carrickmacross Town,2013,5 - 9 years,0,0,0
Carrickmacross Town,2013,50 - 54 years,1,2,3
Carrickmacross Town,2013,55 - 59 years,0,2,2
Carrickmacross Town,2013,60 - 64 years,0,1,1
Carrickmacross Town,2013,65 - 69 years,0,0,0
Carrickmacross Town,2013,70 - 74 years,0,1,1
Carrickmacross Town,2013,75 - 79 years,0,4,4
Carrickmacross Town,2013,80 - 84 years,3,5,8
Carrickmacross Town,2013,85 years and over,6,8,14
Carrickmacross Town,2013,Under 1 year,0,0,0
Carrickmacross Town,2014,1 - 4 years,0,0,0
Carrickmacross Town,2014,10 - 14 years,0,0,0
Carrickmacross Town,2014,15 - 19 years,0,0,0
Carrickmacross Town,2014,20 - 24 years,0,0,0
Carrickmacross Town,2014,25 - 29 years,0,0,0
Carrickmacross Town,2014,30 - 34 years,0,0,0
Carrickmacross Town,2014,35 - 39 years,0,1,1
Carrickmacross Town,2014,40 - 44 years,1,2,3
Carrickmacross Town,2014,45 - 49 years,1,0,1
Carrickmacross Town,2014,5 - 9 years,0,0,0
Carrickmacross Town,2014,50 - 54 years,1,3,4
Carrickmacross Town,2014,55 - 59 years,2,2,4
Carrickmacross Town,2014,60 - 64 years,0,3,3
Carrickmacross Town,2014,65 - 69 years,2,4,6
Carrickmacross Town,2014,70 - 74 years,1,2,3
Carrickmacross Town,2014,75 - 79 years,3,3,6
Carrickmacross Town,2014,80 - 84 years,3,3,6
Carrickmacross Town,2014,85 years and over,13,7,20
Carrickmacross Town,2014,Under 1 year,0,0,0
Carrickmacross Town,2015,1 - 4 years,0,0,0
Carrickmacross Town,2015,10 - 14 years,0,0,0
Carrickmacross Town,2015,15 - 19 years,0,0,0
Carrickmacross Town,2015,20 - 24 years,0,0,0
Carrickmacross Town,2015,25 - 29 years,0,0,0
Carrickmacross Town,2015,30 - 34 years,0,0,0
Carrickmacross Town,2015,35 - 39 years,0,1,1
Carrickmacross Town,2015,40 - 44 years,1,2,3
Carrickmacross Town,2015,45 - 49 years,1,0,1
Carrickmacross Town,2015,5 - 9 years,0,0,0
Carrickmacross Town,2015,50 - 54 years,1,3,4
Carrickmacross Town,2015,55 - 59 years,2,2,4
Carrickmacross Town,2015,60 - 64 years,0,3,3
Carrickmacross Town,2015,65 - 69 years,2,4,6
Carrickmacross Town,2015,70 - 74 years,1,2,3
Carrickmacross Town,2015,75 - 79 years,3,3,6
Carrickmacross Town,2015,80 - 84 years,3,3,6
Carrickmacross Town,2015,85 years and over,13,7,20
Carrickmacross Town,2015,Under 1 year,0,0,0
Carrickmacross Town,2016,1 - 4 years,0,0,0
Carrickmacross Town,2016,10 - 14 years,0,0,0
Carrickmacross Town,2016,15 - 19 years,0,0,0
Carrickmacross Town,2016,20 - 24 years,0,0,0
Carrickmacross Town,2016,25 - 29 years,0,0,0
Carrickmacross Town,2016,30 - 34 years,0,0,0
Carrickmacross Town,2016,35 - 39 years,0,1,1
Carrickmacross Town,2016,40 - 44 years,1,2,3
Carrickmacross Town,2016,45 - 49 years,1,0,1
Carrickmacross Town,2016,5 - 9 years,0,0,0
Carrickmacross Town,2016,50 - 54 years,1,3,4
Carrickmacross Town,2016,55 - 59 years,2,2,4
Carrickmacross Town,2016,60 - 64 years,0,3,3
Carrickmacross Town,2016,65 - 69 years,2,4,6
Carrickmacross Town,2016,70 - 74 years,1,2,3
Carrickmacross Town,2016,75 - 79 years,3,3,6
Carrickmacross Town,2016,80 - 84 years,3,3,6
Carrickmacross Town,2016,85 years and over,13,7,20
Carrickmacross Town,2016,Under 1 year,0,0,0
Carrickmacross Town,2017,1 - 4 years,0,0,0
Carrickmacross Town,2017,10 - 14 years,0,0,0
Carrickmacross Town,2017,15 - 19 years,0,0,0
Carrickmacross Town,2017,20 - 24 years,0,0,0
Carrickmacross Town,2017,25 - 29 years,0,0,0
Carrickmacross Town,2017,30 - 34 years,0,0,0
Carrickmacross Town,2017,35 - 39 years,0,1,1
Carrickmacross Town,2017,40 - 44 years,1,2,3
Carrickmacross Town,2017,45 - 49 years,1,1,2
Carrickmacross Town,2017,5 - 9 years,0,0,0
Carrickmacross Town,2017,50 - 54 years,1,1,2
Carrickmacross Town,2017,55 - 59 years,2,1,3
Carrickmacross Town,2017,60 - 64 years,0,2,2
Carrickmacross Town,2017,65 - 69 years,2,1,3
Carrickmacross Town,2017,70 - 74 years,3,2,5
Carrickmacross Town,2017,75 - 79 years,3,7,10
Carrickmacross Town,2017,80 - 84 years,3,1,4
Carrickmacross Town,2017,85 years and over,15,6,21
Carrickmacross Town,2017,Under 1 year,0,0,0
Carrickmacross Town,2018,1 - 4 years,0,0,0
Carrickmacross Town,2018,10 - 14 years,1,0,1
Carrickmacross Town,2018,15 - 19 years,0,0,0
Carrickmacross Town,2018,20 - 24 years,0,0,0
Carrickmacross Town,2018,25 - 29 years,0,0,0
Carrickmacross Town,2018,30 - 34 years,0,0,0
Carrickmacross Town,2018,35 - 39 years,0,0,0
Carrickmacross Town,2018,40 - 44 years,0,1,1
Carrickmacross Town,2018,45 - 49 years,0,0,0
Carrickmacross Town,2018,5 - 9 years,0,0,0
Carrickmacross Town,2018,50 - 54 years,0,1,1
Carrickmacross Town,2018,55 - 59 years,0,2,2
Carrickmacross Town,2018,60 - 64 years,0,3,3
Carrickmacross Town,2018,65 - 69 years,1,4,5
Carrickmacross Town,2018,70 - 74 years,1,2,3
Carrickmacross Town,2018,75 - 79 years,3,0,3
Carrickmacross Town,2018,80 - 84 years,1,9,10
Carrickmacross Town,2018,85 years and over,10,2,12
Carrickmacross Town,2018,Under 1 year,0,0,0
Carrickmacross Town,2019,1 - 4 years,0,0,0
Carrickmacross Town,2019,10 - 14 years,1,0,1
Carrickmacross Town,2019,15 - 19 years,0,0,0
Carrickmacross Town,2019,20 - 24 years,0,0,0
Carrickmacross Town,2019,25 - 29 years,0,0,0
Carrickmacross Town,2019,30 - 34 years,0,0,0
Carrickmacross Town,2019,35 - 39 years,0,0,0
Carrickmacross Town,2019,40 - 44 years,0,1,1
Carrickmacross Town,2019,45 - 49 years,0,0,0
Carrickmacross Town,2019,5 - 9 years,0,0,0
Carrickmacross Town,2019,50 - 54 years,0,1,1
Carrickmacross Town,2019,55 - 59 years,0,2,2
Carrickmacross Town,2019,60 - 64 years,0,3,3
Carrickmacross Town,2019,65 - 69 years,1,4,5
Carrickmacross Town,2019,70 - 74 years,1,2,3
Carrickmacross Town,2019,75 - 79 years,3,0,3
Carrickmacross Town,2019,80 - 84 years,1,9,10
Carrickmacross Town,2019,85 years and over,10,2,12
Carrickmacross Town,2019,Under 1 year,0,0,0
Carrickmacross Town,2020,1 - 4 years,0,0,0
Carrickmacross Town,2020,10 - 14 years,1,0,1
Carrickmacross Town,2020,15 - 19 years,0,0,0
Carrickmacross Town,2020,20 - 24 years,0,0,0
Carrickmacross Town,2020,25 - 29 years,0,0,0
Carrickmacross Town,2020,30 - 34 years,0,0,0
Carrickmacross Town,2020,35 - 39 years,0,0,0
Carrickmacross Town,2020,40 - 44 years,0,1,1
Carrickmacross Town,2020,45 - 49 years,0,0,0
Carrickmacross Town,2020,5 - 9 years,0,0,0
Carrickmacross Town,2020,50 - 54 years,0,1,1
Carrickmacross Town,2020,55 - 59 years,0,2,2
Carrickmacross Town,2020,60 - 64 years,0,3,3
Carrickmacross Town,2020,65 - 69 years,1,4,5
Carrickmacross Town,2020,70 - 74 years,1,2,3
Carrickmacross Town,2020,75 - 79 years,3,0,3
Carrickmacross Town,2020,80 - 84 years,1,9,10
Carrickmacross Town,2020,85 years and over,10,2,12
Carrickmacross Town,2020,Under 1 year,0,0,0
Cashel Town,2007,1 - 4 years,0,0,0
Cashel Town,2007,10 - 14 years,1,0,1
Cashel Town,2007,15 - 19 years,0,0,0
Cashel Town,2007,20 - 24 years,0,1,1
Cashel Town,2007,25 - 29 years,0,1,1
Cashel Town,2007,30 - 34 years,0,0,0
Cashel Town,2007,35 - 39 years,0,0,0
Cashel Town,2007,40 - 44 years,0,0,0
Cashel Town,2007,45 - 49 years,1,3,4
Cashel Town,2007,5 - 9 years,0,0,0
Cashel Town,2007,50 - 54 years,0,1,1
Cashel Town,2007,55 - 59 years,0,1,1
Cashel Town,2007,60 - 64 years,1,2,3
Cashel Town,2007,65 - 69 years,0,9,9
Cashel Town,2007,70 - 74 years,3,5,8
Cashel Town,2007,75 - 79 years,3,10,13
Cashel Town,2007,80 - 84 years,5,6,11
Cashel Town,2007,85 years and over,12,11,23
Cashel Town,2007,Under 1 year,0,1,1
Cashel Town,2008,1 - 4 years,0,0,0
Cashel Town,2008,10 - 14 years,1,1,2
Cashel Town,2008,15 - 19 years,0,0,0
Cashel Town,2008,20 - 24 years,0,1,1
Cashel Town,2008,25 - 29 years,0,1,1
Cashel Town,2008,30 - 34 years,0,0,0
Cashel Town,2008,35 - 39 years,0,1,1
Cashel Town,2008,40 - 44 years,1,0,1
Cashel Town,2008,45 - 49 years,1,2,3
Cashel Town,2008,5 - 9 years,0,0,0
Cashel Town,2008,50 - 54 years,0,1,1
Cashel Town,2008,55 - 59 years,1,1,2
Cashel Town,2008,60 - 64 years,1,2,3
Cashel Town,2008,65 - 69 years,0,4,4
Cashel Town,2008,70 - 74 years,3,4,7
Cashel Town,2008,75 - 79 years,3,8,11
Cashel Town,2008,80 - 84 years,4,3,7
Cashel Town,2008,85 years and over,9,7,16
Cashel Town,2008,Under 1 year,2,1,3
Cashel Town,2009,1 - 4 years,0,0,0
Cashel Town,2009,10 - 14 years,1,1,2
Cashel Town,2009,15 - 19 years,0,0,0
Cashel Town,2009,20 - 24 years,0,1,1
Cashel Town,2009,25 - 29 years,0,1,1
Cashel Town,2009,30 - 34 years,0,0,0
Cashel Town,2009,35 - 39 years,0,1,1
Cashel Town,2009,40 - 44 years,1,1,2
Cashel Town,2009,45 - 49 years,1,2,3
Cashel Town,2009,5 - 9 years,0,0,0
Cashel Town,2009,50 - 54 years,1,1,2
Cashel Town,2009,55 - 59 years,1,1,2
Cashel Town,2009,60 - 64 years,1,1,2
Cashel Town,2009,65 - 69 years,2,4,6
Cashel Town,2009,70 - 74 years,2,1,3
Cashel Town,2009,75 - 79 years,1,3,4
Cashel Town,2009,80 - 84 years,5,2,7
Cashel Town,2009,85 years and over,8,3,11
Cashel Town,2009,Under 1 year,2,1,3
Cashel Town,2010,1 - 4 years,0,0,0
Cashel Town,2010,10 - 14 years,1,1,2
Cashel Town,2010,15 - 19 years,0,0,0
Cashel Town,2010,20 - 24 years,0,1,1
Cashel Town,2010,25 - 29 years,0,1,1
Cashel Town,2010,30 - 34 years,0,0,0
Cashel Town,2010,35 - 39 years,1,1,2
Cashel Town,2010,40 - 44 years,1,1,2
Cashel Town,2010,45 - 49 years,1,2,3
Cashel Town,2010,5 - 9 years,0,0,0
Cashel Town,2010,50 - 54 years,1,1,2
Cashel Town,2010,55 - 59 years,1,1,2
Cashel Town,2010,60 - 64 years,1,1,2
Cashel Town,2010,65 - 69 years,2,3,5
Cashel Town,2010,70 - 74 years,1,2,3
Cashel Town,2010,75 - 79 years,2,3,5
Cashel Town,2010,80 - 84 years,5,2,7
Cashel Town,2010,85 years and over,5,4,9
Cashel Town,2010,Under 1 year,2,1,3
Cashel Town,2011,1 - 4 years,0,0,0
Cashel Town,2011,10 - 14 years,0,0,0
Cashel Town,2011,15 - 19 years,0,0,0
Cashel Town,2011,20 - 24 years,0,0,0
Cashel Town,2011,25 - 29 years,0,2,2
Cashel Town,2011,30 - 34 years,0,1,1
Cashel Town,2011,35 - 39 years,0,1,1
Cashel Town,2011,40 - 44 years,0,0,0
Cashel Town,2011,45 - 49 years,0,0,0
Cashel Town,2011,5 - 9 years,0,0,0
Cashel Town,2011,50 - 54 years,0,0,0
Cashel Town,2011,55 - 59 years,1,1,2
Cashel Town,2011,60 - 64 years,2,2,4
Cashel Town,2011,65 - 69 years,2,0,2
Cashel Town,2011,70 - 74 years,2,3,5
Cashel Town,2011,75 - 79 years,0,0,0
Cashel Town,2011,80 - 84 years,3,2,5
Cashel Town,2011,85 years and over,7,1,8
Cashel Town,2011,Under 1 year,0,0,0
Cashel Town,2012,1 - 4 years,0,0,0
Cashel Town,2012,10 - 14 years,0,0,0
Cashel Town,2012,15 - 19 years,0,1,1
Cashel Town,2012,20 - 24 years,0,0,0
Cashel Town,2012,25 - 29 years,0,2,2
Cashel Town,2012,30 - 34 years,0,1,1
Cashel Town,2012,35 - 39 years,1,1,2
Cashel Town,2012,40 - 44 years,0,0,0
Cashel Town,2012,45 - 49 years,1,1,2
Cashel Town,2012,5 - 9 years,0,0,0
Cashel Town,2012,50 - 54 years,0,1,1
Cashel Town,2012,55 - 59 years,2,2,4
Cashel Town,2012,60 - 64 years,2,2,4
Cashel Town,2012,65 - 69 years,3,0,3
Cashel Town,2012,70 - 74 years,2,3,5
Cashel Town,2012,75 - 79 years,3,3,6
Cashel Town,2012,80 - 84 years,7,4,11
Cashel Town,2012,85 years and over,13,7,20
Cashel Town,2012,Under 1 year,0,0,0
Cashel Town,2013,1 - 4 years,0,0,0
Cashel Town,2013,10 - 14 years,0,0,0
Cashel Town,2013,15 - 19 years,0,0,0
Cashel Town,2013,20 - 24 years,0,1,1
Cashel Town,2013,25 - 29 years,0,0,0
Cashel Town,2013,30 - 34 years,0,0,0
Cashel Town,2013,35 - 39 years,0,1,1
Cashel Town,2013,40 - 44 years,0,0,0
Cashel Town,2013,45 - 49 years,1,0,1
Cashel Town,2013,5 - 9 years,0,0,0
Cashel Town,2013,50 - 54 years,0,1,1
Cashel Town,2013,55 - 59 years,0,1,1
Cashel Town,2013,60 - 64 years,3,0,3
Cashel Town,2013,65 - 69 years,2,3,5
Cashel Town,2013,70 - 74 years,2,2,4
Cashel Town,2013,75 - 79 years,2,4,6
Cashel Town,2013,80 - 84 years,3,4,7
Cashel Town,2013,85 years and over,11,2,13
Cashel Town,2013,Under 1 year,0,0,0
Cashel Town,2014,1 - 4 years,0,0,0
Cashel Town,2014,10 - 14 years,0,0,0
Cashel Town,2014,15 - 19 years,0,0,0
Cashel Town,2014,20 - 24 years,0,1,1
Cashel Town,2014,25 - 29 years,0,0,0
Cashel Town,2014,30 - 34 years,0,0,0
Cashel Town,2014,35 - 39 years,0,1,1
Cashel Town,2014,40 - 44 years,0,0,0
Cashel Town,2014,45 - 49 years,1,0,1
Cashel Town,2014,5 - 9 years,0,0,0
Cashel Town,2014,50 - 54 years,0,1,1
Cashel Town,2014,55 - 59 years,1,1,2
Cashel Town,2014,60 - 64 years,1,2,3
Cashel Town,2014,65 - 69 years,1,3,4
Cashel Town,2014,70 - 74 years,3,2,5
Cashel Town,2014,75 - 79 years,1,3,4
Cashel Town,2014,80 - 84 years,4,1,5
Cashel Town,2014,85 years and over,7,1,8
Cashel Town,2014,Under 1 year,0,0,0
Cashel Town,2015,1 - 4 years,0,0,0
Cashel Town,2015,10 - 14 years,0,0,0
Cashel Town,2015,15 - 19 years,0,0,0
Cashel Town,2015,20 - 24 years,0,1,1
Cashel Town,2015,25 - 29 years,0,0,0
Cashel Town,2015,30 - 34 years,0,0,0
Cashel Town,2015,35 - 39 years,0,1,1
Cashel Town,2015,40 - 44 years,0,0,0
Cashel Town,2015,45 - 49 years,1,0,1
Cashel Town,2015,5 - 9 years,0,0,0
Cashel Town,2015,50 - 54 years,0,1,1
Cashel Town,2015,55 - 59 years,1,1,2
Cashel Town,2015,60 - 64 years,1,2,3
Cashel Town,2015,65 - 69 years,1,3,4
Cashel Town,2015,70 - 74 years,3,2,5
Cashel Town,2015,75 - 79 years,1,3,4
Cashel Town,2015,80 - 84 years,4,1,5
Cashel Town,2015,85 years and over,7,1,8
Cashel Town,2015,Under 1 year,0,0,0
Cashel Town,2016,1 - 4 years,0,0,0
Cashel Town,2016,10 - 14 years,0,0,0
Cashel Town,2016,15 - 19 years,0,0,0
Cashel Town,2016,20 - 24 years,0,1,1
Cashel Town,2016,25 - 29 years,0,0,0
Cashel Town,2016,30 - 34 years,0,0,0
Cashel Town,2016,35 - 39 years,0,1,1
Cashel Town,2016,40 - 44 years,0,0,0
Cashel Town,2016,45 - 49 years,1,0,1
Cashel Town,2016,5 - 9 years,0,0,0
Cashel Town,2016,50 - 54 years,0,1,1
Cashel Town,2016,55 - 59 years,1,1,2
Cashel Town,2016,60 - 64 years,1,2,3
Cashel Town,2016,65 - 69 years,1,3,4
Cashel Town,2016,70 - 74 years,3,2,5
Cashel Town,2016,75 - 79 years,1,3,4
Cashel Town,2016,80 - 84 years,4,1,5
Cashel Town,2016,85 years and over,7,1,8
Cashel Town,2016,Under 1 year,0,0,0
Cashel Town,2017,1 - 4 years,0,0,0
Cashel Town,2017,10 - 14 years,0,0,0
Cashel Town,2017,15 - 19 years,0,0,0
Cashel Town,2017,20 - 24 years,0,1,1
Cashel Town,2017,25 - 29 years,0,0,0
Cashel Town,2017,30 - 34 years,0,0,0
Cashel Town,2017,35 - 39 years,0,1,1
Cashel Town,2017,40 - 44 years,1,0,1
Cashel Town,2017,45 - 49 years,1,0,1
Cashel Town,2017,5 - 9 years,0,0,0
Cashel Town,2017,50 - 54 years,0,1,1
Cashel Town,2017,55 - 59 years,1,1,2
Cashel Town,2017,60 - 64 years,1,1,2
Cashel Town,2017,65 - 69 years,2,3,5
Cashel Town,2017,70 - 74 years,1,3,4
Cashel Town,2017,75 - 79 years,2,3,5
Cashel Town,2017,80 - 84 years,3,3,6
Cashel Town,2017,85 years and over,5,1,6
Cashel Town,2017,Under 1 year,0,0,0
Cashel Town,2018,1 - 4 years,0,0,0
Cashel Town,2018,10 - 14 years,0,0,0
Cashel Town,2018,15 - 19 years,0,0,0
Cashel Town,2018,20 - 24 years,0,0,0
Cashel Town,2018,25 - 29 years,0,0,0
Cashel Town,2018,30 - 34 years,0,0,0
Cashel Town,2018,35 - 39 years,2,0,2
Cashel Town,2018,40 - 44 years,0,0,0
Cashel Town,2018,45 - 49 years,0,1,1
Cashel Town,2018,5 - 9 years,0,0,0
Cashel Town,2018,50 - 54 years,2,0,2
Cashel Town,2018,55 - 59 years,0,2,2
Cashel Town,2018,60 - 64 years,0,0,0
Cashel Town,2018,65 - 69 years,1,1,2
Cashel Town,2018,70 - 74 years,1,2,3
Cashel Town,2018,75 - 79 years,2,3,5
Cashel Town,2018,80 - 84 years,2,3,5
Cashel Town,2018,85 years and over,6,0,6
Cashel Town,2018,Under 1 year,1,0,1
Cashel Town,2019,1 - 4 years,0,0,0
Cashel Town,2019,10 - 14 years,0,0,0
Cashel Town,2019,15 - 19 years,0,0,0
Cashel Town,2019,20 - 24 years,0,0,0
Cashel Town,2019,25 - 29 years,0,0,0
Cashel Town,2019,30 - 34 years,0,0,0
Cashel Town,2019,35 - 39 years,2,0,2
Cashel Town,2019,40 - 44 years,0,0,0
Cashel Town,2019,45 - 49 years,0,1,1
Cashel Town,2019,5 - 9 years,0,0,0
Cashel Town,2019,50 - 54 years,2,0,2
Cashel Town,2019,55 - 59 years,0,2,2
Cashel Town,2019,60 - 64 years,0,0,0
Cashel Town,2019,65 - 69 years,1,1,2
Cashel Town,2019,70 - 74 years,1,2,3
Cashel Town,2019,75 - 79 years,2,3,5
Cashel Town,2019,80 - 84 years,2,3,5
Cashel Town,2019,85 years and over,6,0,6
Cashel Town,2019,Under 1 year,1,0,1
Cashel Town,2020,1 - 4 years,0,0,0
Cashel Town,2020,10 - 14 years,0,0,0
Cashel Town,2020,15 - 19 years,0,0,0
Cashel Town,2020,20 - 24 years,0,0,0
Cashel Town,2020,25 - 29 years,0,0,0
Cashel Town,2020,30 - 34 years,0,0,0
Cashel Town,2020,35 - 39 years,2,0,2
Cashel Town,2020,40 - 44 years,0,0,0
Cashel Town,2020,45 - 49 years,0,1,1
Cashel Town,2020,5 - 9 years,0,0,0
Cashel Town,2020,50 - 54 years,2,0,2
Cashel Town,2020,55 - 59 years,0,2,2
Cashel Town,2020,60 - 64 years,0,0,0
Cashel Town,2020,65 - 69 years,1,1,2
Cashel Town,2020,70 - 74 years,1,2,3
Cashel Town,2020,75 - 79 years,2,3,5
Cashel Town,2020,80 - 84 years,2,3,5
Cashel Town,2020,85 years and over,6,0,6
Cashel Town,2020,Under 1 year,1,0,1
Castlebar Town,2007,1 - 4 years,0,0,0
Castlebar Town,2007,10 - 14 years,0,0,0
Castlebar Town,2007,15 - 19 years,0,0,0
Castlebar Town,2007,20 - 24 years,0,0,0
Castlebar Town,2007,25 - 29 years,0,1,1
Castlebar Town,2007,30 - 34 years,0,0,0
Castlebar Town,2007,35 - 39 years,0,0,0
Castlebar Town,2007,40 - 44 years,0,1,1
Castlebar Town,2007,45 - 49 years,1,2,3
Castlebar Town,2007,5 - 9 years,0,0,0
Castlebar Town,2007,50 - 54 years,1,3,4
Castlebar Town,2007,55 - 59 years,1,2,3
Castlebar Town,2007,60 - 64 years,1,5,6
Castlebar Town,2007,65 - 69 years,4,0,4
Castlebar Town,2007,70 - 74 years,2,5,7
Castlebar Town,2007,75 - 79 years,7,10,17
Castlebar Town,2007,80 - 84 years,7,12,19
Castlebar Town,2007,85 years and over,22,8,30
Castlebar Town,2007,Under 1 year,0,1,1
Castlebar Town,2008,1 - 4 years,0,0,0
Castlebar Town,2008,10 - 14 years,0,0,0
Castlebar Town,2008,15 - 19 years,0,0,0
Castlebar Town,2008,20 - 24 years,0,1,1
Castlebar Town,2008,25 - 29 years,0,1,1
Castlebar Town,2008,30 - 34 years,0,2,2
Castlebar Town,2008,35 - 39 years,1,1,2
Castlebar Town,2008,40 - 44 years,0,1,1
Castlebar Town,2008,45 - 49 years,1,2,3
Castlebar Town,2008,5 - 9 years,0,0,0
Castlebar Town,2008,50 - 54 years,1,3,4
Castlebar Town,2008,55 - 59 years,2,3,5
Castlebar Town,2008,60 - 64 years,1,3,4
Castlebar Town,2008,65 - 69 years,2,7,9
Castlebar Town,2008,70 - 74 years,3,4,7
Castlebar Town,2008,75 - 79 years,8,10,18
Castlebar Town,2008,80 - 84 years,5,8,13
Castlebar Town,2008,85 years and over,22,6,28
Castlebar Town,2008,Under 1 year,1,1,2
Castlebar Town,2009,1 - 4 years,0,0,0
Castlebar Town,2009,10 - 14 years,0,1,1
Castlebar Town,2009,15 - 19 years,0,0,0
Castlebar Town,2009,20 - 24 years,0,1,1
Castlebar Town,2009,25 - 29 years,0,2,2
Castlebar Town,2009,30 - 34 years,0,2,2
Castlebar Town,2009,35 - 39 years,1,1,2
Castlebar Town,2009,40 - 44 years,1,1,2
Castlebar Town,2009,45 - 49 years,1,2,3
Castlebar Town,2009,5 - 9 years,0,0,0
Castlebar Town,2009,50 - 54 years,1,3,4
Castlebar Town,2009,55 - 59 years,2,4,6
Castlebar Town,2009,60 - 64 years,3,1,4
Castlebar Town,2009,65 - 69 years,2,4,6
Castlebar Town,2009,70 - 74 years,4,2,6
Castlebar Town,2009,75 - 79 years,5,5,10
Castlebar Town,2009,80 - 84 years,2,5,7
Castlebar Town,2009,85 years and over,14,10,24
Castlebar Town,2009,Under 1 year,1,1,2
Castlebar Town,2010,1 - 4 years,0,0,0
Castlebar Town,2010,10 - 14 years,0,1,1
Castlebar Town,2010,15 - 19 years,0,0,0
Castlebar Town,2010,20 - 24 years,0,1,1
Castlebar Town,2010,25 - 29 years,0,2,2
Castlebar Town,2010,30 - 34 years,0,1,1
Castlebar Town,2010,35 - 39 years,1,1,2
Castlebar Town,2010,40 - 44 years,1,1,2
Castlebar Town,2010,45 - 49 years,1,2,3
Castlebar Town,2010,5 - 9 years,0,0,0
Castlebar Town,2010,50 - 54 years,2,2,4
Castlebar Town,2010,55 - 59 years,2,5,7
Castlebar Town,2010,60 - 64 years,2,3,5
Castlebar Town,2010,65 - 69 years,1,2,3
Castlebar Town,2010,70 - 74 years,4,4,8
Castlebar Town,2010,75 - 79 years,8,4,12
Castlebar Town,2010,80 - 84 years,3,10,13
Castlebar Town,2010,85 years and over,20,8,28
Castlebar Town,2010,Under 1 year,1,1,2
Castlebar Town,2011,1 - 4 years,0,0,0
Castlebar Town,2011,10 - 14 years,0,0,0
Castlebar Town,2011,15 - 19 years,0,1,1
Castlebar Town,2011,20 - 24 years,0,0,0
Castlebar Town,2011,25 - 29 years,0,0,0
Castlebar Town,2011,30 - 34 years,0,1,1
Castlebar Town,2011,35 - 39 years,1,0,1
Castlebar Town,2011,40 - 44 years,2,0,2
Castlebar Town,2011,45 - 49 years,2,1,3
Castlebar Town,2011,5 - 9 years,0,0,0
Castlebar Town,2011,50 - 54 years,1,2,3
Castlebar Town,2011,55 - 59 years,2,3,5
Castlebar Town,2011,60 - 64 years,1,4,5
Castlebar Town,2011,65 - 69 years,1,1,2
Castlebar Town,2011,70 - 74 years,1,4,5
Castlebar Town,2011,75 - 79 years,3,7,10
Castlebar Town,2011,80 - 84 years,5,5,10
Castlebar Town,2011,85 years and over,10,8,18
Castlebar Town,2011,Under 1 year,0,1,1
Castlebar Town,2012,1 - 4 years,0,0,0
Castlebar Town,2012,10 - 14 years,1,0,1
Castlebar Town,2012,15 - 19 years,1,1,2
Castlebar Town,2012,20 - 24 years,0,1,1
Castlebar Town,2012,25 - 29 years,0,1,1
Castlebar Town,2012,30 - 34 years,0,1,1
Castlebar Town,2012,35 - 39 years,1,1,2
Castlebar Town,2012,40 - 44 years,1,2,3
Castlebar Town,2012,45 - 49 years,1,1,2
Castlebar Town,2012,5 - 9 years,0,0,0
Castlebar Town,2012,50 - 54 years,2,1,3
Castlebar Town,2012,55 - 59 years,2,2,4
Castlebar Town,2012,60 - 64 years,2,1,3
Castlebar Town,2012,65 - 69 years,1,4,5
Castlebar Town,2012,70 - 74 years,4,5,9
Castlebar Town,2012,75 - 79 years,5,5,10
Castlebar Town,2012,80 - 84 years,3,4,7
Castlebar Town,2012,85 years and over,21,11,32
Castlebar Town,2012,Under 1 year,0,1,1
Castlebar Town,2013,1 - 4 years,0,1,1
Castlebar Town,2013,10 - 14 years,0,0,0
Castlebar Town,2013,15 - 19 years,0,0,0
Castlebar Town,2013,20 - 24 years,0,0,0
Castlebar Town,2013,25 - 29 years,0,0,0
Castlebar Town,2013,30 - 34 years,0,1,1
Castlebar Town,2013,35 - 39 years,1,0,1
Castlebar Town,2013,40 - 44 years,0,2,2
Castlebar Town,2013,45 - 49 years,0,0,0
Castlebar Town,2013,5 - 9 years,0,0,0
Castlebar Town,2013,50 - 54 years,0,2,2
Castlebar Town,2013,55 - 59 years,3,3,6
Castlebar Town,2013,60 - 64 years,5,4,9
Castlebar Town,2013,65 - 69 years,2,3,5
Castlebar Town,2013,70 - 74 years,3,6,9
Castlebar Town,2013,75 - 79 years,4,2,6
Castlebar Town,2013,80 - 84 years,12,6,18
Castlebar Town,2013,85 years and over,31,10,41
Castlebar Town,2013,Under 1 year,0,0,0
Castlebar Town,2014,1 - 4 years,0,1,1
Castlebar Town,2014,10 - 14 years,0,0,0
Castlebar Town,2014,15 - 19 years,0,0,0
Castlebar Town,2014,20 - 24 years,0,0,0
Castlebar Town,2014,25 - 29 years,0,1,1
Castlebar Town,2014,30 - 34 years,1,1,2
Castlebar Town,2014,35 - 39 years,1,0,1
Castlebar Town,2014,40 - 44 years,0,2,2
Castlebar Town,2014,45 - 49 years,1,3,4
Castlebar Town,2014,5 - 9 years,0,0,0
Castlebar Town,2014,50 - 54 years,2,1,3
Castlebar Town,2014,55 - 59 years,2,4,6
Castlebar Town,2014,60 - 64 years,3,2,5
Castlebar Town,2014,65 - 69 years,2,8,10
Castlebar Town,2014,70 - 74 years,5,6,11
Castlebar Town,2014,75 - 79 years,2,2,4
Castlebar Town,2014,80 - 84 years,9,5,14
Castlebar Town,2014,85 years and over,19,7,26
Castlebar Town,2014,Under 1 year,0,0,0
Castlebar Town,2015,1 - 4 years,0,1,1
Castlebar Town,2015,10 - 14 years,0,0,0
Castlebar Town,2015,15 - 19 years,0,0,0
Castlebar Town,2015,20 - 24 years,0,0,0
Castlebar Town,2015,25 - 29 years,0,1,1
Castlebar Town,2015,30 - 34 years,1,1,2
Castlebar Town,2015,35 - 39 years,1,0,1
Castlebar Town,2015,40 - 44 years,0,2,2
Castlebar Town,2015,45 - 49 years,1,3,4
Castlebar Town,2015,5 - 9 years,0,0,0
Castlebar Town,2015,50 - 54 years,2,1,3
Castlebar Town,2015,55 - 59 years,2,4,6
Castlebar Town,2015,60 - 64 years,3,2,5
Castlebar Town,2015,65 - 69 years,2,8,10
Castlebar Town,2015,70 - 74 years,5,6,11
Castlebar Town,2015,75 - 79 years,2,2,4
Castlebar Town,2015,80 - 84 years,9,5,14
Castlebar Town,2015,85 years and over,19,7,26
Castlebar Town,2015,Under 1 year,0,0,0
Castlebar Town,2016,1 - 4 years,0,1,1
Castlebar Town,2016,10 - 14 years,0,0,0
Castlebar Town,2016,15 - 19 years,0,0,0
Castlebar Town,2016,20 - 24 years,0,0,0
Castlebar Town,2016,25 - 29 years,0,1,1
Castlebar Town,2016,30 - 34 years,1,1,2
Castlebar Town,2016,35 - 39 years,1,0,1
Castlebar Town,2016,40 - 44 years,0,2,2
Castlebar Town,2016,45 - 49 years,1,3,4
Castlebar Town,2016,5 - 9 years,0,0,0
Castlebar Town,2016,50 - 54 years,2,1,3
Castlebar Town,2016,55 - 59 years,2,4,6
Castlebar Town,2016,60 - 64 years,3,2,5
Castlebar Town,2016,65 - 69 years,2,8,10
Castlebar Town,2016,70 - 74 years,5,6,11
Castlebar Town,2016,75 - 79 years,2,2,4
Castlebar Town,2016,80 - 84 years,9,5,14
Castlebar Town,2016,85 years and over,19,7,26
Castlebar Town,2016,Under 1 year,0,0,0
Castlebar Town,2017,1 - 4 years,0,1,1
Castlebar Town,2017,10 - 14 years,0,0,0
Castlebar Town,2017,15 - 19 years,0,0,0
Castlebar Town,2017,20 - 24 years,0,1,1
Castlebar Town,2017,25 - 29 years,0,1,1
Castlebar Town,2017,30 - 34 years,1,1,2
Castlebar Town,2017,35 - 39 years,1,2,3
Castlebar Town,2017,40 - 44 years,0,2,2
Castlebar Town,2017,45 - 49 years,1,3,4
Castlebar Town,2017,5 - 9 years,0,0,0
Castlebar Town,2017,50 - 54 years,1,2,3
Castlebar Town,2017,55 - 59 years,3,1,4
Castlebar Town,2017,60 - 64 years,2,4,6
Castlebar Town,2017,65 - 69 years,3,7,10
Castlebar Town,2017,70 - 74 years,5,7,12
Castlebar Town,2017,75 - 79 years,5,5,10
Castlebar Town,2017,80 - 84 years,8,5,13
Castlebar Town,2017,85 years and over,17,10,27
Castlebar Town,2017,Under 1 year,0,0,0
Castlebar Town,2018,1 - 4 years,0,0,0
Castlebar Town,2018,10 - 14 years,0,1,1
Castlebar Town,2018,15 - 19 years,0,0,0
Castlebar Town,2018,20 - 24 years,0,0,0
Castlebar Town,2018,25 - 29 years,0,0,0
Castlebar Town,2018,30 - 34 years,0,1,1
Castlebar Town,2018,35 - 39 years,0,0,0
Castlebar Town,2018,40 - 44 years,0,1,1
Castlebar Town,2018,45 - 49 years,1,0,1
Castlebar Town,2018,5 - 9 years,0,0,0
Castlebar Town,2018,50 - 54 years,0,2,2
Castlebar Town,2018,55 - 59 years,3,1,4
Castlebar Town,2018,60 - 64 years,4,6,10
Castlebar Town,2018,65 - 69 years,6,5,11
Castlebar Town,2018,70 - 74 years,3,4,7
Castlebar Town,2018,75 - 79 years,6,7,13
Castlebar Town,2018,80 - 84 years,4,7,11
Castlebar Town,2018,85 years and over,25,18,43
Castlebar Town,2018,Under 1 year,1,0,1
Castlebar Town,2019,1 - 4 years,0,0,0
Castlebar Town,2019,10 - 14 years,0,1,1
Castlebar Town,2019,15 - 19 years,0,0,0
Castlebar Town,2019,20 - 24 years,0,0,0
Castlebar Town,2019,25 - 29 years,0,0,0
Castlebar Town,2019,30 - 34 years,0,1,1
Castlebar Town,2019,35 - 39 years,0,0,0
Castlebar Town,2019,40 - 44 years,0,1,1
Castlebar Town,2019,45 - 49 years,1,0,1
Castlebar Town,2019,5 - 9 years,0,0,0
Castlebar Town,2019,50 - 54 years,0,2,2
Castlebar Town,2019,55 - 59 years,3,1,4
Castlebar Town,2019,60 - 64 years,4,6,10
Castlebar Town,2019,65 - 69 years,6,5,11
Castlebar Town,2019,70 - 74 years,3,4,7
Castlebar Town,2019,75 - 79 years,6,7,13
Castlebar Town,2019,80 - 84 years,4,7,11
Castlebar Town,2019,85 years and over,25,18,43
Castlebar Town,2019,Under 1 year,1,0,1
Castlebar Town,2020,1 - 4 years,0,0,0
Castlebar Town,2020,10 - 14 years,0,1,1
Castlebar Town,2020,15 - 19 years,0,0,0
Castlebar Town,2020,20 - 24 years,0,0,0
Castlebar Town,2020,25 - 29 years,0,0,0
Castlebar Town,2020,30 - 34 years,0,1,1
Castlebar Town,2020,35 - 39 years,0,0,0
Castlebar Town,2020,40 - 44 years,0,1,1
Castlebar Town,2020,45 - 49 years,1,0,1
Castlebar Town,2020,5 - 9 years,0,0,0
Castlebar Town,2020,50 - 54 years,0,2,2
Castlebar Town,2020,55 - 59 years,3,1,4
Castlebar Town,2020,60 - 64 years,4,6,10
Castlebar Town,2020,65 - 69 years,6,5,11
Castlebar Town,2020,70 - 74 years,3,4,7
Castlebar Town,2020,75 - 79 years,6,7,13
Castlebar Town,2020,80 - 84 years,4,7,11
Castlebar Town,2020,85 years and over,25,18,43
Castlebar Town,2020,Under 1 year,1,0,1
Castleblaney Town,2007,1 - 4 years,0,0,0
Castleblaney Town,2007,10 - 14 years,0,0,0
Castleblaney Town,2007,15 - 19 years,0,1,1
Castleblaney Town,2007,20 - 24 years,0,0,0
Castleblaney Town,2007,25 - 29 years,0,0,0
Castleblaney Town,2007,30 - 34 years,0,1,1
Castleblaney Town,2007,35 - 39 years,1,0,1
Castleblaney Town,2007,40 - 44 years,0,0,0
Castleblaney Town,2007,45 - 49 years,0,0,0
Castleblaney Town,2007,5 - 9 years,0,1,1
Castleblaney Town,2007,50 - 54 years,0,1,1
Castleblaney Town,2007,55 - 59 years,2,4,6
Castleblaney Town,2007,60 - 64 years,1,2,3
Castleblaney Town,2007,65 - 69 years,3,3,6
Castleblaney Town,2007,70 - 74 years,3,5,8
Castleblaney Town,2007,75 - 79 years,3,6,9
Castleblaney Town,2007,80 - 84 years,8,5,13
Castleblaney Town,2007,85 years and over,11,7,18
Castleblaney Town,2007,Under 1 year,0,0,0
Castleblaney Town,2008,1 - 4 years,0,0,0
Castleblaney Town,2008,10 - 14 years,0,0,0
Castleblaney Town,2008,15 - 19 years,0,1,1
Castleblaney Town,2008,20 - 24 years,0,2,2
Castleblaney Town,2008,25 - 29 years,0,0,0
Castleblaney Town,2008,30 - 34 years,0,1,1
Castleblaney Town,2008,35 - 39 years,1,0,1
Castleblaney Town,2008,40 - 44 years,0,0,0
Castleblaney Town,2008,45 - 49 years,1,0,1
Castleblaney Town,2008,5 - 9 years,0,1,1
Castleblaney Town,2008,50 - 54 years,1,2,3
Castleblaney Town,2008,55 - 59 years,2,1,3
Castleblaney Town,2008,60 - 64 years,2,4,6
Castleblaney Town,2008,65 - 69 years,2,3,5
Castleblaney Town,2008,70 - 74 years,3,3,6
Castleblaney Town,2008,75 - 79 years,2,3,5
Castleblaney Town,2008,80 - 84 years,3,7,10
Castleblaney Town,2008,85 years and over,14,12,26
Castleblaney Town,2008,Under 1 year,1,0,1
Castleblaney Town,2009,1 - 4 years,0,0,0
Castleblaney Town,2009,10 - 14 years,0,0,0
Castleblaney Town,2009,15 - 19 years,0,1,1
Castleblaney Town,2009,20 - 24 years,0,1,1
Castleblaney Town,2009,25 - 29 years,0,1,1
Castleblaney Town,2009,30 - 34 years,0,1,1
Castleblaney Town,2009,35 - 39 years,1,0,1
Castleblaney Town,2009,40 - 44 years,0,0,0
Castleblaney Town,2009,45 - 49 years,1,2,3
Castleblaney Town,2009,5 - 9 years,0,1,1
Castleblaney Town,2009,50 - 54 years,1,1,2
Castleblaney Town,2009,55 - 59 years,2,1,3
Castleblaney Town,2009,60 - 64 years,2,4,6
Castleblaney Town,2009,65 - 69 years,1,2,3
Castleblaney Town,2009,70 - 74 years,2,3,5
Castleblaney Town,2009,75 - 79 years,2,3,5
Castleblaney Town,2009,80 - 84 years,6,4,10
Castleblaney Town,2009,85 years and over,7,3,10
Castleblaney Town,2009,Under 1 year,1,1,2
Castleblaney Town,2010,1 - 4 years,0,0,0
Castleblaney Town,2010,10 - 14 years,0,0,0
Castleblaney Town,2010,15 - 19 years,0,1,1
Castleblaney Town,2010,20 - 24 years,0,1,1
Castleblaney Town,2010,25 - 29 years,0,1,1
Castleblaney Town,2010,30 - 34 years,0,1,1
Castleblaney Town,2010,35 - 39 years,1,0,1
Castleblaney Town,2010,40 - 44 years,0,0,0
Castleblaney Town,2010,45 - 49 years,1,1,2
Castleblaney Town,2010,5 - 9 years,0,1,1
Castleblaney Town,2010,50 - 54 years,1,1,2
Castleblaney Town,2010,55 - 59 years,2,1,3
Castleblaney Town,2010,60 - 64 years,2,1,3
Castleblaney Town,2010,65 - 69 years,1,1,2
Castleblaney Town,2010,70 - 74 years,1,4,5
Castleblaney Town,2010,75 - 79 years,3,5,8
Castleblaney Town,2010,80 - 84 years,5,4,9
Castleblaney Town,2010,85 years and over,4,3,7
Castleblaney Town,2010,Under 1 year,1,1,2
Castleblaney Town,2011,1 - 4 years,0,0,0
Castleblaney Town,2011,10 - 14 years,0,0,0
Castleblaney Town,2011,15 - 19 years,0,0,0
Castleblaney Town,2011,20 - 24 years,0,0,0
Castleblaney Town,2011,25 - 29 years,0,1,1
Castleblaney Town,2011,30 - 34 years,0,1,1
Castleblaney Town,2011,35 - 39 years,0,0,0
Castleblaney Town,2011,40 - 44 years,0,0,0
Castleblaney Town,2011,45 - 49 years,1,1,2
Castleblaney Town,2011,5 - 9 years,0,0,0
Castleblaney Town,2011,50 - 54 years,0,3,3
Castleblaney Town,2011,55 - 59 years,1,1,2
Castleblaney Town,2011,60 - 64 years,0,2,2
Castleblaney Town,2011,65 - 69 years,1,1,2
Castleblaney Town,2011,70 - 74 years,0,2,2
Castleblaney Town,2011,75 - 79 years,1,3,4
Castleblaney Town,2011,80 - 84 years,2,2,4
Castleblaney Town,2011,85 years and over,3,2,5
Castleblaney Town,2011,Under 1 year,0,0,0
Castleblaney Town,2012,1 - 4 years,0,0,0
Castleblaney Town,2012,10 - 14 years,0,0,0
Castleblaney Town,2012,15 - 19 years,0,0,0
Castleblaney Town,2012,20 - 24 years,0,0,0
Castleblaney Town,2012,25 - 29 years,0,1,1
Castleblaney Town,2012,30 - 34 years,0,1,1
Castleblaney Town,2012,35 - 39 years,1,0,1
Castleblaney Town,2012,40 - 44 years,0,0,0
Castleblaney Town,2012,45 - 49 years,1,1,2
Castleblaney Town,2012,5 - 9 years,0,0,0
Castleblaney Town,2012,50 - 54 years,0,3,3
Castleblaney Town,2012,55 - 59 years,1,2,3
Castleblaney Town,2012,60 - 64 years,2,1,3
Castleblaney Town,2012,65 - 69 years,2,1,3
Castleblaney Town,2012,70 - 74 years,0,2,2
Castleblaney Town,2012,75 - 79 years,1,1,2
Castleblaney Town,2012,80 - 84 years,3,3,6
Castleblaney Town,2012,85 years and over,11,3,14
Castleblaney Town,2012,Under 1 year,0,0,0
Castleblaney Town,2013,1 - 4 years,0,0,0
Castleblaney Town,2013,10 - 14 years,0,0,0
Castleblaney Town,2013,15 - 19 years,0,0,0
Castleblaney Town,2013,20 - 24 years,0,0,0
Castleblaney Town,2013,25 - 29 years,0,0,0
Castleblaney Town,2013,30 - 34 years,0,0,0
Castleblaney Town,2013,35 - 39 years,0,0,0
Castleblaney Town,2013,40 - 44 years,0,0,0
Castleblaney Town,2013,45 - 49 years,0,0,0
Castleblaney Town,2013,5 - 9 years,0,0,0
Castleblaney Town,2013,50 - 54 years,0,1,1
Castleblaney Town,2013,55 - 59 years,1,2,3
Castleblaney Town,2013,60 - 64 years,0,0,0
Castleblaney Town,2013,65 - 69 years,0,2,2
Castleblaney Town,2013,70 - 74 years,1,2,3
Castleblaney Town,2013,75 - 79 years,1,0,1
Castleblaney Town,2013,80 - 84 years,1,1,2
Castleblaney Town,2013,85 years and over,6,3,9
Castleblaney Town,2013,Under 1 year,1,0,1
Castleblaney Town,2014,1 - 4 years,0,0,0
Castleblaney Town,2014,10 - 14 years,0,0,0
Castleblaney Town,2014,15 - 19 years,0,0,0
Castleblaney Town,2014,20 - 24 years,0,0,0
Castleblaney Town,2014,25 - 29 years,0,0,0
Castleblaney Town,2014,30 - 34 years,0,0,0
Castleblaney Town,2014,35 - 39 years,0,0,0
Castleblaney Town,2014,40 - 44 years,0,0,0
Castleblaney Town,2014,45 - 49 years,0,0,0
Castleblaney Town,2014,5 - 9 years,0,0,0
Castleblaney Town,2014,50 - 54 years,0,1,1
Castleblaney Town,2014,55 - 59 years,1,2,3
Castleblaney Town,2014,60 - 64 years,0,0,0
Castleblaney Town,2014,65 - 69 years,2,1,3
Castleblaney Town,2014,70 - 74 years,1,1,2
Castleblaney Town,2014,75 - 79 years,2,0,2
Castleblaney Town,2014,80 - 84 years,4,4,8
Castleblaney Town,2014,85 years and over,2,3,5
Castleblaney Town,2014,Under 1 year,1,0,1
Castleblaney Town,2015,1 - 4 years,0,0,0
Castleblaney Town,2015,10 - 14 years,0,0,0
Castleblaney Town,2015,15 - 19 years,0,0,0
Castleblaney Town,2015,20 - 24 years,0,0,0
Castleblaney Town,2015,25 - 29 years,0,0,0
Castleblaney Town,2015,30 - 34 years,0,0,0
Castleblaney Town,2015,35 - 39 years,0,0,0
Castleblaney Town,2015,40 - 44 years,0,0,0
Castleblaney Town,2015,45 - 49 years,0,0,0
Castleblaney Town,2015,5 - 9 years,0,0,0
Castleblaney Town,2015,50 - 54 years,0,1,1
Castleblaney Town,2015,55 - 59 years,1,2,3
Castleblaney Town,2015,60 - 64 years,0,0,0
Castleblaney Town,2015,65 - 69 years,2,1,3
Castleblaney Town,2015,70 - 74 years,1,1,2
Castleblaney Town,2015,75 - 79 years,2,0,2
Castleblaney Town,2015,80 - 84 years,4,4,8
Castleblaney Town,2015,85 years and over,2,3,5
Castleblaney Town,2015,Under 1 year,1,0,1
Castleblaney Town,2016,1 - 4 years,0,0,0
Castleblaney Town,2016,10 - 14 years,0,0,0
Castleblaney Town,2016,15 - 19 years,0,0,0
Castleblaney Town,2016,20 - 24 years,0,0,0
Castleblaney Town,2016,25 - 29 years,0,0,0
Castleblaney Town,2016,30 - 34 years,0,0,0
Castleblaney Town,2016,35 - 39 years,0,0,0
Castleblaney Town,2016,40 - 44 years,0,0,0
Castleblaney Town,2016,45 - 49 years,0,0,0
Castleblaney Town,2016,5 - 9 years,0,0,0
Castleblaney Town,2016,50 - 54 years,0,1,1
Castleblaney Town,2016,55 - 59 years,1,2,3
Castleblaney Town,2016,60 - 64 years,0,0,0
Castleblaney Town,2016,65 - 69 years,2,1,3
Castleblaney Town,2016,70 - 74 years,1,1,2
Castleblaney Town,2016,75 - 79 years,2,0,2
Castleblaney Town,2016,80 - 84 years,4,4,8
Castleblaney Town,2016,85 years and over,2,3,5
Castleblaney Town,2016,Under 1 year,1,0,1
Castleblaney Town,2017,1 - 4 years,0,0,0
Castleblaney Town,2017,10 - 14 years,0,0,0
Castleblaney Town,2017,15 - 19 years,0,0,0
Castleblaney Town,2017,20 - 24 years,0,0,0
Castleblaney Town,2017,25 - 29 years,1,0,1
Castleblaney Town,2017,30 - 34 years,0,0,0
Castleblaney Town,2017,35 - 39 years,0,0,0
Castleblaney Town,2017,40 - 44 years,0,1,1
Castleblaney Town,2017,45 - 49 years,0,1,1
Castleblaney Town,2017,5 - 9 years,0,0,0
Castleblaney Town,2017,50 - 54 years,1,1,2
Castleblaney Town,2017,55 - 59 years,1,2,3
Castleblaney Town,2017,60 - 64 years,1,3,4
Castleblaney Town,2017,65 - 69 years,2,2,4
Castleblaney Town,2017,70 - 74 years,1,1,2
Castleblaney Town,2017,75 - 79 years,2,4,6
Castleblaney Town,2017,80 - 84 years,3,3,6
Castleblaney Town,2017,85 years and over,3,1,4
Castleblaney Town,2017,Under 1 year,1,0,1
Castleblaney Town,2018,1 - 4 years,0,0,0
Castleblaney Town,2018,10 - 14 years,0,0,0
Castleblaney Town,2018,15 - 19 years,0,0,0
Castleblaney Town,2018,20 - 24 years,0,0,0
Castleblaney Town,2018,25 - 29 years,0,0,0
Castleblaney Town,2018,30 - 34 years,0,0,0
Castleblaney Town,2018,35 - 39 years,0,0,0
Castleblaney Town,2018,40 - 44 years,0,0,0
Castleblaney Town,2018,45 - 49 years,0,1,1
Castleblaney Town,2018,5 - 9 years,0,0,0
Castleblaney Town,2018,50 - 54 years,0,1,1
Castleblaney Town,2018,55 - 59 years,0,0,0
Castleblaney Town,2018,60 - 64 years,0,0,0
Castleblaney Town,2018,65 - 69 years,3,3,6
Castleblaney Town,2018,70 - 74 years,1,0,1
Castleblaney Town,2018,75 - 79 years,4,1,5
Castleblaney Town,2018,80 - 84 years,0,5,5
Castleblaney Town,2018,85 years and over,10,6,16
Castleblaney Town,2018,Under 1 year,1,0,1
Castleblaney Town,2019,1 - 4 years,0,0,0
Castleblaney Town,2019,10 - 14 years,0,0,0
Castleblaney Town,2019,15 - 19 years,0,0,0
Castleblaney Town,2019,20 - 24 years,0,0,0
Castleblaney Town,2019,25 - 29 years,0,0,0
Castleblaney Town,2019,30 - 34 years,0,0,0
Castleblaney Town,2019,35 - 39 years,0,0,0
Castleblaney Town,2019,40 - 44 years,0,0,0
Castleblaney Town,2019,45 - 49 years,0,1,1
Castleblaney Town,2019,5 - 9 years,0,0,0
Castleblaney Town,2019,50 - 54 years,0,1,1
Castleblaney Town,2019,55 - 59 years,0,0,0
Castleblaney Town,2019,60 - 64 years,0,0,0
Castleblaney Town,2019,65 - 69 years,3,3,6
Castleblaney Town,2019,70 - 74 years,1,0,1
Castleblaney Town,2019,75 - 79 years,4,1,5
Castleblaney Town,2019,80 - 84 years,0,5,5
Castleblaney Town,2019,85 years and over,10,6,16
Castleblaney Town,2019,Under 1 year,1,0,1
Castleblaney Town,2020,1 - 4 years,0,0,0
Castleblaney Town,2020,10 - 14 years,0,0,0
Castleblaney Town,2020,15 - 19 years,0,0,0
Castleblaney Town,2020,20 - 24 years,0,0,0
Castleblaney Town,2020,25 - 29 years,0,0,0
Castleblaney Town,2020,30 - 34 years,0,0,0
Castleblaney Town,2020,35 - 39 years,0,0,0
Castleblaney Town,2020,40 - 44 years,0,0,0
Castleblaney Town,2020,45 - 49 years,0,1,1
Castleblaney Town,2020,5 - 9 years,0,0,0
Castleblaney Town,2020,50 - 54 years,0,1,1
Castleblaney Town,2020,55 - 59 years,0,0,0
Castleblaney Town,2020,60 - 64 years,0,0,0
Castleblaney Town,2020,65 - 69 years,3,3,6
Castleblaney Town,2020,70 - 74 years,1,0,1
Castleblaney Town,2020,75 - 79 years,4,1,5
Castleblaney Town,2020,80 - 84 years,0,5,5
Castleblaney Town,2020,85 years and over,10,6,16
Castleblaney Town,2020,Under 1 year,1,0,1
Cavan,2007,1 - 4 years,2,1,3
Cavan,2007,10 - 14 years,0,0,0
Cavan,2007,15 - 19 years,0,4,4
Cavan,2007,20 - 24 years,0,1,1
Cavan,2007,25 - 29 years,1,2,3
Cavan,2007,30 - 34 years,0,5,5
Cavan,2007,35 - 39 years,1,5,6
Cavan,2007,40 - 44 years,1,5,6
Cavan,2007,45 - 49 years,2,6,8
Cavan,2007,5 - 9 years,1,0,1
Cavan,2007,50 - 54 years,7,4,11
Cavan,2007,55 - 59 years,8,15,23
Cavan,2007,60 - 64 years,17,16,33
Cavan,2007,65 - 69 years,11,20,31
Cavan,2007,70 - 74 years,18,31,49
Cavan,2007,75 - 79 years,39,48,87
Cavan,2007,80 - 84 years,44,55,99
Cavan,2007,85 years and over,101,62,163
Cavan,2007,Under 1 year,1,1,2
Cavan,2008,1 - 4 years,1,1,2
Cavan,2008,10 - 14 years,0,0,0
Cavan,2008,15 - 19 years,1,1,2
Cavan,2008,20 - 24 years,2,2,4
Cavan,2008,25 - 29 years,2,2,4
Cavan,2008,30 - 34 years,1,5,6
Cavan,2008,35 - 39 years,2,2,4
Cavan,2008,40 - 44 years,3,4,7
Cavan,2008,45 - 49 years,10,6,16
Cavan,2008,5 - 9 years,1,0,1
Cavan,2008,50 - 54 years,9,5,14
Cavan,2008,55 - 59 years,10,12,22
Cavan,2008,60 - 64 years,15,24,39
Cavan,2008,65 - 69 years,10,22,32
Cavan,2008,70 - 74 years,14,30,44
Cavan,2008,75 - 79 years,15,42,57
Cavan,2008,80 - 84 years,40,41,81
Cavan,2008,85 years and over,93,59,152
Cavan,2008,Under 1 year,1,1,2
Cavan,2009,1 - 4 years,1,1,2
Cavan,2009,10 - 14 years,0,1,1
Cavan,2009,15 - 19 years,1,2,3
Cavan,2009,20 - 24 years,2,4,6
Cavan,2009,25 - 29 years,2,7,9
Cavan,2009,30 - 34 years,5,3,8
Cavan,2009,35 - 39 years,5,5,10
Cavan,2009,40 - 44 years,2,2,4
Cavan,2009,45 - 49 years,2,2,4
Cavan,2009,5 - 9 years,1,1,2
Cavan,2009,50 - 54 years,2,9,11
Cavan,2009,55 - 59 years,6,14,20
Cavan,2009,60 - 64 years,14,14,28
Cavan,2009,65 - 69 years,9,22,31
Cavan,2009,70 - 74 years,17,31,48
Cavan,2009,75 - 79 years,18,39,57
Cavan,2009,80 - 84 years,55,49,104
Cavan,2009,85 years and over,82,61,143
Cavan,2009,Under 1 year,2,1,3
Cavan,2010,1 - 4 years,1,1,2
Cavan,2010,10 - 14 years,0,1,1
Cavan,2010,15 - 19 years,1,1,2
Cavan,2010,20 - 24 years,2,5,7
Cavan,2010,25 - 29 years,2,3,5
Cavan,2010,30 - 34 years,1,3,4
Cavan,2010,35 - 39 years,1,5,6
Cavan,2010,40 - 44 years,1,9,10
Cavan,2010,45 - 49 years,2,4,6
Cavan,2010,5 - 9 years,1,1,2
Cavan,2010,50 - 54 years,4,7,11
Cavan,2010,55 - 59 years,8,12,20
Cavan,2010,60 - 64 years,8,19,27
Cavan,2010,65 - 69 years,11,26,37
Cavan,2010,70 - 74 years,9,25,34
Cavan,2010,75 - 79 years,23,29,52
Cavan,2010,80 - 84 years,41,52,93
Cavan,2010,85 years and over,116,62,178
Cavan,2010,Under 1 year,1,3,4
Cavan,2011,1 - 4 years,1,0,1
Cavan,2011,10 - 14 years,0,0,0
Cavan,2011,15 - 19 years,1,2,3
Cavan,2011,20 - 24 years,1,2,3
Cavan,2011,25 - 29 years,1,6,7
Cavan,2011,30 - 34 years,0,2,2
Cavan,2011,35 - 39 years,1,3,4
Cavan,2011,40 - 44 years,2,6,8
Cavan,2011,45 - 49 years,2,5,7
Cavan,2011,5 - 9 years,0,0,0
Cavan,2011,50 - 54 years,5,7,12
Cavan,2011,55 - 59 years,6,17,23
Cavan,2011,60 - 64 years,14,17,31
Cavan,2011,65 - 69 years,20,23,43
Cavan,2011,70 - 74 years,13,26,39
Cavan,2011,75 - 79 years,26,46,72
Cavan,2011,80 - 84 years,43,47,90
Cavan,2011,85 years and over,113,89,202
Cavan,2011,Under 1 year,3,1,4
Cavan,2012,1 - 4 years,1,1,2
Cavan,2012,10 - 14 years,0,0,0
Cavan,2012,15 - 19 years,1,2,3
Cavan,2012,20 - 24 years,1,4,5
Cavan,2012,25 - 29 years,1,2,3
Cavan,2012,30 - 34 years,0,2,2
Cavan,2012,35 - 39 years,1,1,2
Cavan,2012,40 - 44 years,2,2,4
Cavan,2012,45 - 49 years,1,8,9
Cavan,2012,5 - 9 years,0,0,0
Cavan,2012,50 - 54 years,5,3,8
Cavan,2012,55 - 59 years,8,15,23
Cavan,2012,60 - 64 years,8,17,25
Cavan,2012,65 - 69 years,13,26,39
Cavan,2012,70 - 74 years,15,20,35
Cavan,2012,75 - 79 years,28,43,71
Cavan,2012,80 - 84 years,43,50,93
Cavan,2012,85 years and over,116,83,199
Cavan,2012,Under 1 year,2,1,3
Cavan,2013,1 - 4 years,0,0,0
Cavan,2013,10 - 14 years,0,0,0
Cavan,2013,15 - 19 years,0,2,2
Cavan,2013,20 - 24 years,0,1,1
Cavan,2013,25 - 29 years,2,1,3
Cavan,2013,30 - 34 years,4,3,7
Cavan,2013,35 - 39 years,2,5,7
Cavan,2013,40 - 44 years,3,6,9
Cavan,2013,45 - 49 years,4,1,5
Cavan,2013,5 - 9 years,0,0,0
Cavan,2013,50 - 54 years,5,7,12
Cavan,2013,55 - 59 years,5,14,19
Cavan,2013,60 - 64 years,4,17,21
Cavan,2013,65 - 69 years,13,30,43
Cavan,2013,70 - 74 years,10,22,32
Cavan,2013,75 - 79 years,25,38,63
Cavan,2013,80 - 84 years,41,44,85
Cavan,2013,85 years and over,113,70,183
Cavan,2013,Under 1 year,0,3,3
Cavan,2014,1 - 4 years,0,1,1
Cavan,2014,10 - 14 years,0,0,0
Cavan,2014,15 - 19 years,0,2,2
Cavan,2014,20 - 24 years,0,4,4
Cavan,2014,25 - 29 years,2,3,5
Cavan,2014,30 - 34 years,1,2,3
Cavan,2014,35 - 39 years,1,5,6
Cavan,2014,40 - 44 years,3,2,5
Cavan,2014,45 - 49 years,1,5,6
Cavan,2014,5 - 9 years,0,0,0
Cavan,2014,50 - 54 years,8,12,20
Cavan,2014,55 - 59 years,4,10,14
Cavan,2014,60 - 64 years,11,6,17
Cavan,2014,65 - 69 years,9,20,29
Cavan,2014,70 - 74 years,20,26,46
Cavan,2014,75 - 79 years,23,38,61
Cavan,2014,80 - 84 years,37,47,84
Cavan,2014,85 years and over,126,80,206
Cavan,2014,Under 1 year,2,3,5
Cavan,2015,1 - 4 years,0,1,1
Cavan,2015,10 - 14 years,0,0,0
Cavan,2015,15 - 19 years,0,1,1
Cavan,2015,20 - 24 years,0,1,1
Cavan,2015,25 - 29 years,2,2,4
Cavan,2015,30 - 34 years,1,1,2
Cavan,2015,35 - 39 years,2,2,4
Cavan,2015,40 - 44 years,3,2,5
Cavan,2015,45 - 49 years,3,3,6
Cavan,2015,5 - 9 years,0,0,0
Cavan,2015,50 - 54 years,11,7,18
Cavan,2015,55 - 59 years,4,10,14
Cavan,2015,60 - 64 years,12,16,28
Cavan,2015,65 - 69 years,16,25,41
Cavan,2015,70 - 74 years,17,34,51
Cavan,2015,75 - 79 years,21,29,50
Cavan,2015,80 - 84 years,47,47,94
Cavan,2015,85 years and over,121,64,185
Cavan,2015,Under 1 year,2,2,4
Cavan,2016,1 - 4 years,0,1,1
Cavan,2016,10 - 14 years,0,0,0
Cavan,2016,15 - 19 years,2,1,3
Cavan,2016,20 - 24 years,1,1,2
Cavan,2016,25 - 29 years,2,1,3
Cavan,2016,30 - 34 years,2,3,5
Cavan,2016,35 - 39 years,2,4,6
Cavan,2016,40 - 44 years,2,5,7
Cavan,2016,45 - 49 years,6,6,12
Cavan,2016,5 - 9 years,0,0,0
Cavan,2016,50 - 54 years,7,6,13
Cavan,2016,55 - 59 years,6,13,19
Cavan,2016,60 - 64 years,14,20,34
Cavan,2016,65 - 69 years,10,26,36
Cavan,2016,70 - 74 years,23,38,61
Cavan,2016,75 - 79 years,20,28,48
Cavan,2016,80 - 84 years,41,46,87
Cavan,2016,85 years and over,110,78,188
Cavan,2016,Under 1 year,2,2,4
Cavan,2017,1 - 4 years,0,1,1
Cavan,2017,10 - 14 years,0,0,0
Cavan,2017,15 - 19 years,2,1,3
Cavan,2017,20 - 24 years,1,2,3
Cavan,2017,25 - 29 years,2,1,3
Cavan,2017,30 - 34 years,2,3,5
Cavan,2017,35 - 39 years,1,2,3
Cavan,2017,40 - 44 years,4,3,7
Cavan,2017,45 - 49 years,5,6,11
Cavan,2017,5 - 9 years,1,0,1
Cavan,2017,50 - 54 years,4,13,17
Cavan,2017,55 - 59 years,1,12,13
Cavan,2017,60 - 64 years,7,17,24
Cavan,2017,65 - 69 years,15,20,35
Cavan,2017,70 - 74 years,14,31,45
Cavan,2017,75 - 79 years,27,33,60
Cavan,2017,80 - 84 years,28,41,69
Cavan,2017,85 years and over,115,81,196
Cavan,2017,Under 1 year,1,3,4
Cavan,2018,1 - 4 years,0,0,0
Cavan,2018,10 - 14 years,0,0,0
Cavan,2018,15 - 19 years,0,1,1
Cavan,2018,20 - 24 years,0,3,3
Cavan,2018,25 - 29 years,1,2,3
Cavan,2018,30 - 34 years,0,4,4
Cavan,2018,35 - 39 years,0,3,3
Cavan,2018,40 - 44 years,4,6,10
Cavan,2018,45 - 49 years,2,4,6
Cavan,2018,5 - 9 years,0,0,0
Cavan,2018,50 - 54 years,5,3,8
Cavan,2018,55 - 59 years,5,18,23
Cavan,2018,60 - 64 years,9,21,30
Cavan,2018,65 - 69 years,20,23,43
Cavan,2018,70 - 74 years,13,32,45
Cavan,2018,75 - 79 years,22,40,62
Cavan,2018,80 - 84 years,33,45,78
Cavan,2018,85 years and over,109,74,183
Cavan,2018,Under 1 year,0,3,3
Cavan,2019,1 - 4 years,0,0,0
Cavan,2019,10 - 14 years,0,0,0
Cavan,2019,15 - 19 years,1,1,2
Cavan,2019,20 - 24 years,2,2,4
Cavan,2019,25 - 29 years,2,2,4
Cavan,2019,30 - 34 years,4,4,8
Cavan,2019,35 - 39 years,2,2,4
Cavan,2019,40 - 44 years,2,2,4
Cavan,2019,45 - 49 years,5,5,10
Cavan,2019,5 - 9 years,0,0,0
Cavan,2019,50 - 54 years,13,13,26
Cavan,2019,55 - 59 years,8,8,16
Cavan,2019,60 - 64 years,22,22,44
Cavan,2019,65 - 69 years,25,25,50
Cavan,2019,70 - 74 years,44,44,88
Cavan,2019,75 - 79 years,40,40,80
Cavan,2019,80 - 84 years,41,41,82
Cavan,2019,85 years and over,80,80,160
Cavan,2019,Under 1 year,0,0,0
Cavan,2020,1 - 4 years,1,1,2
Cavan,2020,10 - 14 years,0,1,1
Cavan,2020,15 - 19 years,1,1,2
Cavan,2020,20 - 24 years,2,2,4
Cavan,2020,25 - 29 years,2,3,5
Cavan,2020,30 - 34 years,1,3,4
Cavan,2020,35 - 39 years,2,1,3
Cavan,2020,40 - 44 years,2,4,6
Cavan,2020,45 - 49 years,4,3,7
Cavan,2020,5 - 9 years,0,0,0
Cavan,2020,50 - 54 years,4,6,10
Cavan,2020,55 - 59 years,8,12,20
Cavan,2020,60 - 64 years,10,15,25
Cavan,2020,65 - 69 years,12,30,42
Cavan,2020,70 - 74 years,16,33,49
Cavan,2020,75 - 79 years,20,45,65
Cavan,2020,80 - 84 years,39,52,91
Cavan,2020,85 years and over,130,97,227
Cavan,2020,Under 1 year,1,0,1
Cavan Town,2007,1 - 4 years,0,1,1
Cavan Town,2007,10 - 14 years,0,0,0
Cavan Town,2007,15 - 19 years,0,2,2
Cavan Town,2007,20 - 24 years,0,0,0
Cavan Town,2007,25 - 29 years,0,0,0
Cavan Town,2007,30 - 34 years,0,0,0
Cavan Town,2007,35 - 39 years,0,1,1
Cavan Town,2007,40 - 44 years,1,0,1
Cavan Town,2007,45 - 49 years,0,0,0
Cavan Town,2007,5 - 9 years,0,0,0
Cavan Town,2007,50 - 54 years,3,1,4
Cavan Town,2007,55 - 59 years,1,1,2
Cavan Town,2007,60 - 64 years,2,3,5
Cavan Town,2007,65 - 69 years,1,0,1
Cavan Town,2007,70 - 74 years,1,3,4
Cavan Town,2007,75 - 79 years,5,4,9
Cavan Town,2007,80 - 84 years,3,2,5
Cavan Town,2007,85 years and over,5,2,7
Cavan Town,2007,Under 1 year,0,0,0
Cavan Town,2008,1 - 4 years,0,1,1
Cavan Town,2008,10 - 14 years,0,0,0
Cavan Town,2008,15 - 19 years,0,2,2
Cavan Town,2008,20 - 24 years,0,0,0
Cavan Town,2008,25 - 29 years,1,1,2
Cavan Town,2008,30 - 34 years,0,0,0
Cavan Town,2008,35 - 39 years,0,1,1
Cavan Town,2008,40 - 44 years,1,1,2
Cavan Town,2008,45 - 49 years,2,0,2
Cavan Town,2008,5 - 9 years,0,0,0
Cavan Town,2008,50 - 54 years,1,1,2
Cavan Town,2008,55 - 59 years,1,1,2
Cavan Town,2008,60 - 64 years,1,2,3
Cavan Town,2008,65 - 69 years,1,4,5
Cavan Town,2008,70 - 74 years,1,3,4
Cavan Town,2008,75 - 79 years,4,3,7
Cavan Town,2008,80 - 84 years,3,2,5
Cavan Town,2008,85 years and over,11,2,13
Cavan Town,2008,Under 1 year,0,0,0
Cavan Town,2009,1 - 4 years,0,1,1
Cavan Town,2009,10 - 14 years,0,0,0
Cavan Town,2009,15 - 19 years,0,2,2
Cavan Town,2009,20 - 24 years,0,0,0
Cavan Town,2009,25 - 29 years,1,1,2
Cavan Town,2009,30 - 34 years,1,1,2
Cavan Town,2009,35 - 39 years,0,3,3
Cavan Town,2009,40 - 44 years,1,1,2
Cavan Town,2009,45 - 49 years,1,0,1
Cavan Town,2009,5 - 9 years,0,0,0
Cavan Town,2009,50 - 54 years,1,1,2
Cavan Town,2009,55 - 59 years,1,4,5
Cavan Town,2009,60 - 64 years,1,1,2
Cavan Town,2009,65 - 69 years,3,2,5
Cavan Town,2009,70 - 74 years,1,4,5
Cavan Town,2009,75 - 79 years,2,3,5
Cavan Town,2009,80 - 84 years,6,4,10
Cavan Town,2009,85 years and over,5,2,7
Cavan Town,2009,Under 1 year,0,0,0
Cavan Town,2010,1 - 4 years,0,1,1
Cavan Town,2010,10 - 14 years,0,0,0
Cavan Town,2010,15 - 19 years,0,2,2
Cavan Town,2010,20 - 24 years,0,2,2
Cavan Town,2010,25 - 29 years,1,1,2
Cavan Town,2010,30 - 34 years,1,1,2
Cavan Town,2010,35 - 39 years,0,3,3
Cavan Town,2010,40 - 44 years,1,3,4
Cavan Town,2010,45 - 49 years,1,0,1
Cavan Town,2010,5 - 9 years,0,0,0
Cavan Town,2010,50 - 54 years,1,1,2
Cavan Town,2010,55 - 59 years,1,2,3
Cavan Town,2010,60 - 64 years,1,2,3
Cavan Town,2010,65 - 69 years,1,1,2
Cavan Town,2010,70 - 74 years,1,1,2
Cavan Town,2010,75 - 79 years,3,3,6
Cavan Town,2010,80 - 84 years,2,1,3
Cavan Town,2010,85 years and over,7,5,12
Cavan Town,2010,Under 1 year,1,1,2
Cavan Town,2011,1 - 4 years,1,0,1
Cavan Town,2011,10 - 14 years,0,0,0
Cavan Town,2011,15 - 19 years,0,0,0
Cavan Town,2011,20 - 24 years,1,0,1
Cavan Town,2011,25 - 29 years,0,0,0
Cavan Town,2011,30 - 34 years,0,1,1
Cavan Town,2011,35 - 39 years,0,0,0
Cavan Town,2011,40 - 44 years,0,1,1
Cavan Town,2011,45 - 49 years,1,0,1
Cavan Town,2011,5 - 9 years,0,0,0
Cavan Town,2011,50 - 54 years,0,2,2
Cavan Town,2011,55 - 59 years,2,2,4
Cavan Town,2011,60 - 64 years,0,1,1
Cavan Town,2011,65 - 69 years,2,2,4
Cavan Town,2011,70 - 74 years,0,1,1
Cavan Town,2011,75 - 79 years,2,4,6
Cavan Town,2011,80 - 84 years,4,1,5
Cavan Town,2011,85 years and over,6,4,10
Cavan Town,2011,Under 1 year,1,0,1
Cavan Town,2012,1 - 4 years,1,0,1
Cavan Town,2012,10 - 14 years,0,0,0
Cavan Town,2012,15 - 19 years,0,0,0
Cavan Town,2012,20 - 24 years,1,0,1
Cavan Town,2012,25 - 29 years,0,1,1
Cavan Town,2012,30 - 34 years,0,1,1
Cavan Town,2012,35 - 39 years,0,1,1
Cavan Town,2012,40 - 44 years,0,1,1
Cavan Town,2012,45 - 49 years,1,0,1
Cavan Town,2012,5 - 9 years,0,0,0
Cavan Town,2012,50 - 54 years,1,2,3
Cavan Town,2012,55 - 59 years,2,2,4
Cavan Town,2012,60 - 64 years,1,2,3
Cavan Town,2012,65 - 69 years,1,2,3
Cavan Town,2012,70 - 74 years,1,1,2
Cavan Town,2012,75 - 79 years,5,1,6
Cavan Town,2012,80 - 84 years,4,3,7
Cavan Town,2012,85 years and over,11,11,22
Cavan Town,2012,Under 1 year,1,0,1
Cavan Town,2013,1 - 4 years,0,0,0
Cavan Town,2013,10 - 14 years,0,0,0
Cavan Town,2013,15 - 19 years,0,0,0
Cavan Town,2013,20 - 24 years,0,0,0
Cavan Town,2013,25 - 29 years,0,0,0
Cavan Town,2013,30 - 34 years,1,0,1
Cavan Town,2013,35 - 39 years,1,1,2
Cavan Town,2013,40 - 44 years,0,0,0
Cavan Town,2013,45 - 49 years,2,0,2
Cavan Town,2013,5 - 9 years,0,0,0
Cavan Town,2013,50 - 54 years,0,0,0
Cavan Town,2013,55 - 59 years,0,0,0
Cavan Town,2013,60 - 64 years,1,0,1
Cavan Town,2013,65 - 69 years,0,3,3
Cavan Town,2013,70 - 74 years,0,2,2
Cavan Town,2013,75 - 79 years,5,4,9
Cavan Town,2013,80 - 84 years,2,3,5
Cavan Town,2013,85 years and over,6,8,14
Cavan Town,2013,Under 1 year,0,0,0
Cavan Town,2014,1 - 4 years,0,0,0
Cavan Town,2014,10 - 14 years,0,0,0
Cavan Town,2014,15 - 19 years,0,0,0
Cavan Town,2014,20 - 24 years,0,0,0
Cavan Town,2014,25 - 29 years,0,0,0
Cavan Town,2014,30 - 34 years,1,0,1
Cavan Town,2014,35 - 39 years,1,2,3
Cavan Town,2014,40 - 44 years,0,0,0
Cavan Town,2014,45 - 49 years,2,2,4
Cavan Town,2014,5 - 9 years,0,0,0
Cavan Town,2014,50 - 54 years,0,1,1
Cavan Town,2014,55 - 59 years,0,1,1
Cavan Town,2014,60 - 64 years,1,0,1
Cavan Town,2014,65 - 69 years,0,1,1
Cavan Town,2014,70 - 74 years,0,1,1
Cavan Town,2014,75 - 79 years,1,3,4
Cavan Town,2014,80 - 84 years,3,7,10
Cavan Town,2014,85 years and over,15,9,24
Cavan Town,2014,Under 1 year,0,0,0
Cavan Town,2015,1 - 4 years,0,0,0
Cavan Town,2015,10 - 14 years,0,0,0
Cavan Town,2015,15 - 19 years,0,0,0
Cavan Town,2015,20 - 24 years,0,0,0
Cavan Town,2015,25 - 29 years,0,0,0
Cavan Town,2015,30 - 34 years,1,0,1
Cavan Town,2015,35 - 39 years,1,2,3
Cavan Town,2015,40 - 44 years,0,0,0
Cavan Town,2015,45 - 49 years,2,2,4
Cavan Town,2015,5 - 9 years,0,0,0
Cavan Town,2015,50 - 54 years,0,1,1
Cavan Town,2015,55 - 59 years,0,1,1
Cavan Town,2015,60 - 64 years,1,0,1
Cavan Town,2015,65 - 69 years,0,1,1
Cavan Town,2015,70 - 74 years,0,1,1
Cavan Town,2015,75 - 79 years,1,3,4
Cavan Town,2015,80 - 84 years,3,7,10
Cavan Town,2015,85 years and over,15,9,24
Cavan Town,2015,Under 1 year,0,0,0
Cavan Town,2016,1 - 4 years,0,0,0
Cavan Town,2016,10 - 14 years,0,0,0
Cavan Town,2016,15 - 19 years,0,0,0
Cavan Town,2016,20 - 24 years,0,0,0
Cavan Town,2016,25 - 29 years,0,0,0
Cavan Town,2016,30 - 34 years,1,0,1
Cavan Town,2016,35 - 39 years,1,2,3
Cavan Town,2016,40 - 44 years,0,0,0
Cavan Town,2016,45 - 49 years,2,2,4
Cavan Town,2016,5 - 9 years,0,0,0
Cavan Town,2016,50 - 54 years,0,1,1
Cavan Town,2016,55 - 59 years,0,1,1
Cavan Town,2016,60 - 64 years,1,0,1
Cavan Town,2016,65 - 69 years,0,1,1
Cavan Town,2016,70 - 74 years,0,1,1
Cavan Town,2016,75 - 79 years,1,3,4
Cavan Town,2016,80 - 84 years,3,7,10
Cavan Town,2016,85 years and over,15,9,24
Cavan Town,2016,Under 1 year,0,0,0
Cavan Town,2017,1 - 4 years,0,0,0
Cavan Town,2017,10 - 14 years,0,0,0
Cavan Town,2017,15 - 19 years,0,0,0
Cavan Town,2017,20 - 24 years,0,0,0
Cavan Town,2017,25 - 29 years,0,0,0
Cavan Town,2017,30 - 34 years,1,0,1
Cavan Town,2017,35 - 39 years,1,2,3
Cavan Town,2017,40 - 44 years,0,1,1
Cavan Town,2017,45 - 49 years,1,2,3
Cavan Town,2017,5 - 9 years,0,0,0
Cavan Town,2017,50 - 54 years,0,2,2
Cavan Town,2017,55 - 59 years,0,5,5
Cavan Town,2017,60 - 64 years,1,1,2
Cavan Town,2017,65 - 69 years,2,4,6
Cavan Town,2017,70 - 74 years,1,2,3
Cavan Town,2017,75 - 79 years,1,3,4
Cavan Town,2017,80 - 84 years,1,3,4
Cavan Town,2017,85 years and over,11,5,16
Cavan Town,2017,Under 1 year,1,1,2
Cavan Town,2018,1 - 4 years,0,0,0
Cavan Town,2018,10 - 14 years,0,0,0
Cavan Town,2018,15 - 19 years,0,0,0
Cavan Town,2018,20 - 24 years,0,0,0
Cavan Town,2018,25 - 29 years,0,0,0
Cavan Town,2018,30 - 34 years,0,1,1
Cavan Town,2018,35 - 39 years,0,0,0
Cavan Town,2018,40 - 44 years,0,0,0
Cavan Town,2018,45 - 49 years,0,1,1
Cavan Town,2018,5 - 9 years,0,0,0
Cavan Town,2018,50 - 54 years,0,0,0
Cavan Town,2018,55 - 59 years,0,0,0
Cavan Town,2018,60 - 64 years,2,2,4
Cavan Town,2018,65 - 69 years,2,3,5
Cavan Town,2018,70 - 74 years,2,3,5
Cavan Town,2018,75 - 79 years,1,5,6
Cavan Town,2018,80 - 84 years,5,1,6
Cavan Town,2018,85 years and over,7,6,13
Cavan Town,2018,Under 1 year,0,1,1
Cavan Town,2019,1 - 4 years,0,0,0
Cavan Town,2019,10 - 14 years,0,0,0
Cavan Town,2019,15 - 19 years,0,0,0
Cavan Town,2019,20 - 24 years,0,0,0
Cavan Town,2019,25 - 29 years,0,0,0
Cavan Town,2019,30 - 34 years,0,1,1
Cavan Town,2019,35 - 39 years,0,0,0
Cavan Town,2019,40 - 44 years,0,0,0
Cavan Town,2019,45 - 49 years,0,1,1
Cavan Town,2019,5 - 9 years,0,0,0
Cavan Town,2019,50 - 54 years,0,0,0
Cavan Town,2019,55 - 59 years,0,0,0
Cavan Town,2019,60 - 64 years,2,2,4
Cavan Town,2019,65 - 69 years,2,3,5
Cavan Town,2019,70 - 74 years,2,3,5
Cavan Town,2019,75 - 79 years,1,5,6
Cavan Town,2019,80 - 84 years,5,1,6
Cavan Town,2019,85 years and over,7,6,13
Cavan Town,2019,Under 1 year,0,1,1
Cavan Town,2020,1 - 4 years,0,0,0
Cavan Town,2020,10 - 14 years,0,0,0
Cavan Town,2020,15 - 19 years,0,0,0
Cavan Town,2020,20 - 24 years,0,0,0
Cavan Town,2020,25 - 29 years,0,0,0
Cavan Town,2020,30 - 34 years,0,1,1
Cavan Town,2020,35 - 39 years,0,0,0
Cavan Town,2020,40 - 44 years,0,0,0
Cavan Town,2020,45 - 49 years,0,1,1
Cavan Town,2020,5 - 9 years,0,0,0
Cavan Town,2020,50 - 54 years,0,0,0
Cavan Town,2020,55 - 59 years,0,0,0
Cavan Town,2020,60 - 64 years,2,2,4
Cavan Town,2020,65 - 69 years,2,3,5
Cavan Town,2020,70 - 74 years,2,3,5
Cavan Town,2020,75 - 79 years,1,5,6
Cavan Town,2020,80 - 84 years,5,1,6
Cavan Town,2020,85 years and over,7,6,13
Cavan Town,2020,Under 1 year,0,1,1
Clare,2007,1 - 4 years,0,1,1
Clare,2007,10 - 14 years,0,0,0
Clare,2007,15 - 19 years,1,6,7
Clare,2007,20 - 24 years,3,5,8
Clare,2007,25 - 29 years,0,6,6
Clare,2007,30 - 34 years,2,6,8
Clare,2007,35 - 39 years,3,3,6
Clare,2007,40 - 44 years,1,6,7
Clare,2007,45 - 49 years,9,8,17
Clare,2007,5 - 9 years,0,0,0
Clare,2007,50 - 54 years,4,15,19
Clare,2007,55 - 59 years,8,27,35
Clare,2007,60 - 64 years,22,33,55
Clare,2007,65 - 69 years,16,35,51
Clare,2007,70 - 74 years,22,40,62
Clare,2007,75 - 79 years,51,63,114
Clare,2007,80 - 84 years,76,58,134
Clare,2007,85 years and over,141,80,221
Clare,2007,Under 1 year,4,4,8
Clare,2008,1 - 4 years,0,2,2
Clare,2008,10 - 14 years,0,1,1
Clare,2008,15 - 19 years,5,3,8
Clare,2008,20 - 24 years,3,9,12
Clare,2008,25 - 29 years,2,3,5
Clare,2008,30 - 34 years,2,5,7
Clare,2008,35 - 39 years,5,6,11
Clare,2008,40 - 44 years,2,8,10
Clare,2008,45 - 49 years,6,10,16
Clare,2008,5 - 9 years,0,1,1
Clare,2008,50 - 54 years,14,7,21
Clare,2008,55 - 59 years,12,26,38
Clare,2008,60 - 64 years,22,28,50
Clare,2008,65 - 69 years,23,36,59
Clare,2008,70 - 74 years,29,62,91
Clare,2008,75 - 79 years,41,71,112
Clare,2008,80 - 84 years,64,53,117
Clare,2008,85 years and over,147,98,245
Clare,2008,Under 1 year,3,8,11
Clare,2009,1 - 4 years,0,1,1
Clare,2009,10 - 14 years,0,1,1
Clare,2009,15 - 19 years,1,1,2
Clare,2009,20 - 24 years,1,3,4
Clare,2009,25 - 29 years,2,5,7
Clare,2009,30 - 34 years,2,7,9
Clare,2009,35 - 39 years,2,7,9
Clare,2009,40 - 44 years,4,10,14
Clare,2009,45 - 49 years,10,9,19
Clare,2009,5 - 9 years,0,1,1
Clare,2009,50 - 54 years,11,13,24
Clare,2009,55 - 59 years,10,20,30
Clare,2009,60 - 64 years,18,34,52
Clare,2009,65 - 69 years,22,35,57
Clare,2009,70 - 74 years,28,59,87
Clare,2009,75 - 79 years,39,55,94
Clare,2009,80 - 84 years,68,73,141
Clare,2009,85 years and over,149,86,235
Clare,2009,Under 1 year,4,6,10
Clare,2010,1 - 4 years,0,1,1
Clare,2010,10 - 14 years,0,1,1
Clare,2010,15 - 19 years,2,1,3
Clare,2010,20 - 24 years,1,5,6
Clare,2010,25 - 29 years,2,7,9
Clare,2010,30 - 34 years,2,7,9
Clare,2010,35 - 39 years,7,5,12
Clare,2010,40 - 44 years,5,4,9
Clare,2010,45 - 49 years,6,9,15
Clare,2010,5 - 9 years,0,1,1
Clare,2010,50 - 54 years,8,9,17
Clare,2010,55 - 59 years,8,11,19
Clare,2010,60 - 64 years,24,33,57
Clare,2010,65 - 69 years,17,36,53
Clare,2010,70 - 74 years,24,42,66
Clare,2010,75 - 79 years,37,70,107
Clare,2010,80 - 84 years,63,58,121
Clare,2010,85 years and over,157,96,253
Clare,2010,Under 1 year,4,5,9
Clare,2011,1 - 4 years,0,0,0
Clare,2011,10 - 14 years,0,1,1
Clare,2011,15 - 19 years,0,1,1
Clare,2011,20 - 24 years,3,1,4
Clare,2011,25 - 29 years,1,2,3
Clare,2011,30 - 34 years,2,3,5
Clare,2011,35 - 39 years,1,1,2
Clare,2011,40 - 44 years,2,7,9
Clare,2011,45 - 49 years,7,6,13
Clare,2011,5 - 9 years,0,1,1
Clare,2011,50 - 54 years,6,16,22
Clare,2011,55 - 59 years,14,10,24
Clare,2011,60 - 64 years,21,38,59
Clare,2011,65 - 69 years,20,32,52
Clare,2011,70 - 74 years,29,49,78
Clare,2011,75 - 79 years,40,58,98
Clare,2011,80 - 84 years,56,58,114
Clare,2011,85 years and over,149,82,231
Clare,2011,Under 1 year,6,2,8
Clare,2012,1 - 4 years,0,0,0
Clare,2012,10 - 14 years,0,1,1
Clare,2012,15 - 19 years,0,2,2
Clare,2012,20 - 24 years,3,4,7
Clare,2012,25 - 29 years,3,2,5
Clare,2012,30 - 34 years,2,4,6
Clare,2012,35 - 39 years,1,3,4
Clare,2012,40 - 44 years,6,6,12
Clare,2012,45 - 49 years,4,7,11
Clare,2012,5 - 9 years,0,1,1
Clare,2012,50 - 54 years,5,21,26
Clare,2012,55 - 59 years,6,15,21
Clare,2012,60 - 64 years,14,34,48
Clare,2012,65 - 69 years,21,35,56
Clare,2012,70 - 74 years,34,49,83
Clare,2012,75 - 79 years,29,54,83
Clare,2012,80 - 84 years,51,55,106
Clare,2012,85 years and over,144,116,260
Clare,2012,Under 1 year,2,3,5
Clare,2013,1 - 4 years,0,0,0
Clare,2013,10 - 14 years,0,0,0
Clare,2013,15 - 19 years,0,3,3
Clare,2013,20 - 24 years,0,3,3
Clare,2013,25 - 29 years,0,3,3
Clare,2013,30 - 34 years,1,3,4
Clare,2013,35 - 39 years,1,5,6
Clare,2013,40 - 44 years,6,7,13
Clare,2013,45 - 49 years,6,10,16
Clare,2013,5 - 9 years,1,1,2
Clare,2013,50 - 54 years,12,11,23
Clare,2013,55 - 59 years,11,18,29
Clare,2013,60 - 64 years,21,29,50
Clare,2013,65 - 69 years,22,56,78
Clare,2013,70 - 74 years,29,55,84
Clare,2013,75 - 79 years,37,45,82
Clare,2013,80 - 84 years,59,68,127
Clare,2013,85 years and over,148,115,263
Clare,2013,Under 1 year,6,0,6
Clare,2014,1 - 4 years,0,0,0
Clare,2014,10 - 14 years,1,0,1
Clare,2014,15 - 19 years,0,2,2
Clare,2014,20 - 24 years,0,2,2
Clare,2014,25 - 29 years,1,4,5
Clare,2014,30 - 34 years,1,3,4
Clare,2014,35 - 39 years,1,5,6
Clare,2014,40 - 44 years,4,4,8
Clare,2014,45 - 49 years,3,8,11
Clare,2014,5 - 9 years,1,1,2
Clare,2014,50 - 54 years,7,12,19
Clare,2014,55 - 59 years,13,28,41
Clare,2014,60 - 64 years,11,35,46
Clare,2014,65 - 69 years,32,44,76
Clare,2014,70 - 74 years,41,54,95
Clare,2014,75 - 79 years,40,58,98
Clare,2014,80 - 84 years,62,66,128
Clare,2014,85 years and over,161,116,277
Clare,2014,Under 1 year,6,6,12
Clare,2015,1 - 4 years,0,0,0
Clare,2015,10 - 14 years,1,0,1
Clare,2015,15 - 19 years,0,2,2
Clare,2015,20 - 24 years,3,3,6
Clare,2015,25 - 29 years,1,5,6
Clare,2015,30 - 34 years,1,2,3
Clare,2015,35 - 39 years,1,5,6
Clare,2015,40 - 44 years,4,10,14
Clare,2015,45 - 49 years,7,12,19
Clare,2015,5 - 9 years,1,1,2
Clare,2015,50 - 54 years,9,15,24
Clare,2015,55 - 59 years,8,21,29
Clare,2015,60 - 64 years,22,27,49
Clare,2015,65 - 69 years,24,42,66
Clare,2015,70 - 74 years,33,58,91
Clare,2015,75 - 79 years,40,62,102
Clare,2015,80 - 84 years,54,78,132
Clare,2015,85 years and over,188,117,305
Clare,2015,Under 1 year,3,5,8
Clare,2016,1 - 4 years,1,1,2
Clare,2016,10 - 14 years,1,0,1
Clare,2016,15 - 19 years,2,1,3
Clare,2016,20 - 24 years,3,1,4
Clare,2016,25 - 29 years,1,3,4
Clare,2016,30 - 34 years,1,3,4
Clare,2016,35 - 39 years,2,2,4
Clare,2016,40 - 44 years,4,7,11
Clare,2016,45 - 49 years,3,7,10
Clare,2016,5 - 9 years,1,1,2
Clare,2016,50 - 54 years,13,3,16
Clare,2016,55 - 59 years,10,18,28
Clare,2016,60 - 64 years,17,24,41
Clare,2016,65 - 69 years,28,46,74
Clare,2016,70 - 74 years,24,51,75
Clare,2016,75 - 79 years,51,62,113
Clare,2016,80 - 84 years,62,92,154
Clare,2016,85 years and over,217,112,329
Clare,2016,Under 1 year,5,1,6
Clare,2017,1 - 4 years,1,2,3
Clare,2017,10 - 14 years,1,1,2
Clare,2017,15 - 19 years,2,4,6
Clare,2017,20 - 24 years,2,2,4
Clare,2017,25 - 29 years,2,3,5
Clare,2017,30 - 34 years,1,4,5
Clare,2017,35 - 39 years,2,5,7
Clare,2017,40 - 44 years,5,6,11
Clare,2017,45 - 49 years,1,10,11
Clare,2017,5 - 9 years,1,1,2
Clare,2017,50 - 54 years,8,10,18
Clare,2017,55 - 59 years,10,22,32
Clare,2017,60 - 64 years,13,22,35
Clare,2017,65 - 69 years,31,39,70
Clare,2017,70 - 74 years,38,57,95
Clare,2017,75 - 79 years,48,54,102
Clare,2017,80 - 84 years,56,60,116
Clare,2017,85 years and over,175,98,273
Clare,2017,Under 1 year,3,1,4
Clare,2018,1 - 4 years,0,0,0
Clare,2018,10 - 14 years,0,1,1
Clare,2018,15 - 19 years,1,4,5
Clare,2018,20 - 24 years,0,2,2
Clare,2018,25 - 29 years,0,4,4
Clare,2018,30 - 34 years,1,6,7
Clare,2018,35 - 39 years,0,5,5
Clare,2018,40 - 44 years,4,3,7
Clare,2018,45 - 49 years,7,12,19
Clare,2018,5 - 9 years,0,0,0
Clare,2018,50 - 54 years,5,9,14
Clare,2018,55 - 59 years,15,13,28
Clare,2018,60 - 64 years,26,27,53
Clare,2018,65 - 69 years,24,38,62
Clare,2018,70 - 74 years,39,57,96
Clare,2018,75 - 79 years,50,65,115
Clare,2018,80 - 84 years,71,68,139
Clare,2018,85 years and over,178,116,294
Clare,2018,Under 1 year,3,4,7
Clare,2019,1 - 4 years,0,0,0
Clare,2019,10 - 14 years,1,1,2
Clare,2019,15 - 19 years,1,3,4
Clare,2019,20 - 24 years,1,2,3
Clare,2019,25 - 29 years,1,3,4
Clare,2019,30 - 34 years,0,4,4
Clare,2019,35 - 39 years,3,3,6
Clare,2019,40 - 44 years,3,4,7
Clare,2019,45 - 49 years,5,7,12
Clare,2019,5 - 9 years,0,1,1
Clare,2019,50 - 54 years,5,14,19
Clare,2019,55 - 59 years,14,25,39
Clare,2019,60 - 64 years,24,28,52
Clare,2019,65 - 69 years,32,35,67
Clare,2019,70 - 74 years,38,52,90
Clare,2019,75 - 79 years,27,61,88
Clare,2019,80 - 84 years,61,56,117
Clare,2019,85 years and over,142,127,269
Clare,2019,Under 1 year,1,3,4
Clare,2020,1 - 4 years,0,1,1
Clare,2020,10 - 14 years,1,1,2
Clare,2020,15 - 19 years,1,3,4
Clare,2020,20 - 24 years,1,2,3
Clare,2020,25 - 29 years,1,4,5
Clare,2020,30 - 34 years,0,4,4
Clare,2020,35 - 39 years,3,4,7
Clare,2020,40 - 44 years,4,9,13
Clare,2020,45 - 49 years,5,7,12
Clare,2020,5 - 9 years,1,1,2
Clare,2020,50 - 54 years,8,15,23
Clare,2020,55 - 59 years,9,20,29
Clare,2020,60 - 64 years,19,28,47
Clare,2020,65 - 69 years,32,39,71
Clare,2020,70 - 74 years,41,64,105
Clare,2020,75 - 79 years,47,44,91
Clare,2020,80 - 84 years,62,70,132
Clare,2020,85 years and over,157,100,257
Clare,2020,Under 1 year,1,3,4
Clonakilty Town,2007,1 - 4 years,0,0,0
Clonakilty Town,2007,10 - 14 years,0,0,0
Clonakilty Town,2007,15 - 19 years,0,1,1
Clonakilty Town,2007,20 - 24 years,0,1,1
Clonakilty Town,2007,25 - 29 years,0,0,0
Clonakilty Town,2007,30 - 34 years,1,1,2
Clonakilty Town,2007,35 - 39 years,0,0,0
Clonakilty Town,2007,40 - 44 years,1,0,1
Clonakilty Town,2007,45 - 49 years,0,2,2
Clonakilty Town,2007,5 - 9 years,0,0,0
Clonakilty Town,2007,50 - 54 years,0,0,0
Clonakilty Town,2007,55 - 59 years,1,1,2
Clonakilty Town,2007,60 - 64 years,0,0,0
Clonakilty Town,2007,65 - 69 years,0,2,2
Clonakilty Town,2007,70 - 74 years,4,3,7
Clonakilty Town,2007,75 - 79 years,6,4,10
Clonakilty Town,2007,80 - 84 years,5,3,8
Clonakilty Town,2007,85 years and over,11,2,13
Clonakilty Town,2007,Under 1 year,0,0,0
Clonakilty Town,2008,1 - 4 years,0,1,1
Clonakilty Town,2008,10 - 14 years,0,0,0
Clonakilty Town,2008,15 - 19 years,0,1,1
Clonakilty Town,2008,20 - 24 years,0,1,1
Clonakilty Town,2008,25 - 29 years,0,1,1
Clonakilty Town,2008,30 - 34 years,1,2,3
Clonakilty Town,2008,35 - 39 years,0,2,2
Clonakilty Town,2008,40 - 44 years,1,0,1
Clonakilty Town,2008,45 - 49 years,0,2,2
Clonakilty Town,2008,5 - 9 years,0,0,0
Clonakilty Town,2008,50 - 54 years,0,1,1
Clonakilty Town,2008,55 - 59 years,1,2,3
Clonakilty Town,2008,60 - 64 years,1,2,3
Clonakilty Town,2008,65 - 69 years,1,3,4
Clonakilty Town,2008,70 - 74 years,2,1,3
Clonakilty Town,2008,75 - 79 years,6,5,11
Clonakilty Town,2008,80 - 84 years,8,3,11
Clonakilty Town,2008,85 years and over,10,14,24
Clonakilty Town,2008,Under 1 year,1,0,1
Clonakilty Town,2009,1 - 4 years,0,1,1
Clonakilty Town,2009,10 - 14 years,0,0,0
Clonakilty Town,2009,15 - 19 years,0,1,1
Clonakilty Town,2009,20 - 24 years,0,1,1
Clonakilty Town,2009,25 - 29 years,0,1,1
Clonakilty Town,2009,30 - 34 years,1,2,3
Clonakilty Town,2009,35 - 39 years,0,2,2
Clonakilty Town,2009,40 - 44 years,1,0,1
Clonakilty Town,2009,45 - 49 years,0,2,2
Clonakilty Town,2009,5 - 9 years,0,0,0
Clonakilty Town,2009,50 - 54 years,1,1,2
Clonakilty Town,2009,55 - 59 years,1,2,3
Clonakilty Town,2009,60 - 64 years,1,2,3
Clonakilty Town,2009,65 - 69 years,1,2,3
Clonakilty Town,2009,70 - 74 years,2,2,4
Clonakilty Town,2009,75 - 79 years,3,3,6
Clonakilty Town,2009,80 - 84 years,3,1,4
Clonakilty Town,2009,85 years and over,3,2,5
Clonakilty Town,2009,Under 1 year,1,0,1
Clonakilty Town,2010,1 - 4 years,0,1,1
Clonakilty Town,2010,10 - 14 years,0,0,0
Clonakilty Town,2010,15 - 19 years,0,1,1
Clonakilty Town,2010,20 - 24 years,0,1,1
Clonakilty Town,2010,25 - 29 years,0,1,1
Clonakilty Town,2010,30 - 34 years,1,2,3
Clonakilty Town,2010,35 - 39 years,1,2,3
Clonakilty Town,2010,40 - 44 years,1,0,1
Clonakilty Town,2010,45 - 49 years,0,2,2
Clonakilty Town,2010,5 - 9 years,0,0,0
Clonakilty Town,2010,50 - 54 years,1,1,2
Clonakilty Town,2010,55 - 59 years,1,2,3
Clonakilty Town,2010,60 - 64 years,1,2,3
Clonakilty Town,2010,65 - 69 years,1,2,3
Clonakilty Town,2010,70 - 74 years,2,2,4
Clonakilty Town,2010,75 - 79 years,3,1,4
Clonakilty Town,2010,80 - 84 years,2,1,3
Clonakilty Town,2010,85 years and over,5,1,6
Clonakilty Town,2010,Under 1 year,1,0,1
Clonakilty Town,2011,1 - 4 years,0,0,0
Clonakilty Town,2011,10 - 14 years,0,0,0
Clonakilty Town,2011,15 - 19 years,0,0,0
Clonakilty Town,2011,20 - 24 years,0,0,0
Clonakilty Town,2011,25 - 29 years,0,0,0
Clonakilty Town,2011,30 - 34 years,0,1,1
Clonakilty Town,2011,35 - 39 years,0,0,0
Clonakilty Town,2011,40 - 44 years,0,0,0
Clonakilty Town,2011,45 - 49 years,0,0,0
Clonakilty Town,2011,5 - 9 years,0,0,0
Clonakilty Town,2011,50 - 54 years,0,0,0
Clonakilty Town,2011,55 - 59 years,1,0,1
Clonakilty Town,2011,60 - 64 years,1,2,3
Clonakilty Town,2011,65 - 69 years,0,2,2
Clonakilty Town,2011,70 - 74 years,1,2,3
Clonakilty Town,2011,75 - 79 years,1,5,6
Clonakilty Town,2011,80 - 84 years,2,3,5
Clonakilty Town,2011,85 years and over,9,7,16
Clonakilty Town,2011,Under 1 year,0,0,0
Clonakilty Town,2012,1 - 4 years,0,0,0
Clonakilty Town,2012,10 - 14 years,0,0,0
Clonakilty Town,2012,15 - 19 years,0,0,0
Clonakilty Town,2012,20 - 24 years,0,1,1
Clonakilty Town,2012,25 - 29 years,0,0,0
Clonakilty Town,2012,30 - 34 years,0,1,1
Clonakilty Town,2012,35 - 39 years,0,0,0
Clonakilty Town,2012,40 - 44 years,0,2,2
Clonakilty Town,2012,45 - 49 years,1,2,3
Clonakilty Town,2012,5 - 9 years,0,0,0
Clonakilty Town,2012,50 - 54 years,0,3,3
Clonakilty Town,2012,55 - 59 years,1,0,1
Clonakilty Town,2012,60 - 64 years,1,3,4
Clonakilty Town,2012,65 - 69 years,1,2,3
Clonakilty Town,2012,70 - 74 years,1,4,5
Clonakilty Town,2012,75 - 79 years,1,4,5
Clonakilty Town,2012,80 - 84 years,2,5,7
Clonakilty Town,2012,85 years and over,10,11,21
Clonakilty Town,2012,Under 1 year,0,0,0
Clonakilty Town,2013,1 - 4 years,0,0,0
Clonakilty Town,2013,10 - 14 years,0,0,0
Clonakilty Town,2013,15 - 19 years,0,0,0
Clonakilty Town,2013,20 - 24 years,0,1,1
Clonakilty Town,2013,25 - 29 years,0,0,0
Clonakilty Town,2013,30 - 34 years,0,0,0
Clonakilty Town,2013,35 - 39 years,0,0,0
Clonakilty Town,2013,40 - 44 years,0,2,2
Clonakilty Town,2013,45 - 49 years,0,0,0
Clonakilty Town,2013,5 - 9 years,0,0,0
Clonakilty Town,2013,50 - 54 years,0,1,1
Clonakilty Town,2013,55 - 59 years,1,2,3
Clonakilty Town,2013,60 - 64 years,0,1,1
Clonakilty Town,2013,65 - 69 years,1,0,1
Clonakilty Town,2013,70 - 74 years,3,1,4
Clonakilty Town,2013,75 - 79 years,2,3,5
Clonakilty Town,2013,80 - 84 years,6,5,11
Clonakilty Town,2013,85 years and over,14,5,19
Clonakilty Town,2013,Under 1 year,0,0,0
Clonakilty Town,2014,1 - 4 years,0,0,0
Clonakilty Town,2014,10 - 14 years,0,0,0
Clonakilty Town,2014,15 - 19 years,0,0,0
Clonakilty Town,2014,20 - 24 years,0,1,1
Clonakilty Town,2014,25 - 29 years,0,0,0
Clonakilty Town,2014,30 - 34 years,0,0,0
Clonakilty Town,2014,35 - 39 years,0,0,0
Clonakilty Town,2014,40 - 44 years,0,2,2
Clonakilty Town,2014,45 - 49 years,1,0,1
Clonakilty Town,2014,5 - 9 years,0,0,0
Clonakilty Town,2014,50 - 54 years,0,1,1
Clonakilty Town,2014,55 - 59 years,1,1,2
Clonakilty Town,2014,60 - 64 years,0,2,2
Clonakilty Town,2014,65 - 69 years,1,2,3
Clonakilty Town,2014,70 - 74 years,2,6,8
Clonakilty Town,2014,75 - 79 years,1,3,4
Clonakilty Town,2014,80 - 84 years,3,6,9
Clonakilty Town,2014,85 years and over,7,2,9
Clonakilty Town,2014,Under 1 year,0,0,0
Clonakilty Town,2015,1 - 4 years,0,0,0
Clonakilty Town,2015,10 - 14 years,0,0,0
Clonakilty Town,2015,15 - 19 years,0,0,0
Clonakilty Town,2015,20 - 24 years,0,1,1
Clonakilty Town,2015,25 - 29 years,0,0,0
Clonakilty Town,2015,30 - 34 years,0,0,0
Clonakilty Town,2015,35 - 39 years,0,0,0
Clonakilty Town,2015,40 - 44 years,0,2,2
Clonakilty Town,2015,45 - 49 years,1,0,1
Clonakilty Town,2015,5 - 9 years,0,0,0
Clonakilty Town,2015,50 - 54 years,0,1,1
Clonakilty Town,2015,55 - 59 years,1,1,2
Clonakilty Town,2015,60 - 64 years,0,2,2
Clonakilty Town,2015,65 - 69 years,1,2,3
Clonakilty Town,2015,70 - 74 years,2,6,8
Clonakilty Town,2015,75 - 79 years,1,3,4
Clonakilty Town,2015,80 - 84 years,3,6,9
Clonakilty Town,2015,85 years and over,7,2,9
Clonakilty Town,2015,Under 1 year,0,0,0
Clonakilty Town,2016,1 - 4 years,0,0,0
Clonakilty Town,2016,10 - 14 years,0,0,0
Clonakilty Town,2016,15 - 19 years,0,0,0
Clonakilty Town,2016,20 - 24 years,0,1,1
Clonakilty Town,2016,25 - 29 years,0,0,0
Clonakilty Town,2016,30 - 34 years,0,0,0
Clonakilty Town,2016,35 - 39 years,0,0,0
Clonakilty Town,2016,40 - 44 years,0,2,2
Clonakilty Town,2016,45 - 49 years,1,0,1
Clonakilty Town,2016,5 - 9 years,0,0,0
Clonakilty Town,2016,50 - 54 years,0,1,1
Clonakilty Town,2016,55 - 59 years,1,1,2
Clonakilty Town,2016,60 - 64 years,0,2,2
Clonakilty Town,2016,65 - 69 years,1,2,3
Clonakilty Town,2016,70 - 74 years,2,6,8
Clonakilty Town,2016,75 - 79 years,1,3,4
Clonakilty Town,2016,80 - 84 years,3,6,9
Clonakilty Town,2016,85 years and over,7,2,9
Clonakilty Town,2016,Under 1 year,0,0,0
Clonakilty Town,2017,1 - 4 years,0,0,0
Clonakilty Town,2017,10 - 14 years,0,0,0
Clonakilty Town,2017,15 - 19 years,0,0,0
Clonakilty Town,2017,20 - 24 years,0,1,1
Clonakilty Town,2017,25 - 29 years,0,0,0
Clonakilty Town,2017,30 - 34 years,0,0,0
Clonakilty Town,2017,35 - 39 years,0,0,0
Clonakilty Town,2017,40 - 44 years,0,1,1
Clonakilty Town,2017,45 - 49 years,1,0,1
Clonakilty Town,2017,5 - 9 years,0,0,0
Clonakilty Town,2017,50 - 54 years,0,1,1
Clonakilty Town,2017,55 - 59 years,1,2,3
Clonakilty Town,2017,60 - 64 years,1,1,2
Clonakilty Town,2017,65 - 69 years,1,2,3
Clonakilty Town,2017,70 - 74 years,1,3,4
Clonakilty Town,2017,75 - 79 years,4,4,8
Clonakilty Town,2017,80 - 84 years,2,1,3
Clonakilty Town,2017,85 years and over,13,3,16
Clonakilty Town,2017,Under 1 year,0,0,0
Clonakilty Town,2018,1 - 4 years,0,0,0
Clonakilty Town,2018,10 - 14 years,0,0,0
Clonakilty Town,2018,15 - 19 years,0,0,0
Clonakilty Town,2018,20 - 24 years,0,0,0
Clonakilty Town,2018,25 - 29 years,0,0,0
Clonakilty Town,2018,30 - 34 years,1,0,1
Clonakilty Town,2018,35 - 39 years,0,0,0
Clonakilty Town,2018,40 - 44 years,0,1,1
Clonakilty Town,2018,45 - 49 years,1,2,3
Clonakilty Town,2018,5 - 9 years,0,0,0
Clonakilty Town,2018,50 - 54 years,0,1,1
Clonakilty Town,2018,55 - 59 years,2,2,4
Clonakilty Town,2018,60 - 64 years,1,0,1
Clonakilty Town,2018,65 - 69 years,0,2,2
Clonakilty Town,2018,70 - 74 years,3,2,5
Clonakilty Town,2018,75 - 79 years,0,3,3
Clonakilty Town,2018,80 - 84 years,4,1,5
Clonakilty Town,2018,85 years and over,10,8,18
Clonakilty Town,2018,Under 1 year,0,0,0
Clonakilty Town,2019,1 - 4 years,0,0,0
Clonakilty Town,2019,10 - 14 years,0,0,0
Clonakilty Town,2019,15 - 19 years,0,0,0
Clonakilty Town,2019,20 - 24 years,0,0,0
Clonakilty Town,2019,25 - 29 years,0,0,0
Clonakilty Town,2019,30 - 34 years,1,0,1
Clonakilty Town,2019,35 - 39 years,0,0,0
Clonakilty Town,2019,40 - 44 years,0,1,1
Clonakilty Town,2019,45 - 49 years,1,2,3
Clonakilty Town,2019,5 - 9 years,0,0,0
Clonakilty Town,2019,50 - 54 years,0,1,1
Clonakilty Town,2019,55 - 59 years,2,2,4
Clonakilty Town,2019,60 - 64 years,1,0,1
Clonakilty Town,2019,65 - 69 years,0,2,2
Clonakilty Town,2019,70 - 74 years,3,2,5
Clonakilty Town,2019,75 - 79 years,0,3,3
Clonakilty Town,2019,80 - 84 years,4,1,5
Clonakilty Town,2019,85 years and over,10,8,18
Clonakilty Town,2019,Under 1 year,0,0,0
Clonakilty Town,2020,1 - 4 years,0,0,0
Clonakilty Town,2020,10 - 14 years,0,0,0
Clonakilty Town,2020,15 - 19 years,0,0,0
Clonakilty Town,2020,20 - 24 years,0,0,0
Clonakilty Town,2020,25 - 29 years,0,0,0
Clonakilty Town,2020,30 - 34 years,1,0,1
Clonakilty Town,2020,35 - 39 years,0,0,0
Clonakilty Town,2020,40 - 44 years,0,1,1
Clonakilty Town,2020,45 - 49 years,1,2,3
Clonakilty Town,2020,5 - 9 years,0,0,0
Clonakilty Town,2020,50 - 54 years,0,1,1
Clonakilty Town,2020,55 - 59 years,2,2,4
Clonakilty Town,2020,60 - 64 years,1,0,1
Clonakilty Town,2020,65 - 69 years,0,2,2
Clonakilty Town,2020,70 - 74 years,3,2,5
Clonakilty Town,2020,75 - 79 years,0,3,3
Clonakilty Town,2020,80 - 84 years,4,1,5
Clonakilty Town,2020,85 years and over,10,8,18
Clonakilty Town,2020,Under 1 year,0,0,0
Clones Town,2007,1 - 4 years,0,0,0
Clones Town,2007,10 - 14 years,0,0,0
Clones Town,2007,15 - 19 years,0,0,0
Clones Town,2007,20 - 24 years,0,0,0
Clones Town,2007,25 - 29 years,0,0,0
Clones Town,2007,30 - 34 years,0,1,1
Clones Town,2007,35 - 39 years,0,0,0
Clones Town,2007,40 - 44 years,0,0,0
Clones Town,2007,45 - 49 years,0,0,0
Clones Town,2007,5 - 9 years,0,0,0
Clones Town,2007,50 - 54 years,0,0,0
Clones Town,2007,55 - 59 years,0,0,0
Clones Town,2007,60 - 64 years,1,0,1
Clones Town,2007,65 - 69 years,0,0,0
Clones Town,2007,70 - 74 years,2,0,2
Clones Town,2007,75 - 79 years,5,3,8
Clones Town,2007,80 - 84 years,1,5,6
Clones Town,2007,85 years and over,1,2,3
Clones Town,2007,Under 1 year,0,0,0
Clones Town,2008,1 - 4 years,0,0,0
Clones Town,2008,10 - 14 years,0,0,0
Clones Town,2008,15 - 19 years,0,0,0
Clones Town,2008,20 - 24 years,0,0,0
Clones Town,2008,25 - 29 years,0,0,0
Clones Town,2008,30 - 34 years,0,1,1
Clones Town,2008,35 - 39 years,0,0,0
Clones Town,2008,40 - 44 years,1,0,1
Clones Town,2008,45 - 49 years,0,0,0
Clones Town,2008,5 - 9 years,0,0,0
Clones Town,2008,50 - 54 years,1,1,2
Clones Town,2008,55 - 59 years,1,1,2
Clones Town,2008,60 - 64 years,1,0,1
Clones Town,2008,65 - 69 years,2,1,3
Clones Town,2008,70 - 74 years,1,0,1
Clones Town,2008,75 - 79 years,1,3,4
Clones Town,2008,80 - 84 years,1,5,6
Clones Town,2008,85 years and over,4,2,6
Clones Town,2008,Under 1 year,0,0,0
Clones Town,2009,1 - 4 years,0,0,0
Clones Town,2009,10 - 14 years,0,0,0
Clones Town,2009,15 - 19 years,0,0,0
Clones Town,2009,20 - 24 years,0,0,0
Clones Town,2009,25 - 29 years,0,0,0
Clones Town,2009,30 - 34 years,0,1,1
Clones Town,2009,35 - 39 years,0,0,0
Clones Town,2009,40 - 44 years,1,0,1
Clones Town,2009,45 - 49 years,0,1,1
Clones Town,2009,5 - 9 years,0,0,0
Clones Town,2009,50 - 54 years,1,1,2
Clones Town,2009,55 - 59 years,1,1,2
Clones Town,2009,60 - 64 years,1,0,1
Clones Town,2009,65 - 69 years,2,1,3
Clones Town,2009,70 - 74 years,1,0,1
Clones Town,2009,75 - 79 years,1,3,4
Clones Town,2009,80 - 84 years,6,2,8
Clones Town,2009,85 years and over,5,1,6
Clones Town,2009,Under 1 year,0,0,0
Clones Town,2010,1 - 4 years,0,0,0
Clones Town,2010,10 - 14 years,0,0,0
Clones Town,2010,15 - 19 years,0,0,0
Clones Town,2010,20 - 24 years,0,0,0
Clones Town,2010,25 - 29 years,0,0,0
Clones Town,2010,30 - 34 years,0,1,1
Clones Town,2010,35 - 39 years,0,0,0
Clones Town,2010,40 - 44 years,1,0,1
Clones Town,2010,45 - 49 years,0,1,1
Clones Town,2010,5 - 9 years,0,0,0
Clones Town,2010,50 - 54 years,1,1,2
Clones Town,2010,55 - 59 years,1,2,3
Clones Town,2010,60 - 64 years,1,2,3
Clones Town,2010,65 - 69 years,2,1,3
Clones Town,2010,70 - 74 years,1,0,1
Clones Town,2010,75 - 79 years,1,2,3
Clones Town,2010,80 - 84 years,2,1,3
Clones Town,2010,85 years and over,3,1,4
Clones Town,2010,Under 1 year,0,1,1
Clones Town,2011,1 - 4 years,0,0,0
Clones Town,2011,10 - 14 years,0,0,0
Clones Town,2011,15 - 19 years,0,0,0
Clones Town,2011,20 - 24 years,0,0,0
Clones Town,2011,25 - 29 years,0,1,1
Clones Town,2011,30 - 34 years,0,0,0
Clones Town,2011,35 - 39 years,0,0,0
Clones Town,2011,40 - 44 years,0,0,0
Clones Town,2011,45 - 49 years,0,0,0
Clones Town,2011,5 - 9 years,0,0,0
Clones Town,2011,50 - 54 years,0,1,1
Clones Town,2011,55 - 59 years,0,2,2
Clones Town,2011,60 - 64 years,0,1,1
Clones Town,2011,65 - 69 years,0,0,0
Clones Town,2011,70 - 74 years,0,3,3
Clones Town,2011,75 - 79 years,1,3,4
Clones Town,2011,80 - 84 years,2,0,2
Clones Town,2011,85 years and over,3,1,4
Clones Town,2011,Under 1 year,0,0,0
Clones Town,2012,1 - 4 years,0,1,1
Clones Town,2012,10 - 14 years,0,0,0
Clones Town,2012,15 - 19 years,0,0,0
Clones Town,2012,20 - 24 years,0,1,1
Clones Town,2012,25 - 29 years,0,1,1
Clones Town,2012,30 - 34 years,0,0,0
Clones Town,2012,35 - 39 years,0,0,0
Clones Town,2012,40 - 44 years,0,0,0
Clones Town,2012,45 - 49 years,0,0,0
Clones Town,2012,5 - 9 years,0,0,0
Clones Town,2012,50 - 54 years,0,1,1
Clones Town,2012,55 - 59 years,0,2,2
Clones Town,2012,60 - 64 years,0,3,3
Clones Town,2012,65 - 69 years,0,1,1
Clones Town,2012,70 - 74 years,0,3,3
Clones Town,2012,75 - 79 years,1,3,4
Clones Town,2012,80 - 84 years,2,1,3
Clones Town,2012,85 years and over,2,2,4
Clones Town,2012,Under 1 year,0,0,0
Clones Town,2013,1 - 4 years,0,0,0
Clones Town,2013,10 - 14 years,0,0,0
Clones Town,2013,15 - 19 years,0,0,0
Clones Town,2013,20 - 24 years,0,0,0
Clones Town,2013,25 - 29 years,0,0,0
Clones Town,2013,30 - 34 years,0,0,0
Clones Town,2013,35 - 39 years,0,0,0
Clones Town,2013,40 - 44 years,0,0,0
Clones Town,2013,45 - 49 years,0,1,1
Clones Town,2013,5 - 9 years,0,0,0
Clones Town,2013,50 - 54 years,1,0,1
Clones Town,2013,55 - 59 years,0,0,0
Clones Town,2013,60 - 64 years,0,0,0
Clones Town,2013,65 - 69 years,2,1,3
Clones Town,2013,70 - 74 years,1,1,2
Clones Town,2013,75 - 79 years,3,4,7
Clones Town,2013,80 - 84 years,1,3,4
Clones Town,2013,85 years and over,5,3,8
Clones Town,2013,Under 1 year,0,0,0
Clones Town,2014,1 - 4 years,0,0,0
Clones Town,2014,10 - 14 years,0,0,0
Clones Town,2014,15 - 19 years,0,0,0
Clones Town,2014,20 - 24 years,0,0,0
Clones Town,2014,25 - 29 years,0,0,0
Clones Town,2014,30 - 34 years,0,0,0
Clones Town,2014,35 - 39 years,0,0,0
Clones Town,2014,40 - 44 years,0,1,1
Clones Town,2014,45 - 49 years,0,1,1
Clones Town,2014,5 - 9 years,0,1,1
Clones Town,2014,50 - 54 years,1,0,1
Clones Town,2014,55 - 59 years,0,0,0
Clones Town,2014,60 - 64 years,1,1,2
Clones Town,2014,65 - 69 years,2,1,3
Clones Town,2014,70 - 74 years,1,1,2
Clones Town,2014,75 - 79 years,2,3,5
Clones Town,2014,80 - 84 years,1,1,2
Clones Town,2014,85 years and over,4,4,8
Clones Town,2014,Under 1 year,0,0,0
Clones Town,2015,1 - 4 years,0,0,0
Clones Town,2015,10 - 14 years,0,0,0
Clones Town,2015,15 - 19 years,0,0,0
Clones Town,2015,20 - 24 years,0,0,0
Clones Town,2015,25 - 29 years,0,0,0
Clones Town,2015,30 - 34 years,0,0,0
Clones Town,2015,35 - 39 years,0,0,0
Clones Town,2015,40 - 44 years,0,1,1
Clones Town,2015,45 - 49 years,0,1,1
Clones Town,2015,5 - 9 years,0,1,1
Clones Town,2015,50 - 54 years,1,0,1
Clones Town,2015,55 - 59 years,0,0,0
Clones Town,2015,60 - 64 years,1,1,2
Clones Town,2015,65 - 69 years,2,1,3
Clones Town,2015,70 - 74 years,1,1,2
Clones Town,2015,75 - 79 years,2,3,5
Clones Town,2015,80 - 84 years,1,1,2
Clones Town,2015,85 years and over,4,4,8
Clones Town,2015,Under 1 year,0,0,0
Clones Town,2016,1 - 4 years,0,0,0
Clones Town,2016,10 - 14 years,0,0,0
Clones Town,2016,15 - 19 years,0,0,0
Clones Town,2016,20 - 24 years,0,0,0
Clones Town,2016,25 - 29 years,0,0,0
Clones Town,2016,30 - 34 years,0,0,0
Clones Town,2016,35 - 39 years,0,0,0
Clones Town,2016,40 - 44 years,0,1,1
Clones Town,2016,45 - 49 years,0,1,1
Clones Town,2016,5 - 9 years,0,1,1
Clones Town,2016,50 - 54 years,1,0,1
Clones Town,2016,55 - 59 years,0,0,0
Clones Town,2016,60 - 64 years,1,1,2
Clones Town,2016,65 - 69 years,2,1,3
Clones Town,2016,70 - 74 years,1,1,2
Clones Town,2016,75 - 79 years,2,3,5
Clones Town,2016,80 - 84 years,1,1,2
Clones Town,2016,85 years and over,4,4,8
Clones Town,2016,Under 1 year,0,0,0
Clones Town,2017,1 - 4 years,0,0,0
Clones Town,2017,10 - 14 years,0,0,0
Clones Town,2017,15 - 19 years,0,0,0
Clones Town,2017,20 - 24 years,0,0,0
Clones Town,2017,25 - 29 years,0,0,0
Clones Town,2017,30 - 34 years,0,0,0
Clones Town,2017,35 - 39 years,0,0,0
Clones Town,2017,40 - 44 years,0,1,1
Clones Town,2017,45 - 49 years,0,1,1
Clones Town,2017,5 - 9 years,0,1,1
Clones Town,2017,50 - 54 years,1,0,1
Clones Town,2017,55 - 59 years,0,1,1
Clones Town,2017,60 - 64 years,1,1,2
Clones Town,2017,65 - 69 years,1,1,2
Clones Town,2017,70 - 74 years,1,1,2
Clones Town,2017,75 - 79 years,1,3,4
Clones Town,2017,80 - 84 years,1,2,3
Clones Town,2017,85 years and over,3,2,5
Clones Town,2017,Under 1 year,0,1,1
Clones Town,2018,1 - 4 years,0,0,0
Clones Town,2018,10 - 14 years,0,0,0
Clones Town,2018,15 - 19 years,0,0,0
Clones Town,2018,20 - 24 years,0,0,0
Clones Town,2018,25 - 29 years,0,0,0
Clones Town,2018,30 - 34 years,0,0,0
Clones Town,2018,35 - 39 years,0,0,0
Clones Town,2018,40 - 44 years,0,0,0
Clones Town,2018,45 - 49 years,0,0,0
Clones Town,2018,5 - 9 years,0,0,0
Clones Town,2018,50 - 54 years,0,1,1
Clones Town,2018,55 - 59 years,1,1,2
Clones Town,2018,60 - 64 years,1,1,2
Clones Town,2018,65 - 69 years,1,0,1
Clones Town,2018,70 - 74 years,1,2,3
Clones Town,2018,75 - 79 years,0,1,1
Clones Town,2018,80 - 84 years,1,2,3
Clones Town,2018,85 years and over,3,2,5
Clones Town,2018,Under 1 year,0,0,0
Clones Town,2019,1 - 4 years,0,0,0
Clones Town,2019,10 - 14 years,0,0,0
Clones Town,2019,15 - 19 years,0,0,0
Clones Town,2019,20 - 24 years,0,0,0
Clones Town,2019,25 - 29 years,0,0,0
Clones Town,2019,30 - 34 years,0,0,0
Clones Town,2019,35 - 39 years,0,0,0
Clones Town,2019,40 - 44 years,0,0,0
Clones Town,2019,45 - 49 years,0,0,0
Clones Town,2019,5 - 9 years,0,0,0
Clones Town,2019,50 - 54 years,0,1,1
Clones Town,2019,55 - 59 years,1,1,2
Clones Town,2019,60 - 64 years,1,1,2
Clones Town,2019,65 - 69 years,1,0,1
Clones Town,2019,70 - 74 years,1,2,3
Clones Town,2019,75 - 79 years,0,1,1
Clones Town,2019,80 - 84 years,1,2,3
Clones Town,2019,85 years and over,3,2,5
Clones Town,2019,Under 1 year,0,0,0
Clones Town,2020,1 - 4 years,0,0,0
Clones Town,2020,10 - 14 years,0,0,0
Clones Town,2020,15 - 19 years,0,0,0
Clones Town,2020,20 - 24 years,0,0,0
Clones Town,2020,25 - 29 years,0,0,0
Clones Town,2020,30 - 34 years,0,0,0
Clones Town,2020,35 - 39 years,0,0,0
Clones Town,2020,40 - 44 years,0,0,0
Clones Town,2020,45 - 49 years,0,0,0
Clones Town,2020,5 - 9 years,0,0,0
Clones Town,2020,50 - 54 years,0,1,1
Clones Town,2020,55 - 59 years,1,1,2
Clones Town,2020,60 - 64 years,1,1,2
Clones Town,2020,65 - 69 years,1,0,1
Clones Town,2020,70 - 74 years,1,2,3
Clones Town,2020,75 - 79 years,0,1,1
Clones Town,2020,80 - 84 years,1,2,3
Clones Town,2020,85 years and over,3,2,5
Clones Town,2020,Under 1 year,0,0,0
Clonmel Borough,2007,1 - 4 years,0,0,0
Clonmel Borough,2007,10 - 14 years,0,0,0
Clonmel Borough,2007,15 - 19 years,0,0,0
Clonmel Borough,2007,20 - 24 years,1,0,1
Clonmel Borough,2007,25 - 29 years,0,1,1
Clonmel Borough,2007,30 - 34 years,0,1,1
Clonmel Borough,2007,35 - 39 years,1,1,2
Clonmel Borough,2007,40 - 44 years,0,1,1
Clonmel Borough,2007,45 - 49 years,0,0,0
Clonmel Borough,2007,5 - 9 years,0,0,0
Clonmel Borough,2007,50 - 54 years,1,2,3
Clonmel Borough,2007,55 - 59 years,3,3,6
Clonmel Borough,2007,60 - 64 years,5,4,9
Clonmel Borough,2007,65 - 69 years,5,11,16
Clonmel Borough,2007,70 - 74 years,8,6,14
Clonmel Borough,2007,75 - 79 years,6,9,15
Clonmel Borough,2007,80 - 84 years,12,15,27
Clonmel Borough,2007,85 years and over,21,11,32
Clonmel Borough,2007,Under 1 year,0,1,1
Clonmel Borough,2008,1 - 4 years,0,0,0
Clonmel Borough,2008,10 - 14 years,0,0,0
Clonmel Borough,2008,15 - 19 years,0,1,1
Clonmel Borough,2008,20 - 24 years,1,0,1
Clonmel Borough,2008,25 - 29 years,0,1,1
Clonmel Borough,2008,30 - 34 years,2,1,3
Clonmel Borough,2008,35 - 39 years,2,6,8
Clonmel Borough,2008,40 - 44 years,4,3,7
Clonmel Borough,2008,45 - 49 years,1,2,3
Clonmel Borough,2008,5 - 9 years,0,0,0
Clonmel Borough,2008,50 - 54 years,1,3,4
Clonmel Borough,2008,55 - 59 years,7,4,11
Clonmel Borough,2008,60 - 64 years,10,5,15
Clonmel Borough,2008,65 - 69 years,2,6,8
Clonmel Borough,2008,70 - 74 years,7,7,14
Clonmel Borough,2008,75 - 79 years,14,6,20
Clonmel Borough,2008,80 - 84 years,14,12,26
Clonmel Borough,2008,85 years and over,33,26,59
Clonmel Borough,2008,Under 1 year,0,2,2
Clonmel Borough,2009,1 - 4 years,0,1,1
Clonmel Borough,2009,10 - 14 years,0,0,0
Clonmel Borough,2009,15 - 19 years,0,1,1
Clonmel Borough,2009,20 - 24 years,1,1,2
Clonmel Borough,2009,25 - 29 years,1,2,3
Clonmel Borough,2009,30 - 34 years,2,1,3
Clonmel Borough,2009,35 - 39 years,1,1,2
Clonmel Borough,2009,40 - 44 years,1,2,3
Clonmel Borough,2009,45 - 49 years,3,2,5
Clonmel Borough,2009,5 - 9 years,0,0,0
Clonmel Borough,2009,50 - 54 years,2,2,4
Clonmel Borough,2009,55 - 59 years,1,4,5
Clonmel Borough,2009,60 - 64 years,2,8,10
Clonmel Borough,2009,65 - 69 years,5,6,11
Clonmel Borough,2009,70 - 74 years,9,10,19
Clonmel Borough,2009,75 - 79 years,5,8,13
Clonmel Borough,2009,80 - 84 years,10,11,21
Clonmel Borough,2009,85 years and over,18,11,29
Clonmel Borough,2009,Under 1 year,0,1,1
Clonmel Borough,2010,1 - 4 years,0,1,1
Clonmel Borough,2010,10 - 14 years,0,0,0
Clonmel Borough,2010,15 - 19 years,0,1,1
Clonmel Borough,2010,20 - 24 years,1,3,4
Clonmel Borough,2010,25 - 29 years,1,2,3
Clonmel Borough,2010,30 - 34 years,1,1,2
Clonmel Borough,2010,35 - 39 years,1,3,4
Clonmel Borough,2010,40 - 44 years,1,1,2
Clonmel Borough,2010,45 - 49 years,3,4,7
Clonmel Borough,2010,5 - 9 years,0,0,0
Clonmel Borough,2010,50 - 54 years,2,2,4
Clonmel Borough,2010,55 - 59 years,2,3,5
Clonmel Borough,2010,60 - 64 years,3,6,9
Clonmel Borough,2010,65 - 69 years,5,4,9
Clonmel Borough,2010,70 - 74 years,6,4,10
Clonmel Borough,2010,75 - 79 years,10,13,23
Clonmel Borough,2010,80 - 84 years,17,12,29
Clonmel Borough,2010,85 years and over,23,18,41
Clonmel Borough,2010,Under 1 year,0,1,1
Clonmel Borough,2011,1 - 4 years,0,0,0
Clonmel Borough,2011,10 - 14 years,0,0,0
Clonmel Borough,2011,15 - 19 years,0,0,0
Clonmel Borough,2011,20 - 24 years,0,2,2
Clonmel Borough,2011,25 - 29 years,0,0,0
Clonmel Borough,2011,30 - 34 years,0,0,0
Clonmel Borough,2011,35 - 39 years,0,2,2
Clonmel Borough,2011,40 - 44 years,0,0,0
Clonmel Borough,2011,45 - 49 years,1,4,5
Clonmel Borough,2011,5 - 9 years,0,0,0
Clonmel Borough,2011,50 - 54 years,5,3,8
Clonmel Borough,2011,55 - 59 years,1,1,2
Clonmel Borough,2011,60 - 64 years,1,5,6
Clonmel Borough,2011,65 - 69 years,3,7,10
Clonmel Borough,2011,70 - 74 years,5,6,11
Clonmel Borough,2011,75 - 79 years,9,7,16
Clonmel Borough,2011,80 - 84 years,9,12,21
Clonmel Borough,2011,85 years and over,27,15,42
Clonmel Borough,2011,Under 1 year,0,1,1
Clonmel Borough,2012,1 - 4 years,0,1,1
Clonmel Borough,2012,10 - 14 years,0,0,0
Clonmel Borough,2012,15 - 19 years,0,0,0
Clonmel Borough,2012,20 - 24 years,0,2,2
Clonmel Borough,2012,25 - 29 years,0,1,1
Clonmel Borough,2012,30 - 34 years,0,1,1
Clonmel Borough,2012,35 - 39 years,0,2,2
Clonmel Borough,2012,40 - 44 years,0,3,3
Clonmel Borough,2012,45 - 49 years,2,5,7
Clonmel Borough,2012,5 - 9 years,0,0,0
Clonmel Borough,2012,50 - 54 years,3,2,5
Clonmel Borough,2012,55 - 59 years,2,1,3
Clonmel Borough,2012,60 - 64 years,2,5,7
Clonmel Borough,2012,65 - 69 years,4,8,12
Clonmel Borough,2012,70 - 74 years,5,9,14
Clonmel Borough,2012,75 - 79 years,8,15,23
Clonmel Borough,2012,80 - 84 years,9,13,22
Clonmel Borough,2012,85 years and over,35,19,54
Clonmel Borough,2012,Under 1 year,0,1,1
Clonmel Borough,2013,1 - 4 years,0,0,0
Clonmel Borough,2013,10 - 14 years,0,0,0
Clonmel Borough,2013,15 - 19 years,0,0,0
Clonmel Borough,2013,20 - 24 years,0,0,0
Clonmel Borough,2013,25 - 29 years,1,0,1
Clonmel Borough,2013,30 - 34 years,0,2,2
Clonmel Borough,2013,35 - 39 years,1,3,4
Clonmel Borough,2013,40 - 44 years,0,0,0
Clonmel Borough,2013,45 - 49 years,1,3,4
Clonmel Borough,2013,5 - 9 years,0,0,0
Clonmel Borough,2013,50 - 54 years,1,8,9
Clonmel Borough,2013,55 - 59 years,4,2,6
Clonmel Borough,2013,60 - 64 years,0,6,6
Clonmel Borough,2013,65 - 69 years,3,12,15
Clonmel Borough,2013,70 - 74 years,6,6,12
Clonmel Borough,2013,75 - 79 years,8,14,22
Clonmel Borough,2013,80 - 84 years,15,13,28
Clonmel Borough,2013,85 years and over,32,19,51
Clonmel Borough,2013,Under 1 year,0,0,0
Clonmel Borough,2014,1 - 4 years,0,0,0
Clonmel Borough,2014,10 - 14 years,0,0,0
Clonmel Borough,2014,15 - 19 years,0,0,0
Clonmel Borough,2014,20 - 24 years,0,2,2
Clonmel Borough,2014,25 - 29 years,1,2,3
Clonmel Borough,2014,30 - 34 years,2,1,3
Clonmel Borough,2014,35 - 39 years,1,1,2
Clonmel Borough,2014,40 - 44 years,1,1,2
Clonmel Borough,2014,45 - 49 years,1,1,2
Clonmel Borough,2014,5 - 9 years,1,0,1
Clonmel Borough,2014,50 - 54 years,1,2,3
Clonmel Borough,2014,55 - 59 years,2,3,5
Clonmel Borough,2014,60 - 64 years,8,4,12
Clonmel Borough,2014,65 - 69 years,7,9,16
Clonmel Borough,2014,70 - 74 years,7,6,13
Clonmel Borough,2014,75 - 79 years,6,10,16
Clonmel Borough,2014,80 - 84 years,11,8,19
Clonmel Borough,2014,85 years and over,30,14,44
Clonmel Borough,2014,Under 1 year,1,0,1
Clonmel Borough,2015,1 - 4 years,0,0,0
Clonmel Borough,2015,10 - 14 years,0,0,0
Clonmel Borough,2015,15 - 19 years,0,0,0
Clonmel Borough,2015,20 - 24 years,0,2,2
Clonmel Borough,2015,25 - 29 years,1,2,3
Clonmel Borough,2015,30 - 34 years,2,1,3
Clonmel Borough,2015,35 - 39 years,1,1,2
Clonmel Borough,2015,40 - 44 years,1,1,2
Clonmel Borough,2015,45 - 49 years,1,1,2
Clonmel Borough,2015,5 - 9 years,1,0,1
Clonmel Borough,2015,50 - 54 years,1,2,3
Clonmel Borough,2015,55 - 59 years,2,3,5
Clonmel Borough,2015,60 - 64 years,8,4,12
Clonmel Borough,2015,65 - 69 years,7,9,16
Clonmel Borough,2015,70 - 74 years,7,6,13
Clonmel Borough,2015,75 - 79 years,6,10,16
Clonmel Borough,2015,80 - 84 years,11,8,19
Clonmel Borough,2015,85 years and over,30,14,44
Clonmel Borough,2015,Under 1 year,1,0,1
Clonmel Borough,2016,1 - 4 years,0,0,0
Clonmel Borough,2016,10 - 14 years,0,0,0
Clonmel Borough,2016,15 - 19 years,0,0,0
Clonmel Borough,2016,20 - 24 years,0,2,2
Clonmel Borough,2016,25 - 29 years,1,2,3
Clonmel Borough,2016,30 - 34 years,2,1,3
Clonmel Borough,2016,35 - 39 years,1,1,2
Clonmel Borough,2016,40 - 44 years,1,1,2
Clonmel Borough,2016,45 - 49 years,1,1,2
Clonmel Borough,2016,5 - 9 years,1,0,1
Clonmel Borough,2016,50 - 54 years,1,2,3
Clonmel Borough,2016,55 - 59 years,2,3,5
Clonmel Borough,2016,60 - 64 years,8,4,12
Clonmel Borough,2016,65 - 69 years,7,9,16
Clonmel Borough,2016,70 - 74 years,7,6,13
Clonmel Borough,2016,75 - 79 years,6,10,16
Clonmel Borough,2016,80 - 84 years,11,8,19
Clonmel Borough,2016,85 years and over,30,14,44
Clonmel Borough,2016,Under 1 year,1,0,1
Clonmel Borough,2017,1 - 4 years,0,0,0
Clonmel Borough,2017,10 - 14 years,0,0,0
Clonmel Borough,2017,15 - 19 years,0,0,0
Clonmel Borough,2017,20 - 24 years,0,2,2
Clonmel Borough,2017,25 - 29 years,1,2,3
Clonmel Borough,2017,30 - 34 years,2,1,3
Clonmel Borough,2017,35 - 39 years,1,2,3
Clonmel Borough,2017,40 - 44 years,1,1,2
Clonmel Borough,2017,45 - 49 years,1,4,5
Clonmel Borough,2017,5 - 9 years,1,0,1
Clonmel Borough,2017,50 - 54 years,1,2,3
Clonmel Borough,2017,55 - 59 years,2,4,6
Clonmel Borough,2017,60 - 64 years,2,5,7
Clonmel Borough,2017,65 - 69 years,4,5,9
Clonmel Borough,2017,70 - 74 years,10,14,24
Clonmel Borough,2017,75 - 79 years,10,12,22
Clonmel Borough,2017,80 - 84 years,16,18,34
Clonmel Borough,2017,85 years and over,43,21,64
Clonmel Borough,2017,Under 1 year,1,0,1
Clonmel Borough,2018,1 - 4 years,0,0,0
Clonmel Borough,2018,10 - 14 years,0,0,0
Clonmel Borough,2018,15 - 19 years,0,1,1
Clonmel Borough,2018,20 - 24 years,0,1,1
Clonmel Borough,2018,25 - 29 years,0,1,1
Clonmel Borough,2018,30 - 34 years,0,1,1
Clonmel Borough,2018,35 - 39 years,1,2,3
Clonmel Borough,2018,40 - 44 years,0,0,0
Clonmel Borough,2018,45 - 49 years,2,0,2
Clonmel Borough,2018,5 - 9 years,0,0,0
Clonmel Borough,2018,50 - 54 years,2,5,7
Clonmel Borough,2018,55 - 59 years,4,3,7
Clonmel Borough,2018,60 - 64 years,2,9,11
Clonmel Borough,2018,65 - 69 years,4,6,10
Clonmel Borough,2018,70 - 74 years,4,11,15
Clonmel Borough,2018,75 - 79 years,17,13,30
Clonmel Borough,2018,80 - 84 years,8,10,18
Clonmel Borough,2018,85 years and over,34,21,55
Clonmel Borough,2018,Under 1 year,1,0,1
Clonmel Borough,2019,1 - 4 years,0,0,0
Clonmel Borough,2019,10 - 14 years,0,0,0
Clonmel Borough,2019,15 - 19 years,0,1,1
Clonmel Borough,2019,20 - 24 years,0,1,1
Clonmel Borough,2019,25 - 29 years,0,1,1
Clonmel Borough,2019,30 - 34 years,0,1,1
Clonmel Borough,2019,35 - 39 years,1,2,3
Clonmel Borough,2019,40 - 44 years,0,0,0
Clonmel Borough,2019,45 - 49 years,2,0,2
Clonmel Borough,2019,5 - 9 years,0,0,0
Clonmel Borough,2019,50 - 54 years,2,5,7
Clonmel Borough,2019,55 - 59 years,4,3,7
Clonmel Borough,2019,60 - 64 years,2,9,11
Clonmel Borough,2019,65 - 69 years,4,6,10
Clonmel Borough,2019,70 - 74 years,4,11,15
Clonmel Borough,2019,75 - 79 years,17,13,30
Clonmel Borough,2019,80 - 84 years,8,10,18
Clonmel Borough,2019,85 years and over,34,21,55
Clonmel Borough,2019,Under 1 year,1,0,1
Clonmel Borough,2020,1 - 4 years,0,0,0
Clonmel Borough,2020,10 - 14 years,0,0,0
Clonmel Borough,2020,15 - 19 years,0,1,1
Clonmel Borough,2020,20 - 24 years,0,1,1
Clonmel Borough,2020,25 - 29 years,0,1,1
Clonmel Borough,2020,30 - 34 years,0,1,1
Clonmel Borough,2020,35 - 39 years,1,2,3
Clonmel Borough,2020,40 - 44 years,0,0,0
Clonmel Borough,2020,45 - 49 years,2,0,2
Clonmel Borough,2020,5 - 9 years,0,0,0
Clonmel Borough,2020,50 - 54 years,2,5,7
Clonmel Borough,2020,55 - 59 years,4,3,7
Clonmel Borough,2020,60 - 64 years,2,9,11
Clonmel Borough,2020,65 - 69 years,4,6,10
Clonmel Borough,2020,70 - 74 years,4,11,15
Clonmel Borough,2020,75 - 79 years,17,13,30
Clonmel Borough,2020,80 - 84 years,8,10,18
Clonmel Borough,2020,85 years and over,34,21,55
Clonmel Borough,2020,Under 1 year,1,0,1
Cobh Town,2007,1 - 4 years,0,0,0
Cobh Town,2007,10 - 14 years,0,0,0
Cobh Town,2007,15 - 19 years,0,0,0
Cobh Town,2007,20 - 24 years,0,1,1
Cobh Town,2007,25 - 29 years,0,0,0
Cobh Town,2007,30 - 34 years,0,0,0
Cobh Town,2007,35 - 39 years,0,2,2
Cobh Town,2007,40 - 44 years,0,1,1
Cobh Town,2007,45 - 49 years,0,1,1
Cobh Town,2007,5 - 9 years,0,0,0
Cobh Town,2007,50 - 54 years,1,1,2
Cobh Town,2007,55 - 59 years,2,0,2
Cobh Town,2007,60 - 64 years,0,1,1
Cobh Town,2007,65 - 69 years,1,2,3
Cobh Town,2007,70 - 74 years,4,11,15
Cobh Town,2007,75 - 79 years,9,9,18
Cobh Town,2007,80 - 84 years,6,6,12
Cobh Town,2007,85 years and over,8,2,10
Cobh Town,2007,Under 1 year,1,0,1
Cobh Town,2008,1 - 4 years,0,0,0
Cobh Town,2008,10 - 14 years,0,0,0
Cobh Town,2008,15 - 19 years,0,0,0
Cobh Town,2008,20 - 24 years,0,1,1
Cobh Town,2008,25 - 29 years,0,0,0
Cobh Town,2008,30 - 34 years,0,0,0
Cobh Town,2008,35 - 39 years,0,2,2
Cobh Town,2008,40 - 44 years,0,1,1
Cobh Town,2008,45 - 49 years,1,1,2
Cobh Town,2008,5 - 9 years,0,0,0
Cobh Town,2008,50 - 54 years,1,2,3
Cobh Town,2008,55 - 59 years,1,4,5
Cobh Town,2008,60 - 64 years,1,3,4
Cobh Town,2008,65 - 69 years,1,1,2
Cobh Town,2008,70 - 74 years,4,6,10
Cobh Town,2008,75 - 79 years,2,5,7
Cobh Town,2008,80 - 84 years,3,5,8
Cobh Town,2008,85 years and over,9,4,13
Cobh Town,2008,Under 1 year,1,1,2
Cobh Town,2009,1 - 4 years,0,0,0
Cobh Town,2009,10 - 14 years,0,0,0
Cobh Town,2009,15 - 19 years,0,0,0
Cobh Town,2009,20 - 24 years,0,1,1
Cobh Town,2009,25 - 29 years,1,3,4
Cobh Town,2009,30 - 34 years,0,0,0
Cobh Town,2009,35 - 39 years,1,2,3
Cobh Town,2009,40 - 44 years,1,1,2
Cobh Town,2009,45 - 49 years,1,1,2
Cobh Town,2009,5 - 9 years,0,0,0
Cobh Town,2009,50 - 54 years,1,1,2
Cobh Town,2009,55 - 59 years,1,1,2
Cobh Town,2009,60 - 64 years,2,3,5
Cobh Town,2009,65 - 69 years,3,3,6
Cobh Town,2009,70 - 74 years,4,3,7
Cobh Town,2009,75 - 79 years,2,8,10
Cobh Town,2009,80 - 84 years,2,4,6
Cobh Town,2009,85 years and over,14,6,20
Cobh Town,2009,Under 1 year,1,1,2
Cobh Town,2010,1 - 4 years,0,0,0
Cobh Town,2010,10 - 14 years,0,0,0
Cobh Town,2010,15 - 19 years,0,0,0
Cobh Town,2010,20 - 24 years,0,1,1
Cobh Town,2010,25 - 29 years,1,3,4
Cobh Town,2010,30 - 34 years,1,0,1
Cobh Town,2010,35 - 39 years,1,2,3
Cobh Town,2010,40 - 44 years,1,3,4
Cobh Town,2010,45 - 49 years,1,1,2
Cobh Town,2010,5 - 9 years,0,0,0
Cobh Town,2010,50 - 54 years,1,1,2
Cobh Town,2010,55 - 59 years,1,1,2
Cobh Town,2010,60 - 64 years,2,5,7
Cobh Town,2010,65 - 69 years,3,3,6
Cobh Town,2010,70 - 74 years,3,5,8
Cobh Town,2010,75 - 79 years,5,6,11
Cobh Town,2010,80 - 84 years,2,3,5
Cobh Town,2010,85 years and over,13,6,19
Cobh Town,2010,Under 1 year,1,1,2
Cobh Town,2011,1 - 4 years,0,0,0
Cobh Town,2011,10 - 14 years,0,0,0
Cobh Town,2011,15 - 19 years,0,0,0
Cobh Town,2011,20 - 24 years,0,0,0
Cobh Town,2011,25 - 29 years,1,0,1
Cobh Town,2011,30 - 34 years,0,1,1
Cobh Town,2011,35 - 39 years,0,2,2
Cobh Town,2011,40 - 44 years,0,1,1
Cobh Town,2011,45 - 49 years,1,0,1
Cobh Town,2011,5 - 9 years,0,0,0
Cobh Town,2011,50 - 54 years,1,0,1
Cobh Town,2011,55 - 59 years,1,1,2
Cobh Town,2011,60 - 64 years,1,4,5
Cobh Town,2011,65 - 69 years,3,5,8
Cobh Town,2011,70 - 74 years,3,4,7
Cobh Town,2011,75 - 79 years,2,6,8
Cobh Town,2011,80 - 84 years,4,3,7
Cobh Town,2011,85 years and over,11,5,16
Cobh Town,2011,Under 1 year,0,0,0
Cobh Town,2012,1 - 4 years,0,0,0
Cobh Town,2012,10 - 14 years,0,1,1
Cobh Town,2012,15 - 19 years,1,0,1
Cobh Town,2012,20 - 24 years,1,1,2
Cobh Town,2012,25 - 29 years,1,0,1
Cobh Town,2012,30 - 34 years,0,1,1
Cobh Town,2012,35 - 39 years,0,2,2
Cobh Town,2012,40 - 44 years,0,1,1
Cobh Town,2012,45 - 49 years,1,1,2
Cobh Town,2012,5 - 9 years,0,0,0
Cobh Town,2012,50 - 54 years,2,2,4
Cobh Town,2012,55 - 59 years,1,1,2
Cobh Town,2012,60 - 64 years,1,5,6
Cobh Town,2012,65 - 69 years,3,5,8
Cobh Town,2012,70 - 74 years,2,4,6
Cobh Town,2012,75 - 79 years,1,7,8
Cobh Town,2012,80 - 84 years,4,4,8
Cobh Town,2012,85 years and over,12,7,19
Cobh Town,2012,Under 1 year,0,0,0
Cobh Town,2013,1 - 4 years,0,0,0
Cobh Town,2013,10 - 14 years,0,0,0
Cobh Town,2013,15 - 19 years,0,0,0
Cobh Town,2013,20 - 24 years,0,0,0
Cobh Town,2013,25 - 29 years,0,0,0
Cobh Town,2013,30 - 34 years,0,1,1
Cobh Town,2013,35 - 39 years,0,0,0
Cobh Town,2013,40 - 44 years,0,2,2
Cobh Town,2013,45 - 49 years,3,1,4
Cobh Town,2013,5 - 9 years,0,0,0
Cobh Town,2013,50 - 54 years,0,0,0
Cobh Town,2013,55 - 59 years,0,1,1
Cobh Town,2013,60 - 64 years,2,1,3
Cobh Town,2013,65 - 69 years,2,2,4
Cobh Town,2013,70 - 74 years,3,2,5
Cobh Town,2013,75 - 79 years,7,5,12
Cobh Town,2013,80 - 84 years,3,8,11
Cobh Town,2013,85 years and over,14,5,19
Cobh Town,2013,Under 1 year,0,1,1
Cobh Town,2014,1 - 4 years,0,0,0
Cobh Town,2014,10 - 14 years,0,0,0
Cobh Town,2014,15 - 19 years,0,0,0
Cobh Town,2014,20 - 24 years,0,1,1
Cobh Town,2014,25 - 29 years,0,0,0
Cobh Town,2014,30 - 34 years,0,1,1
Cobh Town,2014,35 - 39 years,0,1,1
Cobh Town,2014,40 - 44 years,0,1,1
Cobh Town,2014,45 - 49 years,2,1,3
Cobh Town,2014,5 - 9 years,0,0,0
Cobh Town,2014,50 - 54 years,0,1,1
Cobh Town,2014,55 - 59 years,1,1,2
Cobh Town,2014,60 - 64 years,4,3,7
Cobh Town,2014,65 - 69 years,2,4,6
Cobh Town,2014,70 - 74 years,3,1,4
Cobh Town,2014,75 - 79 years,10,4,14
Cobh Town,2014,80 - 84 years,7,8,15
Cobh Town,2014,85 years and over,11,4,15
Cobh Town,2014,Under 1 year,0,1,1
Cobh Town,2015,1 - 4 years,0,0,0
Cobh Town,2015,10 - 14 years,0,0,0
Cobh Town,2015,15 - 19 years,0,0,0
Cobh Town,2015,20 - 24 years,0,1,1
Cobh Town,2015,25 - 29 years,0,0,0
Cobh Town,2015,30 - 34 years,0,1,1
Cobh Town,2015,35 - 39 years,0,1,1
Cobh Town,2015,40 - 44 years,0,1,1
Cobh Town,2015,45 - 49 years,2,1,3
Cobh Town,2015,5 - 9 years,0,0,0
Cobh Town,2015,50 - 54 years,0,1,1
Cobh Town,2015,55 - 59 years,1,1,2
Cobh Town,2015,60 - 64 years,4,3,7
Cobh Town,2015,65 - 69 years,2,4,6
Cobh Town,2015,70 - 74 years,3,1,4
Cobh Town,2015,75 - 79 years,10,4,14
Cobh Town,2015,80 - 84 years,7,8,15
Cobh Town,2015,85 years and over,11,4,15
Cobh Town,2015,Under 1 year,0,1,1
Cobh Town,2016,1 - 4 years,0,0,0
Cobh Town,2016,10 - 14 years,0,0,0
Cobh Town,2016,15 - 19 years,0,0,0
Cobh Town,2016,20 - 24 years,0,1,1
Cobh Town,2016,25 - 29 years,0,0,0
Cobh Town,2016,30 - 34 years,0,1,1
Cobh Town,2016,35 - 39 years,0,1,1
Cobh Town,2016,40 - 44 years,0,1,1
Cobh Town,2016,45 - 49 years,2,1,3
Cobh Town,2016,5 - 9 years,0,0,0
Cobh Town,2016,50 - 54 years,0,1,1
Cobh Town,2016,55 - 59 years,1,1,2
Cobh Town,2016,60 - 64 years,4,3,7
Cobh Town,2016,65 - 69 years,2,4,6
Cobh Town,2016,70 - 74 years,3,1,4
Cobh Town,2016,75 - 79 years,10,4,14
Cobh Town,2016,80 - 84 years,7,8,15
Cobh Town,2016,85 years and over,11,4,15
Cobh Town,2016,Under 1 year,0,1,1
Cobh Town,2017,1 - 4 years,0,0,0
Cobh Town,2017,10 - 14 years,0,0,0
Cobh Town,2017,15 - 19 years,0,0,0
Cobh Town,2017,20 - 24 years,0,1,1
Cobh Town,2017,25 - 29 years,0,1,1
Cobh Town,2017,30 - 34 years,0,1,1
Cobh Town,2017,35 - 39 years,0,1,1
Cobh Town,2017,40 - 44 years,0,1,1
Cobh Town,2017,45 - 49 years,2,1,3
Cobh Town,2017,5 - 9 years,0,0,0
Cobh Town,2017,50 - 54 years,0,3,3
Cobh Town,2017,55 - 59 years,1,1,2
Cobh Town,2017,60 - 64 years,2,3,5
Cobh Town,2017,65 - 69 years,4,5,9
Cobh Town,2017,70 - 74 years,2,2,4
Cobh Town,2017,75 - 79 years,6,5,11
Cobh Town,2017,80 - 84 years,7,6,13
Cobh Town,2017,85 years and over,9,9,18
Cobh Town,2017,Under 1 year,0,1,1
Cobh Town,2018,1 - 4 years,0,0,0
Cobh Town,2018,10 - 14 years,0,0,0
Cobh Town,2018,15 - 19 years,0,0,0
Cobh Town,2018,20 - 24 years,1,0,1
Cobh Town,2018,25 - 29 years,0,1,1
Cobh Town,2018,30 - 34 years,0,0,0
Cobh Town,2018,35 - 39 years,0,0,0
Cobh Town,2018,40 - 44 years,0,0,0
Cobh Town,2018,45 - 49 years,0,2,2
Cobh Town,2018,5 - 9 years,0,0,0
Cobh Town,2018,50 - 54 years,0,0,0
Cobh Town,2018,55 - 59 years,0,2,2
Cobh Town,2018,60 - 64 years,1,2,3
Cobh Town,2018,65 - 69 years,1,4,5
Cobh Town,2018,70 - 74 years,2,3,5
Cobh Town,2018,75 - 79 years,2,4,6
Cobh Town,2018,80 - 84 years,3,3,6
Cobh Town,2018,85 years and over,11,13,24
Cobh Town,2018,Under 1 year,0,0,0
Cobh Town,2019,1 - 4 years,0,0,0
Cobh Town,2019,10 - 14 years,0,0,0
Cobh Town,2019,15 - 19 years,0,0,0
Cobh Town,2019,20 - 24 years,1,0,1
Cobh Town,2019,25 - 29 years,0,1,1
Cobh Town,2019,30 - 34 years,0,0,0
Cobh Town,2019,35 - 39 years,0,0,0
Cobh Town,2019,40 - 44 years,0,0,0
Cobh Town,2019,45 - 49 years,0,2,2
Cobh Town,2019,5 - 9 years,0,0,0
Cobh Town,2019,50 - 54 years,0,0,0
Cobh Town,2019,55 - 59 years,0,2,2
Cobh Town,2019,60 - 64 years,1,2,3
Cobh Town,2019,65 - 69 years,1,4,5
Cobh Town,2019,70 - 74 years,2,3,5
Cobh Town,2019,75 - 79 years,2,4,6
Cobh Town,2019,80 - 84 years,3,3,6
Cobh Town,2019,85 years and over,11,13,24
Cobh Town,2019,Under 1 year,0,0,0
Cobh Town,2020,1 - 4 years,0,0,0
Cobh Town,2020,10 - 14 years,0,0,0
Cobh Town,2020,15 - 19 years,0,0,0
Cobh Town,2020,20 - 24 years,1,0,1
Cobh Town,2020,25 - 29 years,0,1,1
Cobh Town,2020,30 - 34 years,0,0,0
Cobh Town,2020,35 - 39 years,0,0,0
Cobh Town,2020,40 - 44 years,0,0,0
Cobh Town,2020,45 - 49 years,0,2,2
Cobh Town,2020,5 - 9 years,0,0,0
Cobh Town,2020,50 - 54 years,0,0,0
Cobh Town,2020,55 - 59 years,0,2,2
Cobh Town,2020,60 - 64 years,1,2,3
Cobh Town,2020,65 - 69 years,1,4,5
Cobh Town,2020,70 - 74 years,2,3,5
Cobh Town,2020,75 - 79 years,2,4,6
Cobh Town,2020,80 - 84 years,3,3,6
Cobh Town,2020,85 years and over,11,13,24
Cobh Town,2020,Under 1 year,0,0,0
Connacht,2007,1 - 4 years,1,3,4
Connacht,2007,10 - 14 years,2,1,3
Connacht,2007,15 - 19 years,6,10,16
Connacht,2007,20 - 24 years,4,23,27
Connacht,2007,25 - 29 years,6,18,24
Connacht,2007,30 - 34 years,12,19,31
Connacht,2007,35 - 39 years,6,20,26
Connacht,2007,40 - 44 years,19,32,51
Connacht,2007,45 - 49 years,25,40,65
Connacht,2007,5 - 9 years,1,0,1
Connacht,2007,50 - 54 years,26,60,86
Connacht,2007,55 - 59 years,53,103,156
Connacht,2007,60 - 64 years,68,123,191
Connacht,2007,65 - 69 years,85,157,242
Connacht,2007,70 - 74 years,138,216,354
Connacht,2007,75 - 79 years,215,321,536
Connacht,2007,80 - 84 years,352,362,714
Connacht,2007,85 years and over,718,465,1183
Connacht,2007,Under 1 year,7,9,16
Connacht,2008,1 - 4 years,2,4,6
Connacht,2008,10 - 14 years,4,2,6
Connacht,2008,15 - 19 years,3,8,11
Connacht,2008,20 - 24 years,4,16,20
Connacht,2008,25 - 29 years,8,13,21
Connacht,2008,30 - 34 years,7,17,24
Connacht,2008,35 - 39 years,15,27,42
Connacht,2008,40 - 44 years,18,30,48
Connacht,2008,45 - 49 years,34,43,77
Connacht,2008,5 - 9 years,1,0,1
Connacht,2008,50 - 54 years,35,66,101
Connacht,2008,55 - 59 years,50,84,134
Connacht,2008,60 - 64 years,74,145,219
Connacht,2008,65 - 69 years,102,202,304
Connacht,2008,70 - 74 years,130,238,368
Connacht,2008,75 - 79 years,216,312,528
Connacht,2008,80 - 84 years,331,381,712
Connacht,2008,85 years and over,838,437,1275
Connacht,2008,Under 1 year,12,20,32
Connacht,2009,1 - 4 years,4,5,9
Connacht,2009,10 - 14 years,1,1,2
Connacht,2009,15 - 19 years,6,8,14
Connacht,2009,20 - 24 years,4,10,14
Connacht,2009,25 - 29 years,12,14,26
Connacht,2009,30 - 34 years,8,21,29
Connacht,2009,35 - 39 years,12,21,33
Connacht,2009,40 - 44 years,13,28,41
Connacht,2009,45 - 49 years,27,45,72
Connacht,2009,5 - 9 years,1,3,4
Connacht,2009,50 - 54 years,40,69,109
Connacht,2009,55 - 59 years,52,111,163
Connacht,2009,60 - 64 years,68,141,209
Connacht,2009,65 - 69 years,80,167,247
Connacht,2009,70 - 74 years,140,213,353
Connacht,2009,75 - 79 years,195,327,522
Connacht,2009,80 - 84 years,299,345,644
Connacht,2009,85 years and over,756,484,1240
Connacht,2009,Under 1 year,14,12,26
Connacht,2010,1 - 4 years,4,4,8
Connacht,2010,10 - 14 years,1,1,2
Connacht,2010,15 - 19 years,5,8,13
Connacht,2010,20 - 24 years,1,8,9
Connacht,2010,25 - 29 years,5,18,23
Connacht,2010,30 - 34 years,8,10,18
Connacht,2010,35 - 39 years,8,27,35
Connacht,2010,40 - 44 years,18,32,50
Connacht,2010,45 - 49 years,18,51,69
Connacht,2010,5 - 9 years,1,3,4
Connacht,2010,50 - 54 years,46,68,114
Connacht,2010,55 - 59 years,53,97,150
Connacht,2010,60 - 64 years,85,129,214
Connacht,2010,65 - 69 years,99,173,272
Connacht,2010,70 - 74 years,131,206,337
Connacht,2010,75 - 79 years,200,308,508
Connacht,2010,80 - 84 years,279,311,590
Connacht,2010,85 years and over,776,512,1288
Connacht,2010,Under 1 year,12,16,28
Connacht,2011,1 - 4 years,1,1,2
Connacht,2011,10 - 14 years,1,1,2
Connacht,2011,15 - 19 years,7,10,17
Connacht,2011,20 - 24 years,5,11,16
Connacht,2011,25 - 29 years,4,16,20
Connacht,2011,30 - 34 years,12,17,29
Connacht,2011,35 - 39 years,11,15,26
Connacht,2011,40 - 44 years,21,25,46
Connacht,2011,45 - 49 years,32,36,68
Connacht,2011,5 - 9 years,2,2,4
Connacht,2011,50 - 54 years,46,56,102
Connacht,2011,55 - 59 years,62,100,162
Connacht,2011,60 - 64 years,77,147,224
Connacht,2011,65 - 69 years,87,170,257
Connacht,2011,70 - 74 years,98,207,305
Connacht,2011,75 - 79 years,193,297,490
Connacht,2011,80 - 84 years,300,315,615
Connacht,2011,85 years and over,826,511,1337
Connacht,2011,Under 1 year,16,20,36
Connacht,2012,1 - 4 years,3,1,4
Connacht,2012,10 - 14 years,1,1,2
Connacht,2012,15 - 19 years,5,5,10
Connacht,2012,20 - 24 years,2,16,18
Connacht,2012,25 - 29 years,5,11,16
Connacht,2012,30 - 34 years,10,20,30
Connacht,2012,35 - 39 years,15,28,43
Connacht,2012,40 - 44 years,19,32,51
Connacht,2012,45 - 49 years,21,49,70
Connacht,2012,5 - 9 years,1,2,3
Connacht,2012,50 - 54 years,36,62,98
Connacht,2012,55 - 59 years,52,72,124
Connacht,2012,60 - 64 years,69,115,184
Connacht,2012,65 - 69 years,99,160,259
Connacht,2012,70 - 74 years,126,210,336
Connacht,2012,75 - 79 years,174,285,459
Connacht,2012,80 - 84 years,297,368,665
Connacht,2012,85 years and over,852,530,1382
Connacht,2012,Under 1 year,14,13,27
Connacht,2013,1 - 4 years,3,4,7
Connacht,2013,10 - 14 years,0,3,3
Connacht,2013,15 - 19 years,2,2,4
Connacht,2013,20 - 24 years,7,15,22
Connacht,2013,25 - 29 years,4,13,17
Connacht,2013,30 - 34 years,3,18,21
Connacht,2013,35 - 39 years,6,18,24
Connacht,2013,40 - 44 years,11,18,29
Connacht,2013,45 - 49 years,21,39,60
Connacht,2013,5 - 9 years,1,1,2
Connacht,2013,50 - 54 years,37,66,103
Connacht,2013,55 - 59 years,55,87,142
Connacht,2013,60 - 64 years,88,135,223
Connacht,2013,65 - 69 years,101,195,296
Connacht,2013,70 - 74 years,140,234,374
Connacht,2013,75 - 79 years,191,278,469
Connacht,2013,80 - 84 years,277,349,626
Connacht,2013,85 years and over,904,530,1434
Connacht,2013,Under 1 year,10,10,20
Connacht,2014,1 - 4 years,2,3,5
Connacht,2014,10 - 14 years,1,1,2
Connacht,2014,15 - 19 years,2,7,9
Connacht,2014,20 - 24 years,5,14,19
Connacht,2014,25 - 29 years,2,16,18
Connacht,2014,30 - 34 years,12,12,24
Connacht,2014,35 - 39 years,14,15,29
Connacht,2014,40 - 44 years,14,28,42
Connacht,2014,45 - 49 years,22,40,62
Connacht,2014,5 - 9 years,2,3,5
Connacht,2014,50 - 54 years,39,63,102
Connacht,2014,55 - 59 years,52,90,142
Connacht,2014,60 - 64 years,86,126,212
Connacht,2014,65 - 69 years,105,189,294
Connacht,2014,70 - 74 years,120,221,341
Connacht,2014,75 - 79 years,188,294,482
Connacht,2014,80 - 84 years,293,346,639
Connacht,2014,85 years and over,818,536,1354
Connacht,2014,Under 1 year,15,13,28
Connacht,2015,1 - 4 years,1,4,5
Connacht,2015,10 - 14 years,1,2,3
Connacht,2015,15 - 19 years,2,3,5
Connacht,2015,20 - 24 years,2,10,12
Connacht,2015,25 - 29 years,2,8,10
Connacht,2015,30 - 34 years,7,16,23
Connacht,2015,35 - 39 years,14,15,29
Connacht,2015,40 - 44 years,12,24,36
Connacht,2015,45 - 49 years,23,40,63
Connacht,2015,5 - 9 years,2,2,4
Connacht,2015,50 - 54 years,29,54,83
Connacht,2015,55 - 59 years,68,88,156
Connacht,2015,60 - 64 years,84,128,212
Connacht,2015,65 - 69 years,111,191,302
Connacht,2015,70 - 74 years,133,247,380
Connacht,2015,75 - 79 years,185,293,478
Connacht,2015,80 - 84 years,274,362,636
Connacht,2015,85 years and over,892,544,1436
Connacht,2015,Under 1 year,11,21,32
Connacht,2016,1 - 4 years,1,2,3
Connacht,2016,10 - 14 years,1,3,4
Connacht,2016,15 - 19 years,4,9,13
Connacht,2016,20 - 24 years,4,8,12
Connacht,2016,25 - 29 years,3,11,14
Connacht,2016,30 - 34 years,9,7,16
Connacht,2016,35 - 39 years,7,19,26
Connacht,2016,40 - 44 years,16,29,45
Connacht,2016,45 - 49 years,19,29,48
Connacht,2016,5 - 9 years,2,1,3
Connacht,2016,50 - 54 years,35,63,98
Connacht,2016,55 - 59 years,46,99,145
Connacht,2016,60 - 64 years,62,147,209
Connacht,2016,65 - 69 years,114,185,299
Connacht,2016,70 - 74 years,130,259,389
Connacht,2016,75 - 79 years,203,303,506
Connacht,2016,80 - 84 years,289,372,661
Connacht,2016,85 years and over,878,575,1453
Connacht,2016,Under 1 year,10,14,24
Connacht,2017,1 - 4 years,2,3,5
Connacht,2017,10 - 14 years,2,1,3
Connacht,2017,15 - 19 years,1,5,6
Connacht,2017,20 - 24 years,3,10,13
Connacht,2017,25 - 29 years,2,16,18
Connacht,2017,30 - 34 years,10,16,26
Connacht,2017,35 - 39 years,10,20,30
Connacht,2017,40 - 44 years,19,35,54
Connacht,2017,45 - 49 years,16,39,55
Connacht,2017,5 - 9 years,2,3,5
Connacht,2017,50 - 54 years,31,64,95
Connacht,2017,55 - 59 years,61,82,143
Connacht,2017,60 - 64 years,72,119,191
Connacht,2017,65 - 69 years,97,152,249
Connacht,2017,70 - 74 years,121,244,365
Connacht,2017,75 - 79 years,181,278,459
Connacht,2017,80 - 84 years,271,352,623
Connacht,2017,85 years and over,894,600,1494
Connacht,2017,Under 1 year,3,10,13
Connacht,2018,1 - 4 years,1,1,2
Connacht,2018,10 - 14 years,1,3,4
Connacht,2018,15 - 19 years,3,3,6
Connacht,2018,20 - 24 years,2,4,6
Connacht,2018,25 - 29 years,6,9,15
Connacht,2018,30 - 34 years,7,10,17
Connacht,2018,35 - 39 years,8,21,29
Connacht,2018,40 - 44 years,11,29,40
Connacht,2018,45 - 49 years,26,36,62
Connacht,2018,5 - 9 years,0,3,3
Connacht,2018,50 - 54 years,39,53,92
Connacht,2018,55 - 59 years,50,98,148
Connacht,2018,60 - 64 years,68,142,210
Connacht,2018,65 - 69 years,121,206,327
Connacht,2018,70 - 74 years,145,259,404
Connacht,2018,75 - 79 years,170,288,458
Connacht,2018,80 - 84 years,251,351,602
Connacht,2018,85 years and over,932,627,1559
Connacht,2018,Under 1 year,6,10,16
Connacht,2019,1 - 4 years,1,0,1
Connacht,2019,10 - 14 years,0,2,2
Connacht,2019,15 - 19 years,2,0,2
Connacht,2019,20 - 24 years,1,4,5
Connacht,2019,25 - 29 years,6,9,15
Connacht,2019,30 - 34 years,4,10,14
Connacht,2019,35 - 39 years,11,22,33
Connacht,2019,40 - 44 years,19,27,46
Connacht,2019,45 - 49 years,21,40,61
Connacht,2019,5 - 9 years,0,0,0
Connacht,2019,50 - 54 years,34,53,87
Connacht,2019,55 - 59 years,59,106,165
Connacht,2019,60 - 64 years,91,130,221
Connacht,2019,65 - 69 years,95,208,303
Connacht,2019,70 - 74 years,167,274,441
Connacht,2019,75 - 79 years,188,274,462
Connacht,2019,80 - 84 years,270,340,610
Connacht,2019,85 years and over,928,634,1562
Connacht,2019,Under 1 year,9,9,18
Connacht,2020,1 - 4 years,1,2,3
Connacht,2020,10 - 14 years,1,2,3
Connacht,2020,15 - 19 years,2,8,10
Connacht,2020,20 - 24 years,2,7,9
Connacht,2020,25 - 29 years,1,8,9
Connacht,2020,30 - 34 years,4,12,16
Connacht,2020,35 - 39 years,12,14,26
Connacht,2020,40 - 44 years,19,22,41
Connacht,2020,45 - 49 years,21,32,53
Connacht,2020,5 - 9 years,0,1,1
Connacht,2020,50 - 54 years,28,62,90
Connacht,2020,55 - 59 years,58,83,141
Connacht,2020,60 - 64 years,76,119,195
Connacht,2020,65 - 69 years,99,190,289
Connacht,2020,70 - 74 years,168,249,417
Connacht,2020,75 - 79 years,215,319,534
Connacht,2020,80 - 84 years,284,371,655
Connacht,2020,85 years and over,853,638,1491
Connacht,2020,Under 1 year,12,8,20
Cork City,2007,1 - 4 years,1,0,1
Cork City,2007,10 - 14 years,0,0,0
Cork City,2007,15 - 19 years,1,1,2
Cork City,2007,20 - 24 years,2,9,11
Cork City,2007,25 - 29 years,5,5,10
Cork City,2007,30 - 34 years,1,13,14
Cork City,2007,35 - 39 years,4,13,17
Cork City,2007,40 - 44 years,5,10,15
Cork City,2007,45 - 49 years,15,15,30
Cork City,2007,5 - 9 years,0,0,0
Cork City,2007,50 - 54 years,11,24,35
Cork City,2007,55 - 59 years,18,30,48
Cork City,2007,60 - 64 years,28,36,64
Cork City,2007,65 - 69 years,21,53,74
Cork City,2007,70 - 74 years,46,85,131
Cork City,2007,75 - 79 years,85,90,175
Cork City,2007,80 - 84 years,106,95,201
Cork City,2007,85 years and over,177,84,261
Cork City,2007,Under 1 year,6,3,9
Cork City,2008,1 - 4 years,1,3,4
Cork City,2008,10 - 14 years,1,2,3
Cork City,2008,15 - 19 years,1,3,4
Cork City,2008,20 - 24 years,4,6,10
Cork City,2008,25 - 29 years,4,4,8
Cork City,2008,30 - 34 years,5,10,15
Cork City,2008,35 - 39 years,4,11,15
Cork City,2008,40 - 44 years,7,11,18
Cork City,2008,45 - 49 years,8,16,24
Cork City,2008,5 - 9 years,0,0,0
Cork City,2008,50 - 54 years,16,16,32
Cork City,2008,55 - 59 years,16,33,49
Cork City,2008,60 - 64 years,22,42,64
Cork City,2008,65 - 69 years,32,64,96
Cork City,2008,70 - 74 years,52,58,110
Cork City,2008,75 - 79 years,81,85,166
Cork City,2008,80 - 84 years,93,73,166
Cork City,2008,85 years and over,190,73,263
Cork City,2008,Under 1 year,2,2,4
Cork City,2009,1 - 4 years,2,3,5
Cork City,2009,10 - 14 years,1,1,2
Cork City,2009,15 - 19 years,1,6,7
Cork City,2009,20 - 24 years,1,5,6
Cork City,2009,25 - 29 years,3,8,11
Cork City,2009,30 - 34 years,2,11,13
Cork City,2009,35 - 39 years,3,8,11
Cork City,2009,40 - 44 years,4,7,11
Cork City,2009,45 - 49 years,12,25,37
Cork City,2009,5 - 9 years,0,0,0
Cork City,2009,50 - 54 years,10,17,27
Cork City,2009,55 - 59 years,19,29,48
Cork City,2009,60 - 64 years,19,48,67
Cork City,2009,65 - 69 years,38,49,87
Cork City,2009,70 - 74 years,58,79,137
Cork City,2009,75 - 79 years,64,86,150
Cork City,2009,80 - 84 years,100,61,161
Cork City,2009,85 years and over,201,87,288
Cork City,2009,Under 1 year,2,3,5
Cork City,2010,1 - 4 years,1,3,4
Cork City,2010,10 - 14 years,1,1,2
Cork City,2010,15 - 19 years,2,6,8
Cork City,2010,20 - 24 years,3,6,9
Cork City,2010,25 - 29 years,3,7,10
Cork City,2010,30 - 34 years,5,3,8
Cork City,2010,35 - 39 years,3,13,16
Cork City,2010,40 - 44 years,7,19,26
Cork City,2010,45 - 49 years,10,11,21
Cork City,2010,5 - 9 years,1,2,3
Cork City,2010,50 - 54 years,21,21,42
Cork City,2010,55 - 59 years,16,28,44
Cork City,2010,60 - 64 years,23,36,59
Cork City,2010,65 - 69 years,40,51,91
Cork City,2010,70 - 74 years,46,67,113
Cork City,2010,75 - 79 years,87,72,159
Cork City,2010,80 - 84 years,81,88,169
Cork City,2010,85 years and over,193,94,287
Cork City,2010,Under 1 year,2,8,10
Cork City,2011,1 - 4 years,0,3,3
Cork City,2011,10 - 14 years,0,0,0
Cork City,2011,15 - 19 years,1,2,3
Cork City,2011,20 - 24 years,1,6,7
Cork City,2011,25 - 29 years,3,5,8
Cork City,2011,30 - 34 years,1,8,9
Cork City,2011,35 - 39 years,2,6,8
Cork City,2011,40 - 44 years,4,7,11
Cork City,2011,45 - 49 years,10,9,19
Cork City,2011,5 - 9 years,0,2,2
Cork City,2011,50 - 54 years,13,19,32
Cork City,2011,55 - 59 years,18,28,46
Cork City,2011,60 - 64 years,26,36,62
Cork City,2011,65 - 69 years,40,43,83
Cork City,2011,70 - 74 years,46,65,111
Cork City,2011,75 - 79 years,58,90,148
Cork City,2011,80 - 84 years,85,76,161
Cork City,2011,85 years and over,231,107,338
Cork City,2011,Under 1 year,1,3,4
Cork City,2012,1 - 4 years,2,1,3
Cork City,2012,10 - 14 years,0,1,1
Cork City,2012,15 - 19 years,1,2,3
Cork City,2012,20 - 24 years,2,8,10
Cork City,2012,25 - 29 years,5,8,13
Cork City,2012,30 - 34 years,2,14,16
Cork City,2012,35 - 39 years,1,9,10
Cork City,2012,40 - 44 years,8,11,19
Cork City,2012,45 - 49 years,12,21,33
Cork City,2012,5 - 9 years,0,1,1
Cork City,2012,50 - 54 years,13,17,30
Cork City,2012,55 - 59 years,18,24,42
Cork City,2012,60 - 64 years,22,49,71
Cork City,2012,65 - 69 years,39,62,101
Cork City,2012,70 - 74 years,40,70,110
Cork City,2012,75 - 79 years,56,86,142
Cork City,2012,80 - 84 years,116,97,213
Cork City,2012,85 years and over,213,105,318
Cork City,2012,Under 1 year,3,4,7
Cork City,2013,1 - 4 years,1,0,1
Cork City,2013,10 - 14 years,0,1,1
Cork City,2013,15 - 19 years,0,1,1
Cork City,2013,20 - 24 years,0,5,5
Cork City,2013,25 - 29 years,0,6,6
Cork City,2013,30 - 34 years,1,4,5
Cork City,2013,35 - 39 years,4,7,11
Cork City,2013,40 - 44 years,1,7,8
Cork City,2013,45 - 49 years,15,10,25
Cork City,2013,5 - 9 years,0,0,0
Cork City,2013,50 - 54 years,16,21,37
Cork City,2013,55 - 59 years,11,33,44
Cork City,2013,60 - 64 years,27,39,66
Cork City,2013,65 - 69 years,42,55,97
Cork City,2013,70 - 74 years,38,57,95
Cork City,2013,75 - 79 years,72,81,153
Cork City,2013,80 - 84 years,97,82,179
Cork City,2013,85 years and over,237,112,349
Cork City,2013,Under 1 year,2,3,5
Cork City,2014,1 - 4 years,1,0,1
Cork City,2014,10 - 14 years,0,1,1
Cork City,2014,15 - 19 years,0,2,2
Cork City,2014,20 - 24 years,2,4,6
Cork City,2014,25 - 29 years,1,5,6
Cork City,2014,30 - 34 years,2,9,11
Cork City,2014,35 - 39 years,4,8,12
Cork City,2014,40 - 44 years,2,9,11
Cork City,2014,45 - 49 years,9,10,19
Cork City,2014,5 - 9 years,0,0,0
Cork City,2014,50 - 54 years,16,16,32
Cork City,2014,55 - 59 years,13,24,37
Cork City,2014,60 - 64 years,24,37,61
Cork City,2014,65 - 69 years,28,42,70
Cork City,2014,70 - 74 years,33,69,102
Cork City,2014,75 - 79 years,66,93,159
Cork City,2014,80 - 84 years,88,72,160
Cork City,2014,85 years and over,224,107,331
Cork City,2014,Under 1 year,1,2,3
Cork City,2015,1 - 4 years,1,2,3
Cork City,2015,10 - 14 years,0,1,1
Cork City,2015,15 - 19 years,0,3,3
Cork City,2015,20 - 24 years,2,3,5
Cork City,2015,25 - 29 years,4,5,9
Cork City,2015,30 - 34 years,2,4,6
Cork City,2015,35 - 39 years,2,8,10
Cork City,2015,40 - 44 years,6,10,16
Cork City,2015,45 - 49 years,2,19,21
Cork City,2015,5 - 9 years,0,0,0
Cork City,2015,50 - 54 years,14,27,41
Cork City,2015,55 - 59 years,27,27,54
Cork City,2015,60 - 64 years,19,27,46
Cork City,2015,65 - 69 years,37,56,93
Cork City,2015,70 - 74 years,41,57,98
Cork City,2015,75 - 79 years,71,87,158
Cork City,2015,80 - 84 years,86,90,176
Cork City,2015,85 years and over,241,115,356
Cork City,2015,Under 1 year,2,4,6
Cork City,2016,1 - 4 years,1,2,3
Cork City,2016,10 - 14 years,0,1,1
Cork City,2016,15 - 19 years,4,4,8
Cork City,2016,20 - 24 years,2,4,6
Cork City,2016,25 - 29 years,4,3,7
Cork City,2016,30 - 34 years,2,4,6
Cork City,2016,35 - 39 years,2,7,9
Cork City,2016,40 - 44 years,2,16,18
Cork City,2016,45 - 49 years,5,14,19
Cork City,2016,5 - 9 years,0,0,0
Cork City,2016,50 - 54 years,10,13,23
Cork City,2016,55 - 59 years,21,28,49
Cork City,2016,60 - 64 years,27,32,59
Cork City,2016,65 - 69 years,40,49,89
Cork City,2016,70 - 74 years,39,62,101
Cork City,2016,75 - 79 years,77,82,159
Cork City,2016,80 - 84 years,114,94,208
Cork City,2016,85 years and over,251,130,381
Cork City,2016,Under 1 year,2,1,3
Cork City,2017,1 - 4 years,1,2,3
Cork City,2017,10 - 14 years,0,1,1
Cork City,2017,15 - 19 years,4,2,6
Cork City,2017,20 - 24 years,3,1,4
Cork City,2017,25 - 29 years,2,8,10
Cork City,2017,30 - 34 years,4,3,7
Cork City,2017,35 - 39 years,5,5,10
Cork City,2017,40 - 44 years,5,8,13
Cork City,2017,45 - 49 years,8,12,20
Cork City,2017,5 - 9 years,0,0,0
Cork City,2017,50 - 54 years,11,21,32
Cork City,2017,55 - 59 years,25,21,46
Cork City,2017,60 - 64 years,21,41,62
Cork City,2017,65 - 69 years,28,56,84
Cork City,2017,70 - 74 years,55,51,106
Cork City,2017,75 - 79 years,50,106,156
Cork City,2017,80 - 84 years,97,99,196
Cork City,2017,85 years and over,235,122,357
Cork City,2017,Under 1 year,1,1,2
Cork City,2018,1 - 4 years,1,0,1
Cork City,2018,10 - 14 years,0,0,0
Cork City,2018,15 - 19 years,0,1,1
Cork City,2018,20 - 24 years,2,3,5
Cork City,2018,25 - 29 years,2,5,7
Cork City,2018,30 - 34 years,5,6,11
Cork City,2018,35 - 39 years,1,8,9
Cork City,2018,40 - 44 years,2,10,12
Cork City,2018,45 - 49 years,13,19,32
Cork City,2018,5 - 9 years,1,0,1
Cork City,2018,50 - 54 years,7,16,23
Cork City,2018,55 - 59 years,15,27,42
Cork City,2018,60 - 64 years,19,33,52
Cork City,2018,65 - 69 years,45,49,94
Cork City,2018,70 - 74 years,38,74,112
Cork City,2018,75 - 79 years,66,86,152
Cork City,2018,80 - 84 years,92,84,176
Cork City,2018,85 years and over,223,145,368
Cork City,2018,Under 1 year,2,0,2
Cork City,2019,1 - 4 years,2,0,2
Cork City,2019,10 - 14 years,0,0,0
Cork City,2019,15 - 19 years,0,1,1
Cork City,2019,20 - 24 years,2,3,5
Cork City,2019,25 - 29 years,2,6,8
Cork City,2019,30 - 34 years,1,4,5
Cork City,2019,35 - 39 years,1,8,9
Cork City,2019,40 - 44 years,4,13,17
Cork City,2019,45 - 49 years,7,15,22
Cork City,2019,5 - 9 years,1,0,1
Cork City,2019,50 - 54 years,7,14,21
Cork City,2019,55 - 59 years,14,21,35
Cork City,2019,60 - 64 years,17,35,52
Cork City,2019,65 - 69 years,37,55,92
Cork City,2019,70 - 74 years,38,62,100
Cork City,2019,75 - 79 years,51,76,127
Cork City,2019,80 - 84 years,101,93,194
Cork City,2019,85 years and over,229,126,355
Cork City,2019,Under 1 year,3,0,3
Cork City,2020,1 - 4 years,1,0,1
Cork City,2020,10 - 14 years,1,0,1
Cork City,2020,15 - 19 years,1,1,2
Cork City,2020,20 - 24 years,2,2,4
Cork City,2020,25 - 29 years,3,3,6
Cork City,2020,30 - 34 years,3,9,12
Cork City,2020,35 - 39 years,3,11,14
Cork City,2020,40 - 44 years,7,9,16
Cork City,2020,45 - 49 years,6,9,15
Cork City,2020,5 - 9 years,1,0,1
Cork City,2020,50 - 54 years,11,30,41
Cork City,2020,55 - 59 years,14,27,41
Cork City,2020,60 - 64 years,26,31,57
Cork City,2020,65 - 69 years,33,45,78
Cork City,2020,70 - 74 years,53,77,130
Cork City,2020,75 - 79 years,64,83,147
Cork City,2020,80 - 84 years,124,100,224
Cork City,2020,85 years and over,233,191,424
Cork City,2020,Under 1 year,3,2,5
Cork County,2007,1 - 4 years,0,6,6
Cork County,2007,10 - 14 years,1,4,5
Cork County,2007,15 - 19 years,2,7,9
Cork County,2007,20 - 24 years,2,14,16
Cork County,2007,25 - 29 years,2,13,15
Cork County,2007,30 - 34 years,6,4,10
Cork County,2007,35 - 39 years,5,20,25
Cork County,2007,40 - 44 years,10,12,22
Cork County,2007,45 - 49 years,15,38,53
Cork County,2007,5 - 9 years,1,2,3
Cork County,2007,50 - 54 years,28,34,62
Cork County,2007,55 - 59 years,41,48,89
Cork County,2007,60 - 64 years,50,65,115
Cork County,2007,65 - 69 years,46,99,145
Cork County,2007,70 - 74 years,98,133,231
Cork County,2007,75 - 79 years,148,178,326
Cork County,2007,80 - 84 years,178,175,353
Cork County,2007,85 years and over,411,212,623
Cork County,2007,Under 1 year,12,7,19
Cork County,2008,1 - 4 years,1,4,5
Cork County,2008,10 - 14 years,1,3,4
Cork County,2008,15 - 19 years,2,18,20
Cork County,2008,20 - 24 years,1,9,10
Cork County,2008,25 - 29 years,5,15,20
Cork County,2008,30 - 34 years,6,12,18
Cork County,2008,35 - 39 years,7,19,26
Cork County,2008,40 - 44 years,13,12,25
Cork County,2008,45 - 49 years,23,28,51
Cork County,2008,5 - 9 years,1,2,3
Cork County,2008,50 - 54 years,24,43,67
Cork County,2008,55 - 59 years,26,61,87
Cork County,2008,60 - 64 years,47,90,137
Cork County,2008,65 - 69 years,58,105,163
Cork County,2008,70 - 74 years,80,128,208
Cork County,2008,75 - 79 years,118,160,278
Cork County,2008,80 - 84 years,185,177,362
Cork County,2008,85 years and over,424,238,662
Cork County,2008,Under 1 year,11,15,26
Cork County,2009,1 - 4 years,3,4,7
Cork County,2009,10 - 14 years,1,1,2
Cork County,2009,15 - 19 years,2,8,10
Cork County,2009,20 - 24 years,4,13,17
Cork County,2009,25 - 29 years,6,13,19
Cork County,2009,30 - 34 years,5,17,22
Cork County,2009,35 - 39 years,14,23,37
Cork County,2009,40 - 44 years,12,23,35
Cork County,2009,45 - 49 years,18,30,48
Cork County,2009,5 - 9 years,1,2,3
Cork County,2009,50 - 54 years,21,40,61
Cork County,2009,55 - 59 years,32,50,82
Cork County,2009,60 - 64 years,43,82,125
Cork County,2009,65 - 69 years,45,102,147
Cork County,2009,70 - 74 years,71,127,198
Cork County,2009,75 - 79 years,118,168,286
Cork County,2009,80 - 84 years,176,193,369
Cork County,2009,85 years and over,389,245,634
Cork County,2009,Under 1 year,4,17,21
Cork County,2010,1 - 4 years,4,2,6
Cork County,2010,10 - 14 years,1,1,2
Cork County,2010,15 - 19 years,2,8,10
Cork County,2010,20 - 24 years,1,17,18
Cork County,2010,25 - 29 years,2,7,9
Cork County,2010,30 - 34 years,4,13,17
Cork County,2010,35 - 39 years,7,13,20
Cork County,2010,40 - 44 years,13,21,34
Cork County,2010,45 - 49 years,26,24,50
Cork County,2010,5 - 9 years,3,2,5
Cork County,2010,50 - 54 years,25,35,60
Cork County,2010,55 - 59 years,41,54,95
Cork County,2010,60 - 64 years,42,75,117
Cork County,2010,65 - 69 years,77,91,168
Cork County,2010,70 - 74 years,72,144,216
Cork County,2010,75 - 79 years,113,160,273
Cork County,2010,80 - 84 years,172,173,345
Cork County,2010,85 years and over,409,217,626
Cork County,2010,Under 1 year,16,11,27
Cork County,2011,1 - 4 years,1,1,2
Cork County,2011,10 - 14 years,1,1,2
Cork County,2011,15 - 19 years,3,7,10
Cork County,2011,20 - 24 years,3,10,13
Cork County,2011,25 - 29 years,6,15,21
Cork County,2011,30 - 34 years,4,22,26
Cork County,2011,35 - 39 years,7,15,22
Cork County,2011,40 - 44 years,14,27,41
Cork County,2011,45 - 49 years,20,26,46
Cork County,2011,5 - 9 years,1,2,3
Cork County,2011,50 - 54 years,25,38,63
Cork County,2011,55 - 59 years,26,61,87
Cork County,2011,60 - 64 years,42,77,119
Cork County,2011,65 - 69 years,70,92,162
Cork County,2011,70 - 74 years,85,123,208
Cork County,2011,75 - 79 years,124,173,297
Cork County,2011,80 - 84 years,183,188,371
Cork County,2011,85 years and over,450,267,717
Cork County,2011,Under 1 year,16,9,25
Cork County,2012,1 - 4 years,1,1,2
Cork County,2012,10 - 14 years,1,2,3
Cork County,2012,15 - 19 years,3,9,12
Cork County,2012,20 - 24 years,4,12,16
Cork County,2012,25 - 29 years,1,7,8
Cork County,2012,30 - 34 years,6,13,19
Cork County,2012,35 - 39 years,7,14,21
Cork County,2012,40 - 44 years,10,18,28
Cork County,2012,45 - 49 years,17,25,42
Cork County,2012,5 - 9 years,1,3,4
Cork County,2012,50 - 54 years,18,43,61
Cork County,2012,55 - 59 years,33,36,69
Cork County,2012,60 - 64 years,49,80,129
Cork County,2012,65 - 69 years,55,124,179
Cork County,2012,70 - 74 years,68,141,209
Cork County,2012,75 - 79 years,126,159,285
Cork County,2012,80 - 84 years,180,207,387
Cork County,2012,85 years and over,471,306,777
Cork County,2012,Under 1 year,11,9,20
Cork County,2013,1 - 4 years,2,2,4
Cork County,2013,10 - 14 years,1,5,6
Cork County,2013,15 - 19 years,2,1,3
Cork County,2013,20 - 24 years,3,7,10
Cork County,2013,25 - 29 years,2,11,13
Cork County,2013,30 - 34 years,8,7,15
Cork County,2013,35 - 39 years,5,11,16
Cork County,2013,40 - 44 years,12,28,40
Cork County,2013,45 - 49 years,20,36,56
Cork County,2013,5 - 9 years,0,5,5
Cork County,2013,50 - 54 years,19,46,65
Cork County,2013,55 - 59 years,24,46,70
Cork County,2013,60 - 64 years,52,74,126
Cork County,2013,65 - 69 years,76,107,183
Cork County,2013,70 - 74 years,80,121,201
Cork County,2013,75 - 79 years,141,159,300
Cork County,2013,80 - 84 years,200,223,423
Cork County,2013,85 years and over,527,303,830
Cork County,2013,Under 1 year,6,14,20
Cork County,2014,1 - 4 years,2,4,6
Cork County,2014,10 - 14 years,1,6,7
Cork County,2014,15 - 19 years,2,5,7
Cork County,2014,20 - 24 years,1,10,11
Cork County,2014,25 - 29 years,2,8,10
Cork County,2014,30 - 34 years,8,14,22
Cork County,2014,35 - 39 years,14,18,32
Cork County,2014,40 - 44 years,9,14,23
Cork County,2014,45 - 49 years,21,25,46
Cork County,2014,5 - 9 years,0,2,2
Cork County,2014,50 - 54 years,28,42,70
Cork County,2014,55 - 59 years,39,63,102
Cork County,2014,60 - 64 years,39,82,121
Cork County,2014,65 - 69 years,70,122,192
Cork County,2014,70 - 74 years,92,135,227
Cork County,2014,75 - 79 years,139,162,301
Cork County,2014,80 - 84 years,191,198,389
Cork County,2014,85 years and over,489,272,761
Cork County,2014,Under 1 year,7,10,17
Cork County,2015,1 - 4 years,2,3,5
Cork County,2015,10 - 14 years,1,6,7
Cork County,2015,15 - 19 years,2,5,7
Cork County,2015,20 - 24 years,4,9,13
Cork County,2015,25 - 29 years,8,7,15
Cork County,2015,30 - 34 years,5,8,13
Cork County,2015,35 - 39 years,8,12,20
Cork County,2015,40 - 44 years,6,24,30
Cork County,2015,45 - 49 years,16,20,36
Cork County,2015,5 - 9 years,1,1,2
Cork County,2015,50 - 54 years,17,57,74
Cork County,2015,55 - 59 years,45,65,110
Cork County,2015,60 - 64 years,43,61,104
Cork County,2015,65 - 69 years,71,126,197
Cork County,2015,70 - 74 years,82,156,238
Cork County,2015,75 - 79 years,116,163,279
Cork County,2015,80 - 84 years,182,220,402
Cork County,2015,85 years and over,523,325,848
Cork County,2015,Under 1 year,8,5,13
Cork County,2016,1 - 4 years,3,3,6
Cork County,2016,10 - 14 years,1,2,3
Cork County,2016,15 - 19 years,1,6,7
Cork County,2016,20 - 24 years,1,8,9
Cork County,2016,25 - 29 years,3,8,11
Cork County,2016,30 - 34 years,8,13,21
Cork County,2016,35 - 39 years,9,7,16
Cork County,2016,40 - 44 years,11,31,42
Cork County,2016,45 - 49 years,21,31,52
Cork County,2016,5 - 9 years,1,1,2
Cork County,2016,50 - 54 years,33,32,65
Cork County,2016,55 - 59 years,43,56,99
Cork County,2016,60 - 64 years,53,90,143
Cork County,2016,65 - 69 years,70,140,210
Cork County,2016,70 - 74 years,99,164,263
Cork County,2016,75 - 79 years,113,199,312
Cork County,2016,80 - 84 years,200,236,436
Cork County,2016,85 years and over,539,366,905
Cork County,2016,Under 1 year,4,7,11
Cork County,2017,1 - 4 years,1,1,2
Cork County,2017,10 - 14 years,1,1,2
Cork County,2017,15 - 19 years,6,4,10
Cork County,2017,20 - 24 years,1,7,8
Cork County,2017,25 - 29 years,1,7,8
Cork County,2017,30 - 34 years,6,10,16
Cork County,2017,35 - 39 years,12,12,24
Cork County,2017,40 - 44 years,19,20,39
Cork County,2017,45 - 49 years,30,22,52
Cork County,2017,5 - 9 years,1,3,4
Cork County,2017,50 - 54 years,24,48,72
Cork County,2017,55 - 59 years,35,57,92
Cork County,2017,60 - 64 years,78,81,159
Cork County,2017,65 - 69 years,69,106,175
Cork County,2017,70 - 74 years,108,138,246
Cork County,2017,75 - 79 years,128,210,338
Cork County,2017,80 - 84 years,195,210,405
Cork County,2017,85 years and over,595,335,930
Cork County,2017,Under 1 year,6,5,11
Cork County,2018,1 - 4 years,1,1,2
Cork County,2018,10 - 14 years,2,1,3
Cork County,2018,15 - 19 years,1,3,4
Cork County,2018,20 - 24 years,2,7,9
Cork County,2018,25 - 29 years,3,5,8
Cork County,2018,30 - 34 years,4,9,13
Cork County,2018,35 - 39 years,13,8,21
Cork County,2018,40 - 44 years,10,12,22
Cork County,2018,45 - 49 years,16,35,51
Cork County,2018,5 - 9 years,0,1,1
Cork County,2018,50 - 54 years,28,42,70
Cork County,2018,55 - 59 years,32,56,88
Cork County,2018,60 - 64 years,48,90,138
Cork County,2018,65 - 69 years,70,131,201
Cork County,2018,70 - 74 years,107,152,259
Cork County,2018,75 - 79 years,129,201,330
Cork County,2018,80 - 84 years,204,222,426
Cork County,2018,85 years and over,516,380,896
Cork County,2018,Under 1 year,6,6,12
Cork County,2019,1 - 4 years,0,3,3
Cork County,2019,10 - 14 years,1,2,3
Cork County,2019,15 - 19 years,1,7,8
Cork County,2019,20 - 24 years,0,7,7
Cork County,2019,25 - 29 years,2,3,5
Cork County,2019,30 - 34 years,7,7,14
Cork County,2019,35 - 39 years,8,7,15
Cork County,2019,40 - 44 years,13,22,35
Cork County,2019,45 - 49 years,15,42,57
Cork County,2019,5 - 9 years,1,1,2
Cork County,2019,50 - 54 years,27,26,53
Cork County,2019,55 - 59 years,37,57,94
Cork County,2019,60 - 64 years,31,88,119
Cork County,2019,65 - 69 years,93,92,185
Cork County,2019,70 - 74 years,100,167,267
Cork County,2019,75 - 79 years,133,212,345
Cork County,2019,80 - 84 years,204,235,439
Cork County,2019,85 years and over,553,341,894
Cork County,2019,Under 1 year,5,12,17
Cork County,2020,1 - 4 years,0,1,1
Cork County,2020,10 - 14 years,1,1,2
Cork County,2020,15 - 19 years,3,2,5
Cork County,2020,20 - 24 years,1,4,5
Cork County,2020,25 - 29 years,1,3,4
Cork County,2020,30 - 34 years,6,10,16
Cork County,2020,35 - 39 years,13,10,23
Cork County,2020,40 - 44 years,7,14,21
Cork County,2020,45 - 49 years,19,23,42
Cork County,2020,5 - 9 years,2,1,3
Cork County,2020,50 - 54 years,36,47,83
Cork County,2020,55 - 59 years,31,44,75
Cork County,2020,60 - 64 years,50,86,136
Cork County,2020,65 - 69 years,57,127,184
Cork County,2020,70 - 74 years,123,188,311
Cork County,2020,75 - 79 years,125,185,310
Cork County,2020,80 - 84 years,200,224,424
Cork County,2020,85 years and over,553,390,943
Cork County,2020,Under 1 year,6,10,16
Donegal,2007,1 - 4 years,2,1,3
Donegal,2007,10 - 14 years,0,0,0
Donegal,2007,15 - 19 years,3,7,10
Donegal,2007,20 - 24 years,0,2,2
Donegal,2007,25 - 29 years,2,3,5
Donegal,2007,30 - 34 years,2,3,5
Donegal,2007,35 - 39 years,2,4,6
Donegal,2007,40 - 44 years,3,4,7
Donegal,2007,45 - 49 years,8,10,18
Donegal,2007,5 - 9 years,1,0,1
Donegal,2007,50 - 54 years,11,9,20
Donegal,2007,55 - 59 years,19,32,51
Donegal,2007,60 - 64 years,23,24,47
Donegal,2007,65 - 69 years,20,43,63
Donegal,2007,70 - 74 years,45,67,112
Donegal,2007,75 - 79 years,54,79,133
Donegal,2007,80 - 84 years,93,98,191
Donegal,2007,85 years and over,224,145,369
Donegal,2007,Under 1 year,1,6,7
Donegal,2008,1 - 4 years,2,1,3
Donegal,2008,10 - 14 years,0,0,0
Donegal,2008,15 - 19 years,1,2,3
Donegal,2008,20 - 24 years,2,6,8
Donegal,2008,25 - 29 years,4,8,12
Donegal,2008,30 - 34 years,4,6,10
Donegal,2008,35 - 39 years,4,5,9
Donegal,2008,40 - 44 years,6,9,15
Donegal,2008,45 - 49 years,12,5,17
Donegal,2008,5 - 9 years,1,1,2
Donegal,2008,50 - 54 years,5,14,19
Donegal,2008,55 - 59 years,20,26,46
Donegal,2008,60 - 64 years,14,31,45
Donegal,2008,65 - 69 years,28,59,87
Donegal,2008,70 - 74 years,31,57,88
Donegal,2008,75 - 79 years,63,92,155
Donegal,2008,80 - 84 years,86,107,193
Donegal,2008,85 years and over,235,132,367
Donegal,2008,Under 1 year,6,5,11
Donegal,2009,1 - 4 years,2,1,3
Donegal,2009,10 - 14 years,0,1,1
Donegal,2009,15 - 19 years,3,2,5
Donegal,2009,20 - 24 years,2,4,6
Donegal,2009,25 - 29 years,2,5,7
Donegal,2009,30 - 34 years,1,4,5
Donegal,2009,35 - 39 years,3,8,11
Donegal,2009,40 - 44 years,4,7,11
Donegal,2009,45 - 49 years,12,8,20
Donegal,2009,5 - 9 years,1,1,2
Donegal,2009,50 - 54 years,8,22,30
Donegal,2009,55 - 59 years,19,25,44
Donegal,2009,60 - 64 years,29,46,75
Donegal,2009,65 - 69 years,37,41,78
Donegal,2009,70 - 74 years,39,64,103
Donegal,2009,75 - 79 years,59,73,132
Donegal,2009,80 - 84 years,73,102,175
Donegal,2009,85 years and over,230,142,372
Donegal,2009,Under 1 year,3,6,9
Donegal,2010,1 - 4 years,1,2,3
Donegal,2010,10 - 14 years,1,1,2
Donegal,2010,15 - 19 years,3,2,5
Donegal,2010,20 - 24 years,2,3,5
Donegal,2010,25 - 29 years,3,1,4
Donegal,2010,30 - 34 years,1,3,4
Donegal,2010,35 - 39 years,3,9,12
Donegal,2010,40 - 44 years,5,5,10
Donegal,2010,45 - 49 years,1,5,6
Donegal,2010,5 - 9 years,1,1,2
Donegal,2010,50 - 54 years,10,12,22
Donegal,2010,55 - 59 years,26,30,56
Donegal,2010,60 - 64 years,27,38,65
Donegal,2010,65 - 69 years,32,60,92
Donegal,2010,70 - 74 years,47,69,116
Donegal,2010,75 - 79 years,57,79,136
Donegal,2010,80 - 84 years,89,92,181
Donegal,2010,85 years and over,235,141,376
Donegal,2010,Under 1 year,2,4,6
Donegal,2011,1 - 4 years,0,1,1
Donegal,2011,10 - 14 years,0,0,0
Donegal,2011,15 - 19 years,1,3,4
Donegal,2011,20 - 24 years,1,5,6
Donegal,2011,25 - 29 years,1,0,1
Donegal,2011,30 - 34 years,2,5,7
Donegal,2011,35 - 39 years,4,5,9
Donegal,2011,40 - 44 years,6,10,16
Donegal,2011,45 - 49 years,4,13,17
Donegal,2011,5 - 9 years,1,1,2
Donegal,2011,50 - 54 years,8,20,28
Donegal,2011,55 - 59 years,9,25,34
Donegal,2011,60 - 64 years,32,50,82
Donegal,2011,65 - 69 years,31,38,69
Donegal,2011,70 - 74 years,46,70,116
Donegal,2011,75 - 79 years,42,81,123
Donegal,2011,80 - 84 years,87,98,185
Donegal,2011,85 years and over,203,152,355
Donegal,2011,Under 1 year,2,4,6
Donegal,2012,1 - 4 years,0,1,1
Donegal,2012,10 - 14 years,1,1,2
Donegal,2012,15 - 19 years,3,1,4
Donegal,2012,20 - 24 years,2,2,4
Donegal,2012,25 - 29 years,1,6,7
Donegal,2012,30 - 34 years,4,5,9
Donegal,2012,35 - 39 years,1,3,4
Donegal,2012,40 - 44 years,5,5,10
Donegal,2012,45 - 49 years,5,10,15
Donegal,2012,5 - 9 years,1,1,2
Donegal,2012,50 - 54 years,11,12,23
Donegal,2012,55 - 59 years,7,27,34
Donegal,2012,60 - 64 years,31,41,72
Donegal,2012,65 - 69 years,27,55,82
Donegal,2012,70 - 74 years,36,68,104
Donegal,2012,75 - 79 years,64,96,160
Donegal,2012,80 - 84 years,94,101,195
Donegal,2012,85 years and over,251,152,403
Donegal,2012,Under 1 year,7,4,11
Donegal,2013,1 - 4 years,0,1,1
Donegal,2013,10 - 14 years,0,1,1
Donegal,2013,15 - 19 years,0,1,1
Donegal,2013,20 - 24 years,0,1,1
Donegal,2013,25 - 29 years,0,4,4
Donegal,2013,30 - 34 years,1,9,10
Donegal,2013,35 - 39 years,2,1,3
Donegal,2013,40 - 44 years,5,5,10
Donegal,2013,45 - 49 years,10,9,19
Donegal,2013,5 - 9 years,1,1,2
Donegal,2013,50 - 54 years,11,9,20
Donegal,2013,55 - 59 years,13,26,39
Donegal,2013,60 - 64 years,30,42,72
Donegal,2013,65 - 69 years,29,50,79
Donegal,2013,70 - 74 years,43,69,112
Donegal,2013,75 - 79 years,53,69,122
Donegal,2013,80 - 84 years,76,99,175
Donegal,2013,85 years and over,256,186,442
Donegal,2013,Under 1 year,4,6,10
Donegal,2014,1 - 4 years,1,1,2
Donegal,2014,10 - 14 years,0,1,1
Donegal,2014,15 - 19 years,1,1,2
Donegal,2014,20 - 24 years,0,2,2
Donegal,2014,25 - 29 years,3,2,5
Donegal,2014,30 - 34 years,1,4,5
Donegal,2014,35 - 39 years,3,4,7
Donegal,2014,40 - 44 years,3,7,10
Donegal,2014,45 - 49 years,6,8,14
Donegal,2014,5 - 9 years,1,1,2
Donegal,2014,50 - 54 years,9,17,26
Donegal,2014,55 - 59 years,13,23,36
Donegal,2014,60 - 64 years,20,37,57
Donegal,2014,65 - 69 years,43,62,105
Donegal,2014,70 - 74 years,44,72,116
Donegal,2014,75 - 79 years,53,92,145
Donegal,2014,80 - 84 years,81,88,169
Donegal,2014,85 years and over,244,167,411
Donegal,2014,Under 1 year,2,7,9
Donegal,2015,1 - 4 years,1,1,2
Donegal,2015,10 - 14 years,0,1,1
Donegal,2015,15 - 19 years,1,1,2
Donegal,2015,20 - 24 years,2,3,5
Donegal,2015,25 - 29 years,2,2,4
Donegal,2015,30 - 34 years,5,4,9
Donegal,2015,35 - 39 years,3,5,8
Donegal,2015,40 - 44 years,4,5,9
Donegal,2015,45 - 49 years,6,15,21
Donegal,2015,5 - 9 years,1,1,2
Donegal,2015,50 - 54 years,4,15,19
Donegal,2015,55 - 59 years,17,20,37
Donegal,2015,60 - 64 years,15,45,60
Donegal,2015,65 - 69 years,27,42,69
Donegal,2015,70 - 74 years,40,77,117
Donegal,2015,75 - 79 years,59,85,144
Donegal,2015,80 - 84 years,86,114,200
Donegal,2015,85 years and over,259,171,430
Donegal,2015,Under 1 year,4,7,11
Donegal,2016,1 - 4 years,1,2,3
Donegal,2016,10 - 14 years,0,1,1
Donegal,2016,15 - 19 years,1,3,4
Donegal,2016,20 - 24 years,1,3,4
Donegal,2016,25 - 29 years,2,2,4
Donegal,2016,30 - 34 years,2,4,6
Donegal,2016,35 - 39 years,2,7,9
Donegal,2016,40 - 44 years,8,4,12
Donegal,2016,45 - 49 years,7,9,16
Donegal,2016,5 - 9 years,1,1,2
Donegal,2016,50 - 54 years,11,13,24
Donegal,2016,55 - 59 years,15,26,41
Donegal,2016,60 - 64 years,23,28,51
Donegal,2016,65 - 69 years,31,52,83
Donegal,2016,70 - 74 years,55,72,127
Donegal,2016,75 - 79 years,68,75,143
Donegal,2016,80 - 84 years,84,93,177
Donegal,2016,85 years and over,257,169,426
Donegal,2016,Under 1 year,2,5,7
Donegal,2017,1 - 4 years,1,1,2
Donegal,2017,10 - 14 years,0,1,1
Donegal,2017,15 - 19 years,1,1,2
Donegal,2017,20 - 24 years,1,2,3
Donegal,2017,25 - 29 years,2,2,4
Donegal,2017,30 - 34 years,1,3,4
Donegal,2017,35 - 39 years,2,4,6
Donegal,2017,40 - 44 years,3,3,6
Donegal,2017,45 - 49 years,4,20,24
Donegal,2017,5 - 9 years,1,1,2
Donegal,2017,50 - 54 years,11,15,26
Donegal,2017,55 - 59 years,9,16,25
Donegal,2017,60 - 64 years,18,36,54
Donegal,2017,65 - 69 years,41,55,96
Donegal,2017,70 - 74 years,49,86,135
Donegal,2017,75 - 79 years,66,89,155
Donegal,2017,80 - 84 years,89,114,203
Donegal,2017,85 years and over,255,184,439
Donegal,2017,Under 1 year,6,5,11
Donegal,2018,1 - 4 years,1,0,1
Donegal,2018,10 - 14 years,0,0,0
Donegal,2018,15 - 19 years,0,0,0
Donegal,2018,20 - 24 years,1,2,3
Donegal,2018,25 - 29 years,1,3,4
Donegal,2018,30 - 34 years,4,1,5
Donegal,2018,35 - 39 years,0,5,5
Donegal,2018,40 - 44 years,4,3,7
Donegal,2018,45 - 49 years,10,9,19
Donegal,2018,5 - 9 years,0,0,0
Donegal,2018,50 - 54 years,12,19,31
Donegal,2018,55 - 59 years,20,21,41
Donegal,2018,60 - 64 years,17,32,49
Donegal,2018,65 - 69 years,37,54,91
Donegal,2018,70 - 74 years,47,68,115
Donegal,2018,75 - 79 years,67,99,166
Donegal,2018,80 - 84 years,102,101,203
Donegal,2018,85 years and over,261,173,434
Donegal,2018,Under 1 year,2,2,4
Donegal,2019,1 - 4 years,2,2,4
Donegal,2019,10 - 14 years,0,0,0
Donegal,2019,15 - 19 years,2,2,4
Donegal,2019,20 - 24 years,3,3,6
Donegal,2019,25 - 29 years,2,2,4
Donegal,2019,30 - 34 years,2,2,4
Donegal,2019,35 - 39 years,2,2,4
Donegal,2019,40 - 44 years,7,7,14
Donegal,2019,45 - 49 years,15,15,30
Donegal,2019,5 - 9 years,0,0,0
Donegal,2019,50 - 54 years,19,19,38
Donegal,2019,55 - 59 years,20,20,40
Donegal,2019,60 - 64 years,37,37,74
Donegal,2019,65 - 69 years,59,59,118
Donegal,2019,70 - 74 years,89,89,178
Donegal,2019,75 - 79 years,80,80,160
Donegal,2019,80 - 84 years,95,95,190
Donegal,2019,85 years and over,205,205,410
Donegal,2019,Under 1 year,1,1,2
Donegal,2020,1 - 4 years,2,1,3
Donegal,2020,10 - 14 years,0,0,0
Donegal,2020,15 - 19 years,2,1,3
Donegal,2020,20 - 24 years,3,1,4
Donegal,2020,25 - 29 years,1,2,3
Donegal,2020,30 - 34 years,2,3,5
Donegal,2020,35 - 39 years,2,5,7
Donegal,2020,40 - 44 years,4,6,10
Donegal,2020,45 - 49 years,7,6,13
Donegal,2020,5 - 9 years,0,0,0
Donegal,2020,50 - 54 years,11,7,18
Donegal,2020,55 - 59 years,21,21,42
Donegal,2020,60 - 64 years,23,27,50
Donegal,2020,65 - 69 years,30,50,80
Donegal,2020,70 - 74 years,43,80,123
Donegal,2020,75 - 79 years,68,101,169
Donegal,2020,80 - 84 years,91,113,204
Donegal,2020,85 years and over,248,202,450
Donegal,2020,Under 1 year,3,1,4
Drogheda Borough,2007,1 - 4 years,0,0,0
Drogheda Borough,2007,10 - 14 years,0,0,0
Drogheda Borough,2007,15 - 19 years,0,0,0
Drogheda Borough,2007,20 - 24 years,2,4,6
Drogheda Borough,2007,25 - 29 years,0,3,3
Drogheda Borough,2007,30 - 34 years,3,2,5
Drogheda Borough,2007,35 - 39 years,1,4,5
Drogheda Borough,2007,40 - 44 years,3,4,7
Drogheda Borough,2007,45 - 49 years,3,3,6
Drogheda Borough,2007,5 - 9 years,0,0,0
Drogheda Borough,2007,50 - 54 years,2,2,4
Drogheda Borough,2007,55 - 59 years,4,6,10
Drogheda Borough,2007,60 - 64 years,11,9,20
Drogheda Borough,2007,65 - 69 years,13,10,23
Drogheda Borough,2007,70 - 74 years,12,9,21
Drogheda Borough,2007,75 - 79 years,9,15,24
Drogheda Borough,2007,80 - 84 years,21,13,34
Drogheda Borough,2007,85 years and over,27,14,41
Drogheda Borough,2007,Under 1 year,1,1,2
Drogheda Borough,2008,1 - 4 years,0,0,0
Drogheda Borough,2008,10 - 14 years,0,0,0
Drogheda Borough,2008,15 - 19 years,0,0,0
Drogheda Borough,2008,20 - 24 years,2,2,4
Drogheda Borough,2008,25 - 29 years,1,5,6
Drogheda Borough,2008,30 - 34 years,3,1,4
Drogheda Borough,2008,35 - 39 years,2,2,4
Drogheda Borough,2008,40 - 44 years,1,4,5
Drogheda Borough,2008,45 - 49 years,2,5,7
Drogheda Borough,2008,5 - 9 years,0,0,0
Drogheda Borough,2008,50 - 54 years,4,8,12
Drogheda Borough,2008,55 - 59 years,2,9,11
Drogheda Borough,2008,60 - 64 years,2,9,11
Drogheda Borough,2008,65 - 69 years,4,8,12
Drogheda Borough,2008,70 - 74 years,10,9,19
Drogheda Borough,2008,75 - 79 years,16,9,25
Drogheda Borough,2008,80 - 84 years,14,16,30
Drogheda Borough,2008,85 years and over,40,18,58
Drogheda Borough,2008,Under 1 year,2,1,3
Drogheda Borough,2009,1 - 4 years,1,0,1
Drogheda Borough,2009,10 - 14 years,0,0,0
Drogheda Borough,2009,15 - 19 years,0,1,1
Drogheda Borough,2009,20 - 24 years,2,3,5
Drogheda Borough,2009,25 - 29 years,1,2,3
Drogheda Borough,2009,30 - 34 years,3,3,6
Drogheda Borough,2009,35 - 39 years,2,4,6
Drogheda Borough,2009,40 - 44 years,1,2,3
Drogheda Borough,2009,45 - 49 years,2,4,6
Drogheda Borough,2009,5 - 9 years,0,1,1
Drogheda Borough,2009,50 - 54 years,1,5,6
Drogheda Borough,2009,55 - 59 years,2,6,8
Drogheda Borough,2009,60 - 64 years,5,9,14
Drogheda Borough,2009,65 - 69 years,5,13,18
Drogheda Borough,2009,70 - 74 years,10,11,21
Drogheda Borough,2009,75 - 79 years,10,17,27
Drogheda Borough,2009,80 - 84 years,23,17,40
Drogheda Borough,2009,85 years and over,37,18,55
Drogheda Borough,2009,Under 1 year,1,1,2
Drogheda Borough,2010,1 - 4 years,1,0,1
Drogheda Borough,2010,10 - 14 years,0,0,0
Drogheda Borough,2010,15 - 19 years,1,2,3
Drogheda Borough,2010,20 - 24 years,2,3,5
Drogheda Borough,2010,25 - 29 years,1,2,3
Drogheda Borough,2010,30 - 34 years,1,2,3
Drogheda Borough,2010,35 - 39 years,2,4,6
Drogheda Borough,2010,40 - 44 years,1,5,6
Drogheda Borough,2010,45 - 49 years,1,1,2
Drogheda Borough,2010,5 - 9 years,0,1,1
Drogheda Borough,2010,50 - 54 years,2,1,3
Drogheda Borough,2010,55 - 59 years,4,3,7
Drogheda Borough,2010,60 - 64 years,3,11,14
Drogheda Borough,2010,65 - 69 years,7,7,14
Drogheda Borough,2010,70 - 74 years,14,14,28
Drogheda Borough,2010,75 - 79 years,13,14,27
Drogheda Borough,2010,80 - 84 years,24,15,39
Drogheda Borough,2010,85 years and over,36,13,49
Drogheda Borough,2010,Under 1 year,1,1,2
Drogheda Borough,2011,1 - 4 years,0,1,1
Drogheda Borough,2011,10 - 14 years,0,0,0
Drogheda Borough,2011,15 - 19 years,0,1,1
Drogheda Borough,2011,20 - 24 years,0,2,2
Drogheda Borough,2011,25 - 29 years,1,2,3
Drogheda Borough,2011,30 - 34 years,0,2,2
Drogheda Borough,2011,35 - 39 years,1,3,4
Drogheda Borough,2011,40 - 44 years,1,2,3
Drogheda Borough,2011,45 - 49 years,1,3,4
Drogheda Borough,2011,5 - 9 years,0,0,0
Drogheda Borough,2011,50 - 54 years,2,2,4
Drogheda Borough,2011,55 - 59 years,7,7,14
Drogheda Borough,2011,60 - 64 years,4,6,10
Drogheda Borough,2011,65 - 69 years,4,12,16
Drogheda Borough,2011,70 - 74 years,12,15,27
Drogheda Borough,2011,75 - 79 years,13,11,24
Drogheda Borough,2011,80 - 84 years,13,4,17
Drogheda Borough,2011,85 years and over,40,18,58
Drogheda Borough,2011,Under 1 year,1,1,2
Drogheda Borough,2012,1 - 4 years,0,1,1
Drogheda Borough,2012,10 - 14 years,0,0,0
Drogheda Borough,2012,15 - 19 years,0,1,1
Drogheda Borough,2012,20 - 24 years,0,2,2
Drogheda Borough,2012,25 - 29 years,1,2,3
Drogheda Borough,2012,30 - 34 years,3,2,5
Drogheda Borough,2012,35 - 39 years,1,1,2
Drogheda Borough,2012,40 - 44 years,1,6,7
Drogheda Borough,2012,45 - 49 years,5,5,10
Drogheda Borough,2012,5 - 9 years,0,0,0
Drogheda Borough,2012,50 - 54 years,4,3,7
Drogheda Borough,2012,55 - 59 years,4,7,11
Drogheda Borough,2012,60 - 64 years,7,7,14
Drogheda Borough,2012,65 - 69 years,7,6,13
Drogheda Borough,2012,70 - 74 years,4,13,17
Drogheda Borough,2012,75 - 79 years,21,16,37
Drogheda Borough,2012,80 - 84 years,16,9,25
Drogheda Borough,2012,85 years and over,50,14,64
Drogheda Borough,2012,Under 1 year,1,1,2
Drogheda Borough,2013,1 - 4 years,0,0,0
Drogheda Borough,2013,10 - 14 years,1,0,1
Drogheda Borough,2013,15 - 19 years,0,0,0
Drogheda Borough,2013,20 - 24 years,0,1,1
Drogheda Borough,2013,25 - 29 years,0,1,1
Drogheda Borough,2013,30 - 34 years,1,3,4
Drogheda Borough,2013,35 - 39 years,0,1,1
Drogheda Borough,2013,40 - 44 years,1,6,7
Drogheda Borough,2013,45 - 49 years,2,3,5
Drogheda Borough,2013,5 - 9 years,0,0,0
Drogheda Borough,2013,50 - 54 years,6,4,10
Drogheda Borough,2013,55 - 59 years,3,6,9
Drogheda Borough,2013,60 - 64 years,5,4,9
Drogheda Borough,2013,65 - 69 years,4,13,17
Drogheda Borough,2013,70 - 74 years,13,18,31
Drogheda Borough,2013,75 - 79 years,7,13,20
Drogheda Borough,2013,80 - 84 years,19,15,34
Drogheda Borough,2013,85 years and over,32,15,47
Drogheda Borough,2013,Under 1 year,0,0,0
Drogheda Borough,2014,1 - 4 years,0,0,0
Drogheda Borough,2014,10 - 14 years,1,1,2
Drogheda Borough,2014,15 - 19 years,0,0,0
Drogheda Borough,2014,20 - 24 years,1,1,2
Drogheda Borough,2014,25 - 29 years,0,1,1
Drogheda Borough,2014,30 - 34 years,1,3,4
Drogheda Borough,2014,35 - 39 years,0,1,1
Drogheda Borough,2014,40 - 44 years,1,3,4
Drogheda Borough,2014,45 - 49 years,2,2,4
Drogheda Borough,2014,5 - 9 years,0,0,0
Drogheda Borough,2014,50 - 54 years,1,6,7
Drogheda Borough,2014,55 - 59 years,1,4,5
Drogheda Borough,2014,60 - 64 years,6,14,20
Drogheda Borough,2014,65 - 69 years,6,11,17
Drogheda Borough,2014,70 - 74 years,16,12,28
Drogheda Borough,2014,75 - 79 years,13,18,31
Drogheda Borough,2014,80 - 84 years,8,11,19
Drogheda Borough,2014,85 years and over,44,19,63
Drogheda Borough,2014,Under 1 year,0,1,1
Drogheda Borough,2015,1 - 4 years,0,0,0
Drogheda Borough,2015,10 - 14 years,1,1,2
Drogheda Borough,2015,15 - 19 years,0,0,0
Drogheda Borough,2015,20 - 24 years,1,1,2
Drogheda Borough,2015,25 - 29 years,0,1,1
Drogheda Borough,2015,30 - 34 years,1,3,4
Drogheda Borough,2015,35 - 39 years,0,1,1
Drogheda Borough,2015,40 - 44 years,1,3,4
Drogheda Borough,2015,45 - 49 years,2,2,4
Drogheda Borough,2015,5 - 9 years,0,0,0
Drogheda Borough,2015,50 - 54 years,1,6,7
Drogheda Borough,2015,55 - 59 years,1,4,5
Drogheda Borough,2015,60 - 64 years,6,14,20
Drogheda Borough,2015,65 - 69 years,6,11,17
Drogheda Borough,2015,70 - 74 years,16,12,28
Drogheda Borough,2015,75 - 79 years,13,18,31
Drogheda Borough,2015,80 - 84 years,8,11,19
Drogheda Borough,2015,85 years and over,44,19,63
Drogheda Borough,2015,Under 1 year,0,1,1
Drogheda Borough,2016,1 - 4 years,0,0,0
Drogheda Borough,2016,10 - 14 years,1,1,2
Drogheda Borough,2016,15 - 19 years,0,0,0
Drogheda Borough,2016,20 - 24 years,1,1,2
Drogheda Borough,2016,25 - 29 years,0,1,1
Drogheda Borough,2016,30 - 34 years,1,3,4
Drogheda Borough,2016,35 - 39 years,0,1,1
Drogheda Borough,2016,40 - 44 years,1,3,4
Drogheda Borough,2016,45 - 49 years,2,2,4
Drogheda Borough,2016,5 - 9 years,0,0,0
Drogheda Borough,2016,50 - 54 years,1,6,7
Drogheda Borough,2016,55 - 59 years,1,4,5
Drogheda Borough,2016,60 - 64 years,6,14,20
Drogheda Borough,2016,65 - 69 years,6,11,17
Drogheda Borough,2016,70 - 74 years,16,12,28
Drogheda Borough,2016,75 - 79 years,13,18,31
Drogheda Borough,2016,80 - 84 years,8,11,19
Drogheda Borough,2016,85 years and over,44,19,63
Drogheda Borough,2016,Under 1 year,0,1,1
Drogheda Borough,2017,1 - 4 years,1,0,1
Drogheda Borough,2017,10 - 14 years,1,1,2
Drogheda Borough,2017,15 - 19 years,1,0,1
Drogheda Borough,2017,20 - 24 years,1,1,2
Drogheda Borough,2017,25 - 29 years,1,1,2
Drogheda Borough,2017,30 - 34 years,1,3,4
Drogheda Borough,2017,35 - 39 years,0,2,2
Drogheda Borough,2017,40 - 44 years,1,3,4
Drogheda Borough,2017,45 - 49 years,2,1,3
Drogheda Borough,2017,5 - 9 years,0,0,0
Drogheda Borough,2017,50 - 54 years,3,4,7
Drogheda Borough,2017,55 - 59 years,4,4,8
Drogheda Borough,2017,60 - 64 years,4,2,6
Drogheda Borough,2017,65 - 69 years,12,12,24
Drogheda Borough,2017,70 - 74 years,13,13,26
Drogheda Borough,2017,75 - 79 years,11,28,39
Drogheda Borough,2017,80 - 84 years,17,21,38
Drogheda Borough,2017,85 years and over,40,22,62
Drogheda Borough,2017,Under 1 year,0,1,1
Drogheda Borough,2018,1 - 4 years,0,0,0
Drogheda Borough,2018,10 - 14 years,0,1,1
Drogheda Borough,2018,15 - 19 years,0,1,1
Drogheda Borough,2018,20 - 24 years,0,0,0
Drogheda Borough,2018,25 - 29 years,0,2,2
Drogheda Borough,2018,30 - 34 years,2,0,2
Drogheda Borough,2018,35 - 39 years,1,1,2
Drogheda Borough,2018,40 - 44 years,4,3,7
Drogheda Borough,2018,45 - 49 years,2,0,2
Drogheda Borough,2018,5 - 9 years,0,0,0
Drogheda Borough,2018,50 - 54 years,4,4,8
Drogheda Borough,2018,55 - 59 years,0,6,6
Drogheda Borough,2018,60 - 64 years,7,8,15
Drogheda Borough,2018,65 - 69 years,5,1,6
Drogheda Borough,2018,70 - 74 years,10,12,22
Drogheda Borough,2018,75 - 79 years,19,26,45
Drogheda Borough,2018,80 - 84 years,19,22,41
Drogheda Borough,2018,85 years and over,45,24,69
Drogheda Borough,2018,Under 1 year,0,1,1
Drogheda Borough,2019,1 - 4 years,0,0,0
Drogheda Borough,2019,10 - 14 years,0,1,1
Drogheda Borough,2019,15 - 19 years,0,1,1
Drogheda Borough,2019,20 - 24 years,0,0,0
Drogheda Borough,2019,25 - 29 years,0,2,2
Drogheda Borough,2019,30 - 34 years,2,0,2
Drogheda Borough,2019,35 - 39 years,1,1,2
Drogheda Borough,2019,40 - 44 years,4,3,7
Drogheda Borough,2019,45 - 49 years,2,0,2
Drogheda Borough,2019,5 - 9 years,0,0,0
Drogheda Borough,2019,50 - 54 years,4,4,8
Drogheda Borough,2019,55 - 59 years,0,6,6
Drogheda Borough,2019,60 - 64 years,7,8,15
Drogheda Borough,2019,65 - 69 years,5,1,6
Drogheda Borough,2019,70 - 74 years,10,12,22
Drogheda Borough,2019,75 - 79 years,19,26,45
Drogheda Borough,2019,80 - 84 years,19,22,41
Drogheda Borough,2019,85 years and over,45,24,69
Drogheda Borough,2019,Under 1 year,0,1,1
Drogheda Borough,2020,1 - 4 years,0,0,0
Drogheda Borough,2020,10 - 14 years,0,1,1
Drogheda Borough,2020,15 - 19 years,0,1,1
Drogheda Borough,2020,20 - 24 years,0,0,0
Drogheda Borough,2020,25 - 29 years,0,2,2
Drogheda Borough,2020,30 - 34 years,2,0,2
Drogheda Borough,2020,35 - 39 years,1,1,2
Drogheda Borough,2020,40 - 44 years,4,3,7
Drogheda Borough,2020,45 - 49 years,2,0,2
Drogheda Borough,2020,5 - 9 years,0,0,0
Drogheda Borough,2020,50 - 54 years,4,4,8
Drogheda Borough,2020,55 - 59 years,0,6,6
Drogheda Borough,2020,60 - 64 years,7,8,15
Drogheda Borough,2020,65 - 69 years,5,1,6
Drogheda Borough,2020,70 - 74 years,10,12,22
Drogheda Borough,2020,75 - 79 years,19,26,45
Drogheda Borough,2020,80 - 84 years,19,22,41
Drogheda Borough,2020,85 years and over,45,24,69
Drogheda Borough,2020,Under 1 year,0,1,1
Dublin City,2007,1 - 4 years,1,1,2
Dublin City,2007,10 - 14 years,0,2,2
Dublin City,2007,15 - 19 years,2,8,10
Dublin City,2007,20 - 24 years,1,23,24
Dublin City,2007,25 - 29 years,15,28,43
Dublin City,2007,30 - 34 years,15,37,52
Dublin City,2007,35 - 39 years,30,34,64
Dublin City,2007,40 - 44 years,26,52,78
Dublin City,2007,45 - 49 years,36,72,108
Dublin City,2007,5 - 9 years,0,1,1
Dublin City,2007,50 - 54 years,49,79,128
Dublin City,2007,55 - 59 years,69,109,178
Dublin City,2007,60 - 64 years,99,152,251
Dublin City,2007,65 - 69 years,126,210,336
Dublin City,2007,70 - 74 years,215,284,499
Dublin City,2007,75 - 79 years,304,294,598
Dublin City,2007,80 - 84 years,420,325,745
Dublin City,2007,85 years and over,793,345,1138
Dublin City,2007,Under 1 year,16,9,25
Dublin City,2008,1 - 4 years,6,4,10
Dublin City,2008,10 - 14 years,1,1,2
Dublin City,2008,15 - 19 years,2,13,15
Dublin City,2008,20 - 24 years,7,24,31
Dublin City,2008,25 - 29 years,13,33,46
Dublin City,2008,30 - 34 years,8,48,56
Dublin City,2008,35 - 39 years,15,38,53
Dublin City,2008,40 - 44 years,22,55,77
Dublin City,2008,45 - 49 years,40,52,92
Dublin City,2008,5 - 9 years,0,3,3
Dublin City,2008,50 - 54 years,47,69,116
Dublin City,2008,55 - 59 years,65,122,187
Dublin City,2008,60 - 64 years,78,137,215
Dublin City,2008,65 - 69 years,115,174,289
Dublin City,2008,70 - 74 years,193,260,453
Dublin City,2008,75 - 79 years,290,298,588
Dublin City,2008,80 - 84 years,433,317,750
Dublin City,2008,85 years and over,815,344,1159
Dublin City,2008,Under 1 year,12,15,27
Dublin City,2009,1 - 4 years,3,1,4
Dublin City,2009,10 - 14 years,1,1,2
Dublin City,2009,15 - 19 years,2,15,17
Dublin City,2009,20 - 24 years,6,27,33
Dublin City,2009,25 - 29 years,10,35,45
Dublin City,2009,30 - 34 years,16,32,48
Dublin City,2009,35 - 39 years,19,35,54
Dublin City,2009,40 - 44 years,20,46,66
Dublin City,2009,45 - 49 years,41,66,107
Dublin City,2009,5 - 9 years,3,1,4
Dublin City,2009,50 - 54 years,44,75,119
Dublin City,2009,55 - 59 years,77,99,176
Dublin City,2009,60 - 64 years,100,140,240
Dublin City,2009,65 - 69 years,126,187,313
Dublin City,2009,70 - 74 years,183,224,407
Dublin City,2009,75 - 79 years,289,309,598
Dublin City,2009,80 - 84 years,386,346,732
Dublin City,2009,85 years and over,823,391,1214
Dublin City,2009,Under 1 year,5,14,19
Dublin City,2010,1 - 4 years,1,1,2
Dublin City,2010,10 - 14 years,1,4,5
Dublin City,2010,15 - 19 years,1,6,7
Dublin City,2010,20 - 24 years,3,20,23
Dublin City,2010,25 - 29 years,12,25,37
Dublin City,2010,30 - 34 years,15,39,54
Dublin City,2010,35 - 39 years,16,33,49
Dublin City,2010,40 - 44 years,29,37,66
Dublin City,2010,45 - 49 years,35,69,104
Dublin City,2010,5 - 9 years,3,2,5
Dublin City,2010,50 - 54 years,48,83,131
Dublin City,2010,55 - 59 years,63,95,158
Dublin City,2010,60 - 64 years,98,148,246
Dublin City,2010,65 - 69 years,125,204,329
Dublin City,2010,70 - 74 years,179,206,385
Dublin City,2010,75 - 79 years,266,296,562
Dublin City,2010,80 - 84 years,389,306,695
Dublin City,2010,85 years and over,818,382,1200
Dublin City,2010,Under 1 year,5,21,26
Dublin City,2011,1 - 4 years,0,0,0
Dublin City,2011,10 - 14 years,1,1,2
Dublin City,2011,15 - 19 years,5,12,17
Dublin City,2011,20 - 24 years,2,20,22
Dublin City,2011,25 - 29 years,7,25,32
Dublin City,2011,30 - 34 years,12,30,42
Dublin City,2011,35 - 39 years,16,33,49
Dublin City,2011,40 - 44 years,22,64,86
Dublin City,2011,45 - 49 years,39,64,103
Dublin City,2011,5 - 9 years,0,2,2
Dublin City,2011,50 - 54 years,37,82,119
Dublin City,2011,55 - 59 years,73,106,179
Dublin City,2011,60 - 64 years,101,137,238
Dublin City,2011,65 - 69 years,111,188,299
Dublin City,2011,70 - 74 years,169,208,377
Dublin City,2011,75 - 79 years,279,296,575
Dublin City,2011,80 - 84 years,362,310,672
Dublin City,2011,85 years and over,896,396,1292
Dublin City,2011,Under 1 year,10,11,21
Dublin City,2012,1 - 4 years,2,2,4
Dublin City,2012,10 - 14 years,1,1,2
Dublin City,2012,15 - 19 years,3,6,9
Dublin City,2012,20 - 24 years,3,13,16
Dublin City,2012,25 - 29 years,10,24,34
Dublin City,2012,30 - 34 years,16,35,51
Dublin City,2012,35 - 39 years,20,41,61
Dublin City,2012,40 - 44 years,17,51,68
Dublin City,2012,45 - 49 years,32,67,99
Dublin City,2012,5 - 9 years,0,1,1
Dublin City,2012,50 - 54 years,46,96,142
Dublin City,2012,55 - 59 years,62,101,163
Dublin City,2012,60 - 64 years,94,137,231
Dublin City,2012,65 - 69 years,117,166,283
Dublin City,2012,70 - 74 years,171,222,393
Dublin City,2012,75 - 79 years,244,273,517
Dublin City,2012,80 - 84 years,371,327,698
Dublin City,2012,85 years and over,841,442,1283
Dublin City,2012,Under 1 year,10,17,27
Dublin City,2013,1 - 4 years,3,3,6
Dublin City,2013,10 - 14 years,0,0,0
Dublin City,2013,15 - 19 years,3,3,6
Dublin City,2013,20 - 24 years,4,19,23
Dublin City,2013,25 - 29 years,10,11,21
Dublin City,2013,30 - 34 years,15,25,40
Dublin City,2013,35 - 39 years,14,22,36
Dublin City,2013,40 - 44 years,21,37,58
Dublin City,2013,45 - 49 years,23,55,78
Dublin City,2013,5 - 9 years,2,0,2
Dublin City,2013,50 - 54 years,54,79,133
Dublin City,2013,55 - 59 years,73,89,162
Dublin City,2013,60 - 64 years,83,123,206
Dublin City,2013,65 - 69 years,118,150,268
Dublin City,2013,70 - 74 years,177,206,383
Dublin City,2013,75 - 79 years,232,275,507
Dublin City,2013,80 - 84 years,423,319,742
Dublin City,2013,85 years and over,944,448,1392
Dublin City,2013,Under 1 year,12,17,29
Dublin City,2014,1 - 4 years,3,4,7
Dublin City,2014,10 - 14 years,0,1,1
Dublin City,2014,15 - 19 years,3,3,6
Dublin City,2014,20 - 24 years,2,13,15
Dublin City,2014,25 - 29 years,5,23,28
Dublin City,2014,30 - 34 years,9,24,33
Dublin City,2014,35 - 39 years,11,26,37
Dublin City,2014,40 - 44 years,17,34,51
Dublin City,2014,45 - 49 years,20,46,66
Dublin City,2014,5 - 9 years,2,0,2
Dublin City,2014,50 - 54 years,36,67,103
Dublin City,2014,55 - 59 years,67,103,170
Dublin City,2014,60 - 64 years,82,129,211
Dublin City,2014,65 - 69 years,125,148,273
Dublin City,2014,70 - 74 years,173,211,384
Dublin City,2014,75 - 79 years,249,271,520
Dublin City,2014,80 - 84 years,353,339,692
Dublin City,2014,85 years and over,935,473,1408
Dublin City,2014,Under 1 year,5,15,20
Dublin City,2015,1 - 4 years,3,2,5
Dublin City,2015,10 - 14 years,0,3,3
Dublin City,2015,15 - 19 years,3,4,7
Dublin City,2015,20 - 24 years,3,6,9
Dublin City,2015,25 - 29 years,5,11,16
Dublin City,2015,30 - 34 years,9,14,23
Dublin City,2015,35 - 39 years,21,25,46
Dublin City,2015,40 - 44 years,22,44,66
Dublin City,2015,45 - 49 years,38,57,95
Dublin City,2015,5 - 9 years,1,3,4
Dublin City,2015,50 - 54 years,50,64,114
Dublin City,2015,55 - 59 years,76,109,185
Dublin City,2015,60 - 64 years,88,115,203
Dublin City,2015,65 - 69 years,109,162,271
Dublin City,2015,70 - 74 years,183,193,376
Dublin City,2015,75 - 79 years,278,290,568
Dublin City,2015,80 - 84 years,417,343,760
Dublin City,2015,85 years and over,1039,549,1588
Dublin City,2015,Under 1 year,10,9,19
Dublin City,2016,1 - 4 years,3,2,5
Dublin City,2016,10 - 14 years,0,2,2
Dublin City,2016,15 - 19 years,2,3,5
Dublin City,2016,20 - 24 years,2,13,15
Dublin City,2016,25 - 29 years,6,13,19
Dublin City,2016,30 - 34 years,8,16,24
Dublin City,2016,35 - 39 years,16,20,36
Dublin City,2016,40 - 44 years,17,29,46
Dublin City,2016,45 - 49 years,35,61,96
Dublin City,2016,5 - 9 years,1,3,4
Dublin City,2016,50 - 54 years,45,77,122
Dublin City,2016,55 - 59 years,73,97,170
Dublin City,2016,60 - 64 years,73,130,203
Dublin City,2016,65 - 69 years,122,148,270
Dublin City,2016,70 - 74 years,176,185,361
Dublin City,2016,75 - 79 years,254,282,536
Dublin City,2016,80 - 84 years,335,331,666
Dublin City,2016,85 years and over,991,467,1458
Dublin City,2016,Under 1 year,10,11,21
Dublin City,2017,1 - 4 years,1,1,2
Dublin City,2017,10 - 14 years,1,1,2
Dublin City,2017,15 - 19 years,2,3,5
Dublin City,2017,20 - 24 years,2,12,14
Dublin City,2017,25 - 29 years,4,10,14
Dublin City,2017,30 - 34 years,7,11,18
Dublin City,2017,35 - 39 years,18,19,37
Dublin City,2017,40 - 44 years,19,29,48
Dublin City,2017,45 - 49 years,25,54,79
Dublin City,2017,5 - 9 years,2,3,5
Dublin City,2017,50 - 54 years,42,74,116
Dublin City,2017,55 - 59 years,56,114,170
Dublin City,2017,60 - 64 years,97,135,232
Dublin City,2017,65 - 69 years,103,190,293
Dublin City,2017,70 - 74 years,172,218,390
Dublin City,2017,75 - 79 years,242,288,530
Dublin City,2017,80 - 84 years,361,320,681
Dublin City,2017,85 years and over,1017,523,1540
Dublin City,2017,Under 1 year,12,9,21
Dublin City,2018,1 - 4 years,2,1,3
Dublin City,2018,10 - 14 years,3,2,5
Dublin City,2018,15 - 19 years,2,4,6
Dublin City,2018,20 - 24 years,4,1,5
Dublin City,2018,25 - 29 years,7,11,18
Dublin City,2018,30 - 34 years,8,10,18
Dublin City,2018,35 - 39 years,10,23,33
Dublin City,2018,40 - 44 years,20,38,58
Dublin City,2018,45 - 49 years,30,51,81
Dublin City,2018,5 - 9 years,1,1,2
Dublin City,2018,50 - 54 years,46,62,108
Dublin City,2018,55 - 59 years,71,94,165
Dublin City,2018,60 - 64 years,72,122,194
Dublin City,2018,65 - 69 years,118,174,292
Dublin City,2018,70 - 74 years,184,250,434
Dublin City,2018,75 - 79 years,250,286,536
Dublin City,2018,80 - 84 years,362,309,671
Dublin City,2018,85 years and over,1041,541,1582
Dublin City,2018,Under 1 year,9,13,22
Dublin City,2019,1 - 4 years,1,1,2
Dublin City,2019,10 - 14 years,0,2,2
Dublin City,2019,15 - 19 years,3,2,5
Dublin City,2019,20 - 24 years,1,5,6
Dublin City,2019,25 - 29 years,4,6,10
Dublin City,2019,30 - 34 years,7,10,17
Dublin City,2019,35 - 39 years,10,32,42
Dublin City,2019,40 - 44 years,21,30,51
Dublin City,2019,45 - 49 years,31,60,91
Dublin City,2019,5 - 9 years,1,1,2
Dublin City,2019,50 - 54 years,44,76,120
Dublin City,2019,55 - 59 years,70,110,180
Dublin City,2019,60 - 64 years,97,153,250
Dublin City,2019,65 - 69 years,111,170,281
Dublin City,2019,70 - 74 years,146,240,386
Dublin City,2019,75 - 79 years,227,254,481
Dublin City,2019,80 - 84 years,341,346,687
Dublin City,2019,85 years and over,981,590,1571
Dublin City,2019,Under 1 year,12,14,26
Dublin City,2020,1 - 4 years,1,1,2
Dublin City,2020,10 - 14 years,0,1,1
Dublin City,2020,15 - 19 years,1,2,3
Dublin City,2020,20 - 24 years,3,7,10
Dublin City,2020,25 - 29 years,6,13,19
Dublin City,2020,30 - 34 years,11,14,25
Dublin City,2020,35 - 39 years,14,32,46
Dublin City,2020,40 - 44 years,22,29,51
Dublin City,2020,45 - 49 years,26,43,69
Dublin City,2020,5 - 9 years,1,1,2
Dublin City,2020,50 - 54 years,33,67,100
Dublin City,2020,55 - 59 years,44,82,126
Dublin City,2020,60 - 64 years,70,125,195
Dublin City,2020,65 - 69 years,121,172,293
Dublin City,2020,70 - 74 years,178,277,455
Dublin City,2020,75 - 79 years,209,274,483
Dublin City,2020,80 - 84 years,368,389,757
Dublin City,2020,85 years and over,1103,633,1736
Dublin City,2020,Under 1 year,9,7,16
Dun Laoghaire Rathdown,2007,1 - 4 years,0,1,1
Dun Laoghaire Rathdown,2007,10 - 14 years,0,0,0
Dun Laoghaire Rathdown,2007,15 - 19 years,2,3,5
Dun Laoghaire Rathdown,2007,20 - 24 years,1,5,6
Dun Laoghaire Rathdown,2007,25 - 29 years,6,4,10
Dun Laoghaire Rathdown,2007,30 - 34 years,3,1,4
Dun Laoghaire Rathdown,2007,35 - 39 years,5,5,10
Dun Laoghaire Rathdown,2007,40 - 44 years,4,8,12
Dun Laoghaire Rathdown,2007,45 - 49 years,14,16,30
Dun Laoghaire Rathdown,2007,5 - 9 years,1,0,1
Dun Laoghaire Rathdown,2007,50 - 54 years,12,16,28
Dun Laoghaire Rathdown,2007,55 - 59 years,15,29,44
Dun Laoghaire Rathdown,2007,60 - 64 years,24,34,58
Dun Laoghaire Rathdown,2007,65 - 69 years,40,46,86
Dun Laoghaire Rathdown,2007,70 - 74 years,57,65,122
Dun Laoghaire Rathdown,2007,75 - 79 years,87,91,178
Dun Laoghaire Rathdown,2007,80 - 84 years,136,105,241
Dun Laoghaire Rathdown,2007,85 years and over,288,122,410
Dun Laoghaire Rathdown,2007,Under 1 year,5,6,11
Dun Laoghaire Rathdown,2008,1 - 4 years,1,2,3
Dun Laoghaire Rathdown,2008,10 - 14 years,0,1,1
Dun Laoghaire Rathdown,2008,15 - 19 years,1,3,4
Dun Laoghaire Rathdown,2008,20 - 24 years,1,2,3
Dun Laoghaire Rathdown,2008,25 - 29 years,6,3,9
Dun Laoghaire Rathdown,2008,30 - 34 years,1,3,4
Dun Laoghaire Rathdown,2008,35 - 39 years,1,10,11
Dun Laoghaire Rathdown,2008,40 - 44 years,7,12,19
Dun Laoghaire Rathdown,2008,45 - 49 years,17,19,36
Dun Laoghaire Rathdown,2008,5 - 9 years,1,0,1
Dun Laoghaire Rathdown,2008,50 - 54 years,12,19,31
Dun Laoghaire Rathdown,2008,55 - 59 years,21,33,54
Dun Laoghaire Rathdown,2008,60 - 64 years,29,38,67
Dun Laoghaire Rathdown,2008,65 - 69 years,41,43,84
Dun Laoghaire Rathdown,2008,70 - 74 years,65,79,144
Dun Laoghaire Rathdown,2008,75 - 79 years,84,91,175
Dun Laoghaire Rathdown,2008,80 - 84 years,110,110,220
Dun Laoghaire Rathdown,2008,85 years and over,292,133,425
Dun Laoghaire Rathdown,2008,Under 1 year,1,3,4
Dun Laoghaire Rathdown,2009,1 - 4 years,1,2,3
Dun Laoghaire Rathdown,2009,10 - 14 years,0,1,1
Dun Laoghaire Rathdown,2009,15 - 19 years,2,1,3
Dun Laoghaire Rathdown,2009,20 - 24 years,1,3,4
Dun Laoghaire Rathdown,2009,25 - 29 years,2,3,5
Dun Laoghaire Rathdown,2009,30 - 34 years,7,9,16
Dun Laoghaire Rathdown,2009,35 - 39 years,5,6,11
Dun Laoghaire Rathdown,2009,40 - 44 years,4,10,14
Dun Laoghaire Rathdown,2009,45 - 49 years,11,11,22
Dun Laoghaire Rathdown,2009,5 - 9 years,1,0,1
Dun Laoghaire Rathdown,2009,50 - 54 years,14,23,37
Dun Laoghaire Rathdown,2009,55 - 59 years,24,32,56
Dun Laoghaire Rathdown,2009,60 - 64 years,28,40,68
Dun Laoghaire Rathdown,2009,65 - 69 years,31,50,81
Dun Laoghaire Rathdown,2009,70 - 74 years,61,56,117
Dun Laoghaire Rathdown,2009,75 - 79 years,93,95,188
Dun Laoghaire Rathdown,2009,80 - 84 years,117,137,254
Dun Laoghaire Rathdown,2009,85 years and over,282,131,413
Dun Laoghaire Rathdown,2009,Under 1 year,6,10,16
Dun Laoghaire Rathdown,2010,1 - 4 years,1,2,3
Dun Laoghaire Rathdown,2010,10 - 14 years,0,1,1
Dun Laoghaire Rathdown,2010,15 - 19 years,1,2,3
Dun Laoghaire Rathdown,2010,20 - 24 years,1,6,7
Dun Laoghaire Rathdown,2010,25 - 29 years,2,4,6
Dun Laoghaire Rathdown,2010,30 - 34 years,4,5,9
Dun Laoghaire Rathdown,2010,35 - 39 years,4,3,7
Dun Laoghaire Rathdown,2010,40 - 44 years,7,10,17
Dun Laoghaire Rathdown,2010,45 - 49 years,11,20,31
Dun Laoghaire Rathdown,2010,5 - 9 years,1,0,1
Dun Laoghaire Rathdown,2010,50 - 54 years,12,13,25
Dun Laoghaire Rathdown,2010,55 - 59 years,13,21,34
Dun Laoghaire Rathdown,2010,60 - 64 years,20,43,63
Dun Laoghaire Rathdown,2010,65 - 69 years,43,56,99
Dun Laoghaire Rathdown,2010,70 - 74 years,65,76,141
Dun Laoghaire Rathdown,2010,75 - 79 years,74,92,166
Dun Laoghaire Rathdown,2010,80 - 84 years,134,141,275
Dun Laoghaire Rathdown,2010,85 years and over,334,164,498
Dun Laoghaire Rathdown,2010,Under 1 year,4,2,6
Dun Laoghaire Rathdown,2011,1 - 4 years,0,2,2
Dun Laoghaire Rathdown,2011,10 - 14 years,0,0,0
Dun Laoghaire Rathdown,2011,15 - 19 years,1,0,1
Dun Laoghaire Rathdown,2011,20 - 24 years,1,4,5
Dun Laoghaire Rathdown,2011,25 - 29 years,1,0,1
Dun Laoghaire Rathdown,2011,30 - 34 years,2,7,9
Dun Laoghaire Rathdown,2011,35 - 39 years,5,6,11
Dun Laoghaire Rathdown,2011,40 - 44 years,0,4,4
Dun Laoghaire Rathdown,2011,45 - 49 years,9,17,26
Dun Laoghaire Rathdown,2011,5 - 9 years,0,0,0
Dun Laoghaire Rathdown,2011,50 - 54 years,15,21,36
Dun Laoghaire Rathdown,2011,55 - 59 years,17,22,39
Dun Laoghaire Rathdown,2011,60 - 64 years,24,44,68
Dun Laoghaire Rathdown,2011,65 - 69 years,34,48,82
Dun Laoghaire Rathdown,2011,70 - 74 years,50,73,123
Dun Laoghaire Rathdown,2011,75 - 79 years,76,102,178
Dun Laoghaire Rathdown,2011,80 - 84 years,110,117,227
Dun Laoghaire Rathdown,2011,85 years and over,325,148,473
Dun Laoghaire Rathdown,2011,Under 1 year,3,6,9
Dun Laoghaire Rathdown,2012,1 - 4 years,1,1,2
Dun Laoghaire Rathdown,2012,10 - 14 years,1,1,2
Dun Laoghaire Rathdown,2012,15 - 19 years,1,1,2
Dun Laoghaire Rathdown,2012,20 - 24 years,1,4,5
Dun Laoghaire Rathdown,2012,25 - 29 years,1,3,4
Dun Laoghaire Rathdown,2012,30 - 34 years,1,4,5
Dun Laoghaire Rathdown,2012,35 - 39 years,3,4,7
Dun Laoghaire Rathdown,2012,40 - 44 years,5,12,17
Dun Laoghaire Rathdown,2012,45 - 49 years,8,16,24
Dun Laoghaire Rathdown,2012,5 - 9 years,0,0,0
Dun Laoghaire Rathdown,2012,50 - 54 years,18,29,47
Dun Laoghaire Rathdown,2012,55 - 59 years,25,20,45
Dun Laoghaire Rathdown,2012,60 - 64 years,28,44,72
Dun Laoghaire Rathdown,2012,65 - 69 years,37,51,88
Dun Laoghaire Rathdown,2012,70 - 74 years,54,81,135
Dun Laoghaire Rathdown,2012,75 - 79 years,90,102,192
Dun Laoghaire Rathdown,2012,80 - 84 years,139,130,269
Dun Laoghaire Rathdown,2012,85 years and over,370,177,547
Dun Laoghaire Rathdown,2012,Under 1 year,1,1,2
Dun Laoghaire Rathdown,2013,1 - 4 years,1,2,3
Dun Laoghaire Rathdown,2013,10 - 14 years,0,1,1
Dun Laoghaire Rathdown,2013,15 - 19 years,1,1,2
Dun Laoghaire Rathdown,2013,20 - 24 years,0,1,1
Dun Laoghaire Rathdown,2013,25 - 29 years,2,2,4
Dun Laoghaire Rathdown,2013,30 - 34 years,4,5,9
Dun Laoghaire Rathdown,2013,35 - 39 years,3,5,8
Dun Laoghaire Rathdown,2013,40 - 44 years,4,13,17
Dun Laoghaire Rathdown,2013,45 - 49 years,8,17,25
Dun Laoghaire Rathdown,2013,5 - 9 years,0,0,0
Dun Laoghaire Rathdown,2013,50 - 54 years,19,20,39
Dun Laoghaire Rathdown,2013,55 - 59 years,24,34,58
Dun Laoghaire Rathdown,2013,60 - 64 years,25,33,58
Dun Laoghaire Rathdown,2013,65 - 69 years,44,59,103
Dun Laoghaire Rathdown,2013,70 - 74 years,52,74,126
Dun Laoghaire Rathdown,2013,75 - 79 years,94,94,188
Dun Laoghaire Rathdown,2013,80 - 84 years,145,121,266
Dun Laoghaire Rathdown,2013,85 years and over,370,162,532
Dun Laoghaire Rathdown,2013,Under 1 year,2,2,4
Dun Laoghaire Rathdown,2014,1 - 4 years,1,1,2
Dun Laoghaire Rathdown,2014,10 - 14 years,0,1,1
Dun Laoghaire Rathdown,2014,15 - 19 years,1,1,2
Dun Laoghaire Rathdown,2014,20 - 24 years,1,1,2
Dun Laoghaire Rathdown,2014,25 - 29 years,2,1,3
Dun Laoghaire Rathdown,2014,30 - 34 years,4,5,9
Dun Laoghaire Rathdown,2014,35 - 39 years,1,5,6
Dun Laoghaire Rathdown,2014,40 - 44 years,3,8,11
Dun Laoghaire Rathdown,2014,45 - 49 years,6,12,18
Dun Laoghaire Rathdown,2014,5 - 9 years,0,0,0
Dun Laoghaire Rathdown,2014,50 - 54 years,9,27,36
Dun Laoghaire Rathdown,2014,55 - 59 years,17,24,41
Dun Laoghaire Rathdown,2014,60 - 64 years,24,34,58
Dun Laoghaire Rathdown,2014,65 - 69 years,53,46,99
Dun Laoghaire Rathdown,2014,70 - 74 years,66,70,136
Dun Laoghaire Rathdown,2014,75 - 79 years,81,103,184
Dun Laoghaire Rathdown,2014,80 - 84 years,133,136,269
Dun Laoghaire Rathdown,2014,85 years and over,355,191,546
Dun Laoghaire Rathdown,2014,Under 1 year,1,2,3
Dun Laoghaire Rathdown,2015,1 - 4 years,1,1,2
Dun Laoghaire Rathdown,2015,10 - 14 years,1,1,2
Dun Laoghaire Rathdown,2015,15 - 19 years,2,1,3
Dun Laoghaire Rathdown,2015,20 - 24 years,1,2,3
Dun Laoghaire Rathdown,2015,25 - 29 years,2,4,6
Dun Laoghaire Rathdown,2015,30 - 34 years,2,3,5
Dun Laoghaire Rathdown,2015,35 - 39 years,2,3,5
Dun Laoghaire Rathdown,2015,40 - 44 years,2,3,5
Dun Laoghaire Rathdown,2015,45 - 49 years,4,11,15
Dun Laoghaire Rathdown,2015,5 - 9 years,0,0,0
Dun Laoghaire Rathdown,2015,50 - 54 years,18,12,30
Dun Laoghaire Rathdown,2015,55 - 59 years,18,27,45
Dun Laoghaire Rathdown,2015,60 - 64 years,24,50,74
Dun Laoghaire Rathdown,2015,65 - 69 years,40,45,85
Dun Laoghaire Rathdown,2015,70 - 74 years,51,59,110
Dun Laoghaire Rathdown,2015,75 - 79 years,100,97,197
Dun Laoghaire Rathdown,2015,80 - 84 years,143,120,263
Dun Laoghaire Rathdown,2015,85 years and over,373,200,573
Dun Laoghaire Rathdown,2015,Under 1 year,9,5,14
Dun Laoghaire Rathdown,2016,1 - 4 years,2,1,3
Dun Laoghaire Rathdown,2016,10 - 14 years,1,1,2
Dun Laoghaire Rathdown,2016,15 - 19 years,2,1,3
Dun Laoghaire Rathdown,2016,20 - 24 years,2,2,4
Dun Laoghaire Rathdown,2016,25 - 29 years,2,4,6
Dun Laoghaire Rathdown,2016,30 - 34 years,2,3,5
Dun Laoghaire Rathdown,2016,35 - 39 years,5,4,9
Dun Laoghaire Rathdown,2016,40 - 44 years,4,6,10
Dun Laoghaire Rathdown,2016,45 - 49 years,12,13,25
Dun Laoghaire Rathdown,2016,5 - 9 years,0,0,0
Dun Laoghaire Rathdown,2016,50 - 54 years,17,21,38
Dun Laoghaire Rathdown,2016,55 - 59 years,12,23,35
Dun Laoghaire Rathdown,2016,60 - 64 years,21,32,53
Dun Laoghaire Rathdown,2016,65 - 69 years,38,51,89
Dun Laoghaire Rathdown,2016,70 - 74 years,72,65,137
Dun Laoghaire Rathdown,2016,75 - 79 years,82,111,193
Dun Laoghaire Rathdown,2016,80 - 84 years,102,150,252
Dun Laoghaire Rathdown,2016,85 years and over,354,213,567
Dun Laoghaire Rathdown,2016,Under 1 year,6,4,10
Dun Laoghaire Rathdown,2017,1 - 4 years,1,2,3
Dun Laoghaire Rathdown,2017,10 - 14 years,1,1,2
Dun Laoghaire Rathdown,2017,15 - 19 years,1,1,2
Dun Laoghaire Rathdown,2017,20 - 24 years,2,2,4
Dun Laoghaire Rathdown,2017,25 - 29 years,2,1,3
Dun Laoghaire Rathdown,2017,30 - 34 years,2,3,5
Dun Laoghaire Rathdown,2017,35 - 39 years,4,3,7
Dun Laoghaire Rathdown,2017,40 - 44 years,5,2,7
Dun Laoghaire Rathdown,2017,45 - 49 years,10,10,20
Dun Laoghaire Rathdown,2017,5 - 9 years,0,0,0
Dun Laoghaire Rathdown,2017,50 - 54 years,9,11,20
Dun Laoghaire Rathdown,2017,55 - 59 years,20,21,41
Dun Laoghaire Rathdown,2017,60 - 64 years,21,38,59
Dun Laoghaire Rathdown,2017,65 - 69 years,34,52,86
Dun Laoghaire Rathdown,2017,70 - 74 years,46,66,112
Dun Laoghaire Rathdown,2017,75 - 79 years,101,100,201
Dun Laoghaire Rathdown,2017,80 - 84 years,151,135,286
Dun Laoghaire Rathdown,2017,85 years and over,396,229,625
Dun Laoghaire Rathdown,2017,Under 1 year,1,3,4
Dun Laoghaire Rathdown,2018,1 - 4 years,1,0,1
Dun Laoghaire Rathdown,2018,10 - 14 years,0,1,1
Dun Laoghaire Rathdown,2018,15 - 19 years,0,1,1
Dun Laoghaire Rathdown,2018,20 - 24 years,1,0,1
Dun Laoghaire Rathdown,2018,25 - 29 years,2,1,3
Dun Laoghaire Rathdown,2018,30 - 34 years,1,3,4
Dun Laoghaire Rathdown,2018,35 - 39 years,2,4,6
Dun Laoghaire Rathdown,2018,40 - 44 years,8,8,16
Dun Laoghaire Rathdown,2018,45 - 49 years,6,6,12
Dun Laoghaire Rathdown,2018,5 - 9 years,0,0,0
Dun Laoghaire Rathdown,2018,50 - 54 years,13,16,29
Dun Laoghaire Rathdown,2018,55 - 59 years,16,17,33
Dun Laoghaire Rathdown,2018,60 - 64 years,24,49,73
Dun Laoghaire Rathdown,2018,65 - 69 years,36,50,86
Dun Laoghaire Rathdown,2018,70 - 74 years,54,65,119
Dun Laoghaire Rathdown,2018,75 - 79 years,89,93,182
Dun Laoghaire Rathdown,2018,80 - 84 years,137,138,275
Dun Laoghaire Rathdown,2018,85 years and over,402,245,647
Dun Laoghaire Rathdown,2018,Under 1 year,4,0,4
Dun Laoghaire Rathdown,2019,1 - 4 years,1,1,2
Dun Laoghaire Rathdown,2019,10 - 14 years,0,2,2
Dun Laoghaire Rathdown,2019,15 - 19 years,0,2,2
Dun Laoghaire Rathdown,2019,20 - 24 years,0,0,0
Dun Laoghaire Rathdown,2019,25 - 29 years,2,1,3
Dun Laoghaire Rathdown,2019,30 - 34 years,1,2,3
Dun Laoghaire Rathdown,2019,35 - 39 years,1,3,4
Dun Laoghaire Rathdown,2019,40 - 44 years,3,9,12
Dun Laoghaire Rathdown,2019,45 - 49 years,9,9,18
Dun Laoghaire Rathdown,2019,5 - 9 years,0,0,0
Dun Laoghaire Rathdown,2019,50 - 54 years,9,17,26
Dun Laoghaire Rathdown,2019,55 - 59 years,18,23,41
Dun Laoghaire Rathdown,2019,60 - 64 years,32,38,70
Dun Laoghaire Rathdown,2019,65 - 69 years,34,47,81
Dun Laoghaire Rathdown,2019,70 - 74 years,52,60,112
Dun Laoghaire Rathdown,2019,75 - 79 years,88,102,190
Dun Laoghaire Rathdown,2019,80 - 84 years,116,122,238
Dun Laoghaire Rathdown,2019,85 years and over,389,264,653
Dun Laoghaire Rathdown,2019,Under 1 year,4,2,6
Dun Laoghaire Rathdown,2020,1 - 4 years,1,1,2
Dun Laoghaire Rathdown,2020,10 - 14 years,1,2,3
Dun Laoghaire Rathdown,2020,15 - 19 years,1,2,3
Dun Laoghaire Rathdown,2020,20 - 24 years,0,2,2
Dun Laoghaire Rathdown,2020,25 - 29 years,2,3,5
Dun Laoghaire Rathdown,2020,30 - 34 years,2,4,6
Dun Laoghaire Rathdown,2020,35 - 39 years,2,6,8
Dun Laoghaire Rathdown,2020,40 - 44 years,3,6,9
Dun Laoghaire Rathdown,2020,45 - 49 years,9,9,18
Dun Laoghaire Rathdown,2020,5 - 9 years,0,1,1
Dun Laoghaire Rathdown,2020,50 - 54 years,13,11,24
Dun Laoghaire Rathdown,2020,55 - 59 years,18,25,43
Dun Laoghaire Rathdown,2020,60 - 64 years,31,28,59
Dun Laoghaire Rathdown,2020,65 - 69 years,41,39,80
Dun Laoghaire Rathdown,2020,70 - 74 years,58,67,125
Dun Laoghaire Rathdown,2020,75 - 79 years,73,106,179
Dun Laoghaire Rathdown,2020,80 - 84 years,131,135,266
Dun Laoghaire Rathdown,2020,85 years and over,394,222,616
Dun Laoghaire Rathdown,2020,Under 1 year,3,4,7
Dundalk Town,2007,1 - 4 years,0,0,0
Dundalk Town,2007,10 - 14 years,0,0,0
Dundalk Town,2007,15 - 19 years,1,1,2
Dundalk Town,2007,20 - 24 years,1,0,1
Dundalk Town,2007,25 - 29 years,0,6,6
Dundalk Town,2007,30 - 34 years,1,1,2
Dundalk Town,2007,35 - 39 years,0,3,3
Dundalk Town,2007,40 - 44 years,2,4,6
Dundalk Town,2007,45 - 49 years,1,5,6
Dundalk Town,2007,5 - 9 years,0,0,0
Dundalk Town,2007,50 - 54 years,6,7,13
Dundalk Town,2007,55 - 59 years,5,8,13
Dundalk Town,2007,60 - 64 years,5,13,18
Dundalk Town,2007,65 - 69 years,5,11,16
Dundalk Town,2007,70 - 74 years,18,18,36
Dundalk Town,2007,75 - 79 years,19,13,32
Dundalk Town,2007,80 - 84 years,35,21,56
Dundalk Town,2007,85 years and over,46,26,72
Dundalk Town,2007,Under 1 year,0,2,2
Dundalk Town,2008,1 - 4 years,0,0,0
Dundalk Town,2008,10 - 14 years,1,0,1
Dundalk Town,2008,15 - 19 years,1,1,2
Dundalk Town,2008,20 - 24 years,1,3,4
Dundalk Town,2008,25 - 29 years,0,4,4
Dundalk Town,2008,30 - 34 years,1,1,2
Dundalk Town,2008,35 - 39 years,3,3,6
Dundalk Town,2008,40 - 44 years,3,2,5
Dundalk Town,2008,45 - 49 years,4,6,10
Dundalk Town,2008,5 - 9 years,0,0,0
Dundalk Town,2008,50 - 54 years,1,4,5
Dundalk Town,2008,55 - 59 years,8,10,18
Dundalk Town,2008,60 - 64 years,7,14,21
Dundalk Town,2008,65 - 69 years,5,11,16
Dundalk Town,2008,70 - 74 years,6,20,26
Dundalk Town,2008,75 - 79 years,17,25,42
Dundalk Town,2008,80 - 84 years,34,30,64
Dundalk Town,2008,85 years and over,70,35,105
Dundalk Town,2008,Under 1 year,0,2,2
Dundalk Town,2009,1 - 4 years,1,1,2
Dundalk Town,2009,10 - 14 years,1,0,1
Dundalk Town,2009,15 - 19 years,1,1,2
Dundalk Town,2009,20 - 24 years,1,2,3
Dundalk Town,2009,25 - 29 years,0,2,2
Dundalk Town,2009,30 - 34 years,4,1,5
Dundalk Town,2009,35 - 39 years,2,2,4
Dundalk Town,2009,40 - 44 years,2,2,4
Dundalk Town,2009,45 - 49 years,3,2,5
Dundalk Town,2009,5 - 9 years,0,0,0
Dundalk Town,2009,50 - 54 years,4,8,12
Dundalk Town,2009,55 - 59 years,5,4,9
Dundalk Town,2009,60 - 64 years,10,14,24
Dundalk Town,2009,65 - 69 years,9,12,21
Dundalk Town,2009,70 - 74 years,6,19,25
Dundalk Town,2009,75 - 79 years,18,15,33
Dundalk Town,2009,80 - 84 years,22,15,37
Dundalk Town,2009,85 years and over,51,26,77
Dundalk Town,2009,Under 1 year,2,2,4
Dundalk Town,2010,1 - 4 years,1,1,2
Dundalk Town,2010,10 - 14 years,1,0,1
Dundalk Town,2010,15 - 19 years,1,1,2
Dundalk Town,2010,20 - 24 years,1,2,3
Dundalk Town,2010,25 - 29 years,1,2,3
Dundalk Town,2010,30 - 34 years,1,2,3
Dundalk Town,2010,35 - 39 years,1,4,5
Dundalk Town,2010,40 - 44 years,2,3,5
Dundalk Town,2010,45 - 49 years,2,2,4
Dundalk Town,2010,5 - 9 years,0,1,1
Dundalk Town,2010,50 - 54 years,5,3,8
Dundalk Town,2010,55 - 59 years,4,4,8
Dundalk Town,2010,60 - 64 years,5,6,11
Dundalk Town,2010,65 - 69 years,7,13,20
Dundalk Town,2010,70 - 74 years,8,12,20
Dundalk Town,2010,75 - 79 years,16,20,36
Dundalk Town,2010,80 - 84 years,15,13,28
Dundalk Town,2010,85 years and over,42,31,73
Dundalk Town,2010,Under 1 year,3,2,5
Dundalk Town,2011,1 - 4 years,1,0,1
Dundalk Town,2011,10 - 14 years,0,0,0
Dundalk Town,2011,15 - 19 years,1,0,1
Dundalk Town,2011,20 - 24 years,0,3,3
Dundalk Town,2011,25 - 29 years,0,1,1
Dundalk Town,2011,30 - 34 years,1,6,7
Dundalk Town,2011,35 - 39 years,2,5,7
Dundalk Town,2011,40 - 44 years,0,3,3
Dundalk Town,2011,45 - 49 years,3,2,5
Dundalk Town,2011,5 - 9 years,0,0,0
Dundalk Town,2011,50 - 54 years,3,2,5
Dundalk Town,2011,55 - 59 years,0,2,2
Dundalk Town,2011,60 - 64 years,8,7,15
Dundalk Town,2011,65 - 69 years,4,11,15
Dundalk Town,2011,70 - 74 years,6,9,15
Dundalk Town,2011,75 - 79 years,12,7,19
Dundalk Town,2011,80 - 84 years,19,21,40
Dundalk Town,2011,85 years and over,39,25,64
Dundalk Town,2011,Under 1 year,0,0,0
Dundalk Town,2012,1 - 4 years,1,1,2
Dundalk Town,2012,10 - 14 years,0,0,0
Dundalk Town,2012,15 - 19 years,1,0,1
Dundalk Town,2012,20 - 24 years,0,1,1
Dundalk Town,2012,25 - 29 years,0,1,1
Dundalk Town,2012,30 - 34 years,1,2,3
Dundalk Town,2012,35 - 39 years,1,2,3
Dundalk Town,2012,40 - 44 years,1,2,3
Dundalk Town,2012,45 - 49 years,3,5,8
Dundalk Town,2012,5 - 9 years,0,0,0
Dundalk Town,2012,50 - 54 years,4,3,7
Dundalk Town,2012,55 - 59 years,2,7,9
Dundalk Town,2012,60 - 64 years,3,9,12
Dundalk Town,2012,65 - 69 years,9,13,22
Dundalk Town,2012,70 - 74 years,5,11,16
Dundalk Town,2012,75 - 79 years,13,15,28
Dundalk Town,2012,80 - 84 years,24,22,46
Dundalk Town,2012,85 years and over,52,29,81
Dundalk Town,2012,Under 1 year,0,0,0
Dundalk Town,2013,1 - 4 years,0,0,0
Dundalk Town,2013,10 - 14 years,0,0,0
Dundalk Town,2013,15 - 19 years,0,0,0
Dundalk Town,2013,20 - 24 years,0,3,3
Dundalk Town,2013,25 - 29 years,1,1,2
Dundalk Town,2013,30 - 34 years,0,1,1
Dundalk Town,2013,35 - 39 years,0,6,6
Dundalk Town,2013,40 - 44 years,0,4,4
Dundalk Town,2013,45 - 49 years,2,3,5
Dundalk Town,2013,5 - 9 years,0,0,0
Dundalk Town,2013,50 - 54 years,5,4,9
Dundalk Town,2013,55 - 59 years,4,6,10
Dundalk Town,2013,60 - 64 years,3,6,9
Dundalk Town,2013,65 - 69 years,5,14,19
Dundalk Town,2013,70 - 74 years,8,16,24
Dundalk Town,2013,75 - 79 years,16,12,28
Dundalk Town,2013,80 - 84 years,21,19,40
Dundalk Town,2013,85 years and over,55,24,79
Dundalk Town,2013,Under 1 year,0,0,0
Dundalk Town,2014,1 - 4 years,0,0,0
Dundalk Town,2014,10 - 14 years,0,0,0
Dundalk Town,2014,15 - 19 years,0,1,1
Dundalk Town,2014,20 - 24 years,0,1,1
Dundalk Town,2014,25 - 29 years,1,1,2
Dundalk Town,2014,30 - 34 years,0,1,1
Dundalk Town,2014,35 - 39 years,0,4,4
Dundalk Town,2014,40 - 44 years,1,5,6
Dundalk Town,2014,45 - 49 years,3,2,5
Dundalk Town,2014,5 - 9 years,0,0,0
Dundalk Town,2014,50 - 54 years,3,2,5
Dundalk Town,2014,55 - 59 years,6,6,12
Dundalk Town,2014,60 - 64 years,4,7,11
Dundalk Town,2014,65 - 69 years,5,7,12
Dundalk Town,2014,70 - 74 years,5,11,16
Dundalk Town,2014,75 - 79 years,10,23,33
Dundalk Town,2014,80 - 84 years,20,20,40
Dundalk Town,2014,85 years and over,55,26,81
Dundalk Town,2014,Under 1 year,1,0,1
Dundalk Town,2015,1 - 4 years,0,0,0
Dundalk Town,2015,10 - 14 years,0,0,0
Dundalk Town,2015,15 - 19 years,0,1,1
Dundalk Town,2015,20 - 24 years,0,1,1
Dundalk Town,2015,25 - 29 years,1,1,2
Dundalk Town,2015,30 - 34 years,0,1,1
Dundalk Town,2015,35 - 39 years,0,4,4
Dundalk Town,2015,40 - 44 years,1,5,6
Dundalk Town,2015,45 - 49 years,3,2,5
Dundalk Town,2015,5 - 9 years,0,0,0
Dundalk Town,2015,50 - 54 years,3,2,5
Dundalk Town,2015,55 - 59 years,6,6,12
Dundalk Town,2015,60 - 64 years,4,7,11
Dundalk Town,2015,65 - 69 years,5,7,12
Dundalk Town,2015,70 - 74 years,5,11,16
Dundalk Town,2015,75 - 79 years,10,23,33
Dundalk Town,2015,80 - 84 years,20,20,40
Dundalk Town,2015,85 years and over,55,26,81
Dundalk Town,2015,Under 1 year,1,0,1
Dundalk Town,2016,1 - 4 years,0,0,0
Dundalk Town,2016,10 - 14 years,0,0,0
Dundalk Town,2016,15 - 19 years,0,1,1
Dundalk Town,2016,20 - 24 years,0,1,1
Dundalk Town,2016,25 - 29 years,1,1,2
Dundalk Town,2016,30 - 34 years,0,1,1
Dundalk Town,2016,35 - 39 years,0,4,4
Dundalk Town,2016,40 - 44 years,1,5,6
Dundalk Town,2016,45 - 49 years,3,2,5
Dundalk Town,2016,5 - 9 years,0,0,0
Dundalk Town,2016,50 - 54 years,3,2,5
Dundalk Town,2016,55 - 59 years,6,6,12
Dundalk Town,2016,60 - 64 years,4,7,11
Dundalk Town,2016,65 - 69 years,5,7,12
Dundalk Town,2016,70 - 74 years,5,11,16
Dundalk Town,2016,75 - 79 years,10,23,33
Dundalk Town,2016,80 - 84 years,20,20,40
Dundalk Town,2016,85 years and over,55,26,81
Dundalk Town,2016,Under 1 year,1,0,1
Dundalk Town,2017,1 - 4 years,0,0,0
Dundalk Town,2017,10 - 14 years,0,0,0
Dundalk Town,2017,15 - 19 years,0,1,1
Dundalk Town,2017,20 - 24 years,0,1,1
Dundalk Town,2017,25 - 29 years,1,1,2
Dundalk Town,2017,30 - 34 years,0,2,2
Dundalk Town,2017,35 - 39 years,0,3,3
Dundalk Town,2017,40 - 44 years,1,6,7
Dundalk Town,2017,45 - 49 years,3,5,8
Dundalk Town,2017,5 - 9 years,0,0,0
Dundalk Town,2017,50 - 54 years,3,4,7
Dundalk Town,2017,55 - 59 years,3,2,5
Dundalk Town,2017,60 - 64 years,5,10,15
Dundalk Town,2017,65 - 69 years,5,10,15
Dundalk Town,2017,70 - 74 years,12,17,29
Dundalk Town,2017,75 - 79 years,19,13,32
Dundalk Town,2017,80 - 84 years,25,21,46
Dundalk Town,2017,85 years and over,54,29,83
Dundalk Town,2017,Under 1 year,2,5,7
Dundalk Town,2018,1 - 4 years,0,0,0
Dundalk Town,2018,10 - 14 years,0,0,0
Dundalk Town,2018,15 - 19 years,0,0,0
Dundalk Town,2018,20 - 24 years,0,2,2
Dundalk Town,2018,25 - 29 years,0,0,0
Dundalk Town,2018,30 - 34 years,1,2,3
Dundalk Town,2018,35 - 39 years,2,3,5
Dundalk Town,2018,40 - 44 years,2,1,3
Dundalk Town,2018,45 - 49 years,2,6,8
Dundalk Town,2018,5 - 9 years,0,0,0
Dundalk Town,2018,50 - 54 years,4,5,9
Dundalk Town,2018,55 - 59 years,3,3,6
Dundalk Town,2018,60 - 64 years,7,9,16
Dundalk Town,2018,65 - 69 years,11,14,25
Dundalk Town,2018,70 - 74 years,13,20,33
Dundalk Town,2018,75 - 79 years,12,18,30
Dundalk Town,2018,80 - 84 years,17,19,36
Dundalk Town,2018,85 years and over,52,31,83
Dundalk Town,2018,Under 1 year,0,1,1
Dundalk Town,2019,1 - 4 years,0,0,0
Dundalk Town,2019,10 - 14 years,0,0,0
Dundalk Town,2019,15 - 19 years,0,0,0
Dundalk Town,2019,20 - 24 years,0,2,2
Dundalk Town,2019,25 - 29 years,0,0,0
Dundalk Town,2019,30 - 34 years,1,2,3
Dundalk Town,2019,35 - 39 years,2,3,5
Dundalk Town,2019,40 - 44 years,2,1,3
Dundalk Town,2019,45 - 49 years,2,6,8
Dundalk Town,2019,5 - 9 years,0,0,0
Dundalk Town,2019,50 - 54 years,4,5,9
Dundalk Town,2019,55 - 59 years,3,3,6
Dundalk Town,2019,60 - 64 years,7,9,16
Dundalk Town,2019,65 - 69 years,11,14,25
Dundalk Town,2019,70 - 74 years,13,20,33
Dundalk Town,2019,75 - 79 years,12,18,30
Dundalk Town,2019,80 - 84 years,17,19,36
Dundalk Town,2019,85 years and over,52,31,83
Dundalk Town,2019,Under 1 year,0,1,1
Dundalk Town,2020,1 - 4 years,0,0,0
Dundalk Town,2020,10 - 14 years,0,0,0
Dundalk Town,2020,15 - 19 years,0,0,0
Dundalk Town,2020,20 - 24 years,0,2,2
Dundalk Town,2020,25 - 29 years,0,0,0
Dundalk Town,2020,30 - 34 years,1,2,3
Dundalk Town,2020,35 - 39 years,2,3,5
Dundalk Town,2020,40 - 44 years,2,1,3
Dundalk Town,2020,45 - 49 years,2,6,8
Dundalk Town,2020,5 - 9 years,0,0,0
Dundalk Town,2020,50 - 54 years,4,5,9
Dundalk Town,2020,55 - 59 years,3,3,6
Dundalk Town,2020,60 - 64 years,7,9,16
Dundalk Town,2020,65 - 69 years,11,14,25
Dundalk Town,2020,70 - 74 years,13,20,33
Dundalk Town,2020,75 - 79 years,12,18,30
Dundalk Town,2020,80 - 84 years,17,19,36
Dundalk Town,2020,85 years and over,52,31,83
Dundalk Town,2020,Under 1 year,0,1,1
Dungarvan Town,2007,1 - 4 years,0,1,1
Dungarvan Town,2007,10 - 14 years,1,0,1
Dungarvan Town,2007,15 - 19 years,1,0,1
Dungarvan Town,2007,20 - 24 years,0,0,0
Dungarvan Town,2007,25 - 29 years,0,0,0
Dungarvan Town,2007,30 - 34 years,0,0,0
Dungarvan Town,2007,35 - 39 years,0,1,1
Dungarvan Town,2007,40 - 44 years,0,0,0
Dungarvan Town,2007,45 - 49 years,1,2,3
Dungarvan Town,2007,5 - 9 years,0,0,0
Dungarvan Town,2007,50 - 54 years,2,1,3
Dungarvan Town,2007,55 - 59 years,4,2,6
Dungarvan Town,2007,60 - 64 years,4,2,6
Dungarvan Town,2007,65 - 69 years,3,4,7
Dungarvan Town,2007,70 - 74 years,3,3,6
Dungarvan Town,2007,75 - 79 years,7,7,14
Dungarvan Town,2007,80 - 84 years,5,9,14
Dungarvan Town,2007,85 years and over,21,11,32
Dungarvan Town,2007,Under 1 year,0,0,0
Dungarvan Town,2008,1 - 4 years,0,1,1
Dungarvan Town,2008,10 - 14 years,1,0,1
Dungarvan Town,2008,15 - 19 years,1,0,1
Dungarvan Town,2008,20 - 24 years,0,3,3
Dungarvan Town,2008,25 - 29 years,0,1,1
Dungarvan Town,2008,30 - 34 years,0,0,0
Dungarvan Town,2008,35 - 39 years,1,1,2
Dungarvan Town,2008,40 - 44 years,0,0,0
Dungarvan Town,2008,45 - 49 years,1,1,2
Dungarvan Town,2008,5 - 9 years,0,0,0
Dungarvan Town,2008,50 - 54 years,3,3,6
Dungarvan Town,2008,55 - 59 years,2,1,3
Dungarvan Town,2008,60 - 64 years,4,5,9
Dungarvan Town,2008,65 - 69 years,1,8,9
Dungarvan Town,2008,70 - 74 years,3,6,9
Dungarvan Town,2008,75 - 79 years,2,6,8
Dungarvan Town,2008,80 - 84 years,8,8,16
Dungarvan Town,2008,85 years and over,14,7,21
Dungarvan Town,2008,Under 1 year,1,1,2
Dungarvan Town,2009,1 - 4 years,0,1,1
Dungarvan Town,2009,10 - 14 years,1,0,1
Dungarvan Town,2009,15 - 19 years,1,0,1
Dungarvan Town,2009,20 - 24 years,0,3,3
Dungarvan Town,2009,25 - 29 years,0,1,1
Dungarvan Town,2009,30 - 34 years,0,0,0
Dungarvan Town,2009,35 - 39 years,1,1,2
Dungarvan Town,2009,40 - 44 years,0,0,0
Dungarvan Town,2009,45 - 49 years,1,1,2
Dungarvan Town,2009,5 - 9 years,0,0,0
Dungarvan Town,2009,50 - 54 years,3,3,6
Dungarvan Town,2009,55 - 59 years,2,1,3
Dungarvan Town,2009,60 - 64 years,4,3,7
Dungarvan Town,2009,65 - 69 years,1,3,4
Dungarvan Town,2009,70 - 74 years,1,3,4
Dungarvan Town,2009,75 - 79 years,3,6,9
Dungarvan Town,2009,80 - 84 years,8,10,18
Dungarvan Town,2009,85 years and over,15,3,18
Dungarvan Town,2009,Under 1 year,1,2,3
Dungarvan Town,2010,1 - 4 years,0,1,1
Dungarvan Town,2010,10 - 14 years,1,0,1
Dungarvan Town,2010,15 - 19 years,1,0,1
Dungarvan Town,2010,20 - 24 years,0,1,1
Dungarvan Town,2010,25 - 29 years,0,1,1
Dungarvan Town,2010,30 - 34 years,0,0,0
Dungarvan Town,2010,35 - 39 years,1,1,2
Dungarvan Town,2010,40 - 44 years,1,0,1
Dungarvan Town,2010,45 - 49 years,1,3,4
Dungarvan Town,2010,5 - 9 years,0,0,0
Dungarvan Town,2010,50 - 54 years,1,1,2
Dungarvan Town,2010,55 - 59 years,2,3,5
Dungarvan Town,2010,60 - 64 years,2,7,9
Dungarvan Town,2010,65 - 69 years,1,2,3
Dungarvan Town,2010,70 - 74 years,3,3,6
Dungarvan Town,2010,75 - 79 years,4,6,10
Dungarvan Town,2010,80 - 84 years,7,5,12
Dungarvan Town,2010,85 years and over,25,8,33
Dungarvan Town,2010,Under 1 year,1,2,3
Dungarvan Town,2011,1 - 4 years,0,0,0
Dungarvan Town,2011,10 - 14 years,0,0,0
Dungarvan Town,2011,15 - 19 years,0,0,0
Dungarvan Town,2011,20 - 24 years,0,0,0
Dungarvan Town,2011,25 - 29 years,0,1,1
Dungarvan Town,2011,30 - 34 years,1,1,2
Dungarvan Town,2011,35 - 39 years,1,1,2
Dungarvan Town,2011,40 - 44 years,0,0,0
Dungarvan Town,2011,45 - 49 years,2,0,2
Dungarvan Town,2011,5 - 9 years,0,0,0
Dungarvan Town,2011,50 - 54 years,0,2,2
Dungarvan Town,2011,55 - 59 years,1,3,4
Dungarvan Town,2011,60 - 64 years,1,3,4
Dungarvan Town,2011,65 - 69 years,1,4,5
Dungarvan Town,2011,70 - 74 years,2,1,3
Dungarvan Town,2011,75 - 79 years,6,4,10
Dungarvan Town,2011,80 - 84 years,7,4,11
Dungarvan Town,2011,85 years and over,13,5,18
Dungarvan Town,2011,Under 1 year,0,0,0
Dungarvan Town,2012,1 - 4 years,0,0,0
Dungarvan Town,2012,10 - 14 years,0,0,0
Dungarvan Town,2012,15 - 19 years,0,2,2
Dungarvan Town,2012,20 - 24 years,0,1,1
Dungarvan Town,2012,25 - 29 years,0,1,1
Dungarvan Town,2012,30 - 34 years,1,1,2
Dungarvan Town,2012,35 - 39 years,1,1,2
Dungarvan Town,2012,40 - 44 years,0,0,0
Dungarvan Town,2012,45 - 49 years,2,0,2
Dungarvan Town,2012,5 - 9 years,0,0,0
Dungarvan Town,2012,50 - 54 years,2,1,3
Dungarvan Town,2012,55 - 59 years,4,3,7
Dungarvan Town,2012,60 - 64 years,1,4,5
Dungarvan Town,2012,65 - 69 years,2,4,6
Dungarvan Town,2012,70 - 74 years,2,3,5
Dungarvan Town,2012,75 - 79 years,6,6,12
Dungarvan Town,2012,80 - 84 years,3,7,10
Dungarvan Town,2012,85 years and over,12,7,19
Dungarvan Town,2012,Under 1 year,0,0,0
Dungarvan Town,2013,1 - 4 years,0,0,0
Dungarvan Town,2013,10 - 14 years,0,0,0
Dungarvan Town,2013,15 - 19 years,0,0,0
Dungarvan Town,2013,20 - 24 years,0,1,1
Dungarvan Town,2013,25 - 29 years,0,1,1
Dungarvan Town,2013,30 - 34 years,0,0,0
Dungarvan Town,2013,35 - 39 years,0,1,1
Dungarvan Town,2013,40 - 44 years,0,2,2
Dungarvan Town,2013,45 - 49 years,0,1,1
Dungarvan Town,2013,5 - 9 years,0,0,0
Dungarvan Town,2013,50 - 54 years,0,3,3
Dungarvan Town,2013,55 - 59 years,1,1,2
Dungarvan Town,2013,60 - 64 years,3,2,5
Dungarvan Town,2013,65 - 69 years,2,3,5
Dungarvan Town,2013,70 - 74 years,4,10,14
Dungarvan Town,2013,75 - 79 years,7,7,14
Dungarvan Town,2013,80 - 84 years,6,4,10
Dungarvan Town,2013,85 years and over,10,9,19
Dungarvan Town,2013,Under 1 year,0,0,0
Dungarvan Town,2014,1 - 4 years,1,1,2
Dungarvan Town,2014,10 - 14 years,0,0,0
Dungarvan Town,2014,15 - 19 years,0,0,0
Dungarvan Town,2014,20 - 24 years,0,1,1
Dungarvan Town,2014,25 - 29 years,0,1,1
Dungarvan Town,2014,30 - 34 years,0,2,2
Dungarvan Town,2014,35 - 39 years,1,1,2
Dungarvan Town,2014,40 - 44 years,0,1,1
Dungarvan Town,2014,45 - 49 years,1,1,2
Dungarvan Town,2014,5 - 9 years,0,0,0
Dungarvan Town,2014,50 - 54 years,0,3,3
Dungarvan Town,2014,55 - 59 years,1,1,2
Dungarvan Town,2014,60 - 64 years,3,4,7
Dungarvan Town,2014,65 - 69 years,1,5,6
Dungarvan Town,2014,70 - 74 years,6,3,9
Dungarvan Town,2014,75 - 79 years,4,3,7
Dungarvan Town,2014,80 - 84 years,6,6,12
Dungarvan Town,2014,85 years and over,16,7,23
Dungarvan Town,2014,Under 1 year,0,0,0
Dungarvan Town,2015,1 - 4 years,1,1,2
Dungarvan Town,2015,10 - 14 years,0,0,0
Dungarvan Town,2015,15 - 19 years,0,0,0
Dungarvan Town,2015,20 - 24 years,0,1,1
Dungarvan Town,2015,25 - 29 years,0,1,1
Dungarvan Town,2015,30 - 34 years,0,2,2
Dungarvan Town,2015,35 - 39 years,1,1,2
Dungarvan Town,2015,40 - 44 years,0,1,1
Dungarvan Town,2015,45 - 49 years,1,1,2
Dungarvan Town,2015,5 - 9 years,0,0,0
Dungarvan Town,2015,50 - 54 years,0,3,3
Dungarvan Town,2015,55 - 59 years,1,1,2
Dungarvan Town,2015,60 - 64 years,3,4,7
Dungarvan Town,2015,65 - 69 years,1,5,6
Dungarvan Town,2015,70 - 74 years,6,3,9
Dungarvan Town,2015,75 - 79 years,4,3,7
Dungarvan Town,2015,80 - 84 years,6,6,12
Dungarvan Town,2015,85 years and over,16,7,23
Dungarvan Town,2015,Under 1 year,0,0,0
Dungarvan Town,2016,1 - 4 years,1,1,2
Dungarvan Town,2016,10 - 14 years,0,0,0
Dungarvan Town,2016,15 - 19 years,0,0,0
Dungarvan Town,2016,20 - 24 years,0,1,1
Dungarvan Town,2016,25 - 29 years,0,1,1
Dungarvan Town,2016,30 - 34 years,0,2,2
Dungarvan Town,2016,35 - 39 years,1,1,2
Dungarvan Town,2016,40 - 44 years,0,1,1
Dungarvan Town,2016,45 - 49 years,1,1,2
Dungarvan Town,2016,5 - 9 years,0,0,0
Dungarvan Town,2016,50 - 54 years,0,3,3
Dungarvan Town,2016,55 - 59 years,1,1,2
Dungarvan Town,2016,60 - 64 years,3,4,7
Dungarvan Town,2016,65 - 69 years,1,5,6
Dungarvan Town,2016,70 - 74 years,6,3,9
Dungarvan Town,2016,75 - 79 years,4,3,7
Dungarvan Town,2016,80 - 84 years,6,6,12
Dungarvan Town,2016,85 years and over,16,7,23
Dungarvan Town,2016,Under 1 year,0,0,0
Dungarvan Town,2017,1 - 4 years,1,1,2
Dungarvan Town,2017,10 - 14 years,0,0,0
Dungarvan Town,2017,15 - 19 years,1,0,1
Dungarvan Town,2017,20 - 24 years,0,1,1
Dungarvan Town,2017,25 - 29 years,0,1,1
Dungarvan Town,2017,30 - 34 years,0,1,1
Dungarvan Town,2017,35 - 39 years,1,1,2
Dungarvan Town,2017,40 - 44 years,0,1,1
Dungarvan Town,2017,45 - 49 years,1,2,3
Dungarvan Town,2017,5 - 9 years,0,0,0
Dungarvan Town,2017,50 - 54 years,1,1,2
Dungarvan Town,2017,55 - 59 years,1,1,2
Dungarvan Town,2017,60 - 64 years,3,2,5
Dungarvan Town,2017,65 - 69 years,1,2,3
Dungarvan Town,2017,70 - 74 years,3,7,10
Dungarvan Town,2017,75 - 79 years,4,8,12
Dungarvan Town,2017,80 - 84 years,5,5,10
Dungarvan Town,2017,85 years and over,18,16,34
Dungarvan Town,2017,Under 1 year,1,0,1
Dungarvan Town,2018,1 - 4 years,0,0,0
Dungarvan Town,2018,10 - 14 years,0,0,0
Dungarvan Town,2018,15 - 19 years,0,0,0
Dungarvan Town,2018,20 - 24 years,0,0,0
Dungarvan Town,2018,25 - 29 years,0,1,1
Dungarvan Town,2018,30 - 34 years,0,0,0
Dungarvan Town,2018,35 - 39 years,0,1,1
Dungarvan Town,2018,40 - 44 years,0,0,0
Dungarvan Town,2018,45 - 49 years,0,0,0
Dungarvan Town,2018,5 - 9 years,0,0,0
Dungarvan Town,2018,50 - 54 years,0,1,1
Dungarvan Town,2018,55 - 59 years,0,1,1
Dungarvan Town,2018,60 - 64 years,2,3,5
Dungarvan Town,2018,65 - 69 years,1,5,6
Dungarvan Town,2018,70 - 74 years,4,1,5
Dungarvan Town,2018,75 - 79 years,3,5,8
Dungarvan Town,2018,80 - 84 years,4,6,10
Dungarvan Town,2018,85 years and over,20,11,31
Dungarvan Town,2018,Under 1 year,0,0,0
Dungarvan Town,2019,1 - 4 years,0,0,0
Dungarvan Town,2019,10 - 14 years,0,0,0
Dungarvan Town,2019,15 - 19 years,0,0,0
Dungarvan Town,2019,20 - 24 years,0,0,0
Dungarvan Town,2019,25 - 29 years,0,1,1
Dungarvan Town,2019,30 - 34 years,0,0,0
Dungarvan Town,2019,35 - 39 years,0,1,1
Dungarvan Town,2019,40 - 44 years,0,0,0
Dungarvan Town,2019,45 - 49 years,0,0,0
Dungarvan Town,2019,5 - 9 years,0,0,0
Dungarvan Town,2019,50 - 54 years,0,1,1
Dungarvan Town,2019,55 - 59 years,0,1,1
Dungarvan Town,2019,60 - 64 years,2,3,5
Dungarvan Town,2019,65 - 69 years,1,5,6
Dungarvan Town,2019,70 - 74 years,4,1,5
Dungarvan Town,2019,75 - 79 years,3,5,8
Dungarvan Town,2019,80 - 84 years,4,6,10
Dungarvan Town,2019,85 years and over,20,11,31
Dungarvan Town,2019,Under 1 year,0,0,0
Dungarvan Town,2020,1 - 4 years,0,0,0
Dungarvan Town,2020,10 - 14 years,0,0,0
Dungarvan Town,2020,15 - 19 years,0,0,0
Dungarvan Town,2020,20 - 24 years,0,0,0
Dungarvan Town,2020,25 - 29 years,0,1,1
Dungarvan Town,2020,30 - 34 years,0,0,0
Dungarvan Town,2020,35 - 39 years,0,1,1
Dungarvan Town,2020,40 - 44 years,0,0,0
Dungarvan Town,2020,45 - 49 years,0,0,0
Dungarvan Town,2020,5 - 9 years,0,0,0
Dungarvan Town,2020,50 - 54 years,0,1,1
Dungarvan Town,2020,55 - 59 years,0,1,1
Dungarvan Town,2020,60 - 64 years,2,3,5
Dungarvan Town,2020,65 - 69 years,1,5,6
Dungarvan Town,2020,70 - 74 years,4,1,5
Dungarvan Town,2020,75 - 79 years,3,5,8
Dungarvan Town,2020,80 - 84 years,4,6,10
Dungarvan Town,2020,85 years and over,20,11,31
Dungarvan Town,2020,Under 1 year,0,0,0
Ennis Town,2007,1 - 4 years,0,0,0
Ennis Town,2007,10 - 14 years,0,0,0
Ennis Town,2007,15 - 19 years,1,2,3
Ennis Town,2007,20 - 24 years,0,1,1
Ennis Town,2007,25 - 29 years,0,2,2
Ennis Town,2007,30 - 34 years,0,3,3
Ennis Town,2007,35 - 39 years,0,1,1
Ennis Town,2007,40 - 44 years,1,2,3
Ennis Town,2007,45 - 49 years,2,0,2
Ennis Town,2007,5 - 9 years,0,0,0
Ennis Town,2007,50 - 54 years,1,4,5
Ennis Town,2007,55 - 59 years,1,2,3
Ennis Town,2007,60 - 64 years,4,5,9
Ennis Town,2007,65 - 69 years,4,5,9
Ennis Town,2007,70 - 74 years,4,5,9
Ennis Town,2007,75 - 79 years,14,11,25
Ennis Town,2007,80 - 84 years,14,9,23
Ennis Town,2007,85 years and over,17,9,26
Ennis Town,2007,Under 1 year,1,1,2
Ennis Town,2008,1 - 4 years,0,0,0
Ennis Town,2008,10 - 14 years,0,0,0
Ennis Town,2008,15 - 19 years,2,2,4
Ennis Town,2008,20 - 24 years,0,1,1
Ennis Town,2008,25 - 29 years,0,1,1
Ennis Town,2008,30 - 34 years,0,3,3
Ennis Town,2008,35 - 39 years,0,1,1
Ennis Town,2008,40 - 44 years,1,2,3
Ennis Town,2008,45 - 49 years,1,2,3
Ennis Town,2008,5 - 9 years,0,1,1
Ennis Town,2008,50 - 54 years,2,2,4
Ennis Town,2008,55 - 59 years,4,6,10
Ennis Town,2008,60 - 64 years,3,6,9
Ennis Town,2008,65 - 69 years,4,7,11
Ennis Town,2008,70 - 74 years,7,10,17
Ennis Town,2008,75 - 79 years,7,11,18
Ennis Town,2008,80 - 84 years,15,11,26
Ennis Town,2008,85 years and over,20,17,37
Ennis Town,2008,Under 1 year,1,4,5
Ennis Town,2009,1 - 4 years,0,0,0
Ennis Town,2009,10 - 14 years,0,0,0
Ennis Town,2009,15 - 19 years,2,2,4
Ennis Town,2009,20 - 24 years,0,1,1
Ennis Town,2009,25 - 29 years,0,1,1
Ennis Town,2009,30 - 34 years,0,1,1
Ennis Town,2009,35 - 39 years,1,3,4
Ennis Town,2009,40 - 44 years,1,3,4
Ennis Town,2009,45 - 49 years,3,3,6
Ennis Town,2009,5 - 9 years,0,1,1
Ennis Town,2009,50 - 54 years,3,6,9
Ennis Town,2009,55 - 59 years,1,2,3
Ennis Town,2009,60 - 64 years,1,6,7
Ennis Town,2009,65 - 69 years,5,7,12
Ennis Town,2009,70 - 74 years,3,9,12
Ennis Town,2009,75 - 79 years,2,8,10
Ennis Town,2009,80 - 84 years,11,9,20
Ennis Town,2009,85 years and over,26,10,36
Ennis Town,2009,Under 1 year,2,1,3
Ennis Town,2010,1 - 4 years,0,0,0
Ennis Town,2010,10 - 14 years,0,0,0
Ennis Town,2010,15 - 19 years,1,2,3
Ennis Town,2010,20 - 24 years,0,2,2
Ennis Town,2010,25 - 29 years,0,3,3
Ennis Town,2010,30 - 34 years,0,4,4
Ennis Town,2010,35 - 39 years,2,3,5
Ennis Town,2010,40 - 44 years,1,3,4
Ennis Town,2010,45 - 49 years,1,3,4
Ennis Town,2010,5 - 9 years,0,1,1
Ennis Town,2010,50 - 54 years,4,1,5
Ennis Town,2010,55 - 59 years,1,3,4
Ennis Town,2010,60 - 64 years,4,7,11
Ennis Town,2010,65 - 69 years,2,6,8
Ennis Town,2010,70 - 74 years,5,10,15
Ennis Town,2010,75 - 79 years,3,9,12
Ennis Town,2010,80 - 84 years,10,13,23
Ennis Town,2010,85 years and over,21,7,28
Ennis Town,2010,Under 1 year,1,1,2
Ennis Town,2011,1 - 4 years,0,0,0
Ennis Town,2011,10 - 14 years,0,0,0
Ennis Town,2011,15 - 19 years,0,0,0
Ennis Town,2011,20 - 24 years,1,1,2
Ennis Town,2011,25 - 29 years,1,0,1
Ennis Town,2011,30 - 34 years,1,1,2
Ennis Town,2011,35 - 39 years,0,0,0
Ennis Town,2011,40 - 44 years,0,1,1
Ennis Town,2011,45 - 49 years,1,1,2
Ennis Town,2011,5 - 9 years,0,0,0
Ennis Town,2011,50 - 54 years,0,1,1
Ennis Town,2011,55 - 59 years,1,3,4
Ennis Town,2011,60 - 64 years,2,3,5
Ennis Town,2011,65 - 69 years,8,6,14
Ennis Town,2011,70 - 74 years,7,3,10
Ennis Town,2011,75 - 79 years,13,3,16
Ennis Town,2011,80 - 84 years,8,9,17
Ennis Town,2011,85 years and over,20,9,29
Ennis Town,2011,Under 1 year,3,0,3
Ennis Town,2012,1 - 4 years,0,0,0
Ennis Town,2012,10 - 14 years,0,0,0
Ennis Town,2012,15 - 19 years,0,0,0
Ennis Town,2012,20 - 24 years,1,1,2
Ennis Town,2012,25 - 29 years,1,0,1
Ennis Town,2012,30 - 34 years,1,1,2
Ennis Town,2012,35 - 39 years,0,0,0
Ennis Town,2012,40 - 44 years,2,3,5
Ennis Town,2012,45 - 49 years,1,1,2
Ennis Town,2012,5 - 9 years,0,0,0
Ennis Town,2012,50 - 54 years,1,8,9
Ennis Town,2012,55 - 59 years,1,7,8
Ennis Town,2012,60 - 64 years,1,6,7
Ennis Town,2012,65 - 69 years,4,6,10
Ennis Town,2012,70 - 74 years,4,7,11
Ennis Town,2012,75 - 79 years,6,14,20
Ennis Town,2012,80 - 84 years,10,7,17
Ennis Town,2012,85 years and over,37,24,61
Ennis Town,2012,Under 1 year,3,0,3
Ennis Town,2013,1 - 4 years,0,0,0
Ennis Town,2013,10 - 14 years,0,0,0
Ennis Town,2013,15 - 19 years,0,0,0
Ennis Town,2013,20 - 24 years,0,3,3
Ennis Town,2013,25 - 29 years,0,1,1
Ennis Town,2013,30 - 34 years,0,1,1
Ennis Town,2013,35 - 39 years,0,2,2
Ennis Town,2013,40 - 44 years,2,2,4
Ennis Town,2013,45 - 49 years,1,1,2
Ennis Town,2013,5 - 9 years,0,0,0
Ennis Town,2013,50 - 54 years,2,4,6
Ennis Town,2013,55 - 59 years,2,2,4
Ennis Town,2013,60 - 64 years,6,6,12
Ennis Town,2013,65 - 69 years,5,6,11
Ennis Town,2013,70 - 74 years,4,13,17
Ennis Town,2013,75 - 79 years,3,6,9
Ennis Town,2013,80 - 84 years,11,6,17
Ennis Town,2013,85 years and over,25,15,40
Ennis Town,2013,Under 1 year,0,0,0
Ennis Town,2014,1 - 4 years,0,0,0
Ennis Town,2014,10 - 14 years,0,0,0
Ennis Town,2014,15 - 19 years,0,0,0
Ennis Town,2014,20 - 24 years,0,3,3
Ennis Town,2014,25 - 29 years,0,2,2
Ennis Town,2014,30 - 34 years,0,1,1
Ennis Town,2014,35 - 39 years,0,1,1
Ennis Town,2014,40 - 44 years,1,2,3
Ennis Town,2014,45 - 49 years,1,1,2
Ennis Town,2014,5 - 9 years,0,0,0
Ennis Town,2014,50 - 54 years,2,2,4
Ennis Town,2014,55 - 59 years,1,4,5
Ennis Town,2014,60 - 64 years,2,4,6
Ennis Town,2014,65 - 69 years,4,6,10
Ennis Town,2014,70 - 74 years,6,10,16
Ennis Town,2014,75 - 79 years,9,14,23
Ennis Town,2014,80 - 84 years,13,11,24
Ennis Town,2014,85 years and over,26,18,44
Ennis Town,2014,Under 1 year,0,1,1
Ennis Town,2015,1 - 4 years,0,0,0
Ennis Town,2015,10 - 14 years,0,0,0
Ennis Town,2015,15 - 19 years,0,0,0
Ennis Town,2015,20 - 24 years,0,3,3
Ennis Town,2015,25 - 29 years,0,2,2
Ennis Town,2015,30 - 34 years,0,1,1
Ennis Town,2015,35 - 39 years,0,1,1
Ennis Town,2015,40 - 44 years,1,2,3
Ennis Town,2015,45 - 49 years,1,1,2
Ennis Town,2015,5 - 9 years,0,0,0
Ennis Town,2015,50 - 54 years,2,2,4
Ennis Town,2015,55 - 59 years,1,4,5
Ennis Town,2015,60 - 64 years,2,4,6
Ennis Town,2015,65 - 69 years,4,6,10
Ennis Town,2015,70 - 74 years,6,10,16
Ennis Town,2015,75 - 79 years,9,14,23
Ennis Town,2015,80 - 84 years,13,11,24
Ennis Town,2015,85 years and over,26,18,44
Ennis Town,2015,Under 1 year,0,1,1
Ennis Town,2016,1 - 4 years,0,0,0
Ennis Town,2016,10 - 14 years,0,0,0
Ennis Town,2016,15 - 19 years,0,0,0
Ennis Town,2016,20 - 24 years,0,3,3
Ennis Town,2016,25 - 29 years,0,2,2
Ennis Town,2016,30 - 34 years,0,1,1
Ennis Town,2016,35 - 39 years,0,1,1
Ennis Town,2016,40 - 44 years,1,2,3
Ennis Town,2016,45 - 49 years,1,1,2
Ennis Town,2016,5 - 9 years,0,0,0
Ennis Town,2016,50 - 54 years,2,2,4
Ennis Town,2016,55 - 59 years,1,4,5
Ennis Town,2016,60 - 64 years,2,4,6
Ennis Town,2016,65 - 69 years,4,6,10
Ennis Town,2016,70 - 74 years,6,10,16
Ennis Town,2016,75 - 79 years,9,14,23
Ennis Town,2016,80 - 84 years,13,11,24
Ennis Town,2016,85 years and over,26,18,44
Ennis Town,2016,Under 1 year,0,1,1
Ennis Town,2017,1 - 4 years,0,0,0
Ennis Town,2017,10 - 14 years,0,0,0
Ennis Town,2017,15 - 19 years,0,3,3
Ennis Town,2017,20 - 24 years,2,3,5
Ennis Town,2017,25 - 29 years,0,1,1
Ennis Town,2017,30 - 34 years,0,2,2
Ennis Town,2017,35 - 39 years,1,1,2
Ennis Town,2017,40 - 44 years,1,2,3
Ennis Town,2017,45 - 49 years,1,1,2
Ennis Town,2017,5 - 9 years,0,0,0
Ennis Town,2017,50 - 54 years,2,2,4
Ennis Town,2017,55 - 59 years,3,5,8
Ennis Town,2017,60 - 64 years,2,3,5
Ennis Town,2017,65 - 69 years,8,6,14
Ennis Town,2017,70 - 74 years,5,13,18
Ennis Town,2017,75 - 79 years,7,5,12
Ennis Town,2017,80 - 84 years,10,8,18
Ennis Town,2017,85 years and over,21,16,37
Ennis Town,2017,Under 1 year,1,1,2
Ennis Town,2018,1 - 4 years,0,0,0
Ennis Town,2018,10 - 14 years,0,1,1
Ennis Town,2018,15 - 19 years,0,2,2
Ennis Town,2018,20 - 24 years,0,0,0
Ennis Town,2018,25 - 29 years,0,0,0
Ennis Town,2018,30 - 34 years,0,0,0
Ennis Town,2018,35 - 39 years,0,0,0
Ennis Town,2018,40 - 44 years,2,0,2
Ennis Town,2018,45 - 49 years,1,4,5
Ennis Town,2018,5 - 9 years,0,0,0
Ennis Town,2018,50 - 54 years,0,1,1
Ennis Town,2018,55 - 59 years,2,3,5
Ennis Town,2018,60 - 64 years,2,5,7
Ennis Town,2018,65 - 69 years,5,8,13
Ennis Town,2018,70 - 74 years,7,8,15
Ennis Town,2018,75 - 79 years,3,10,13
Ennis Town,2018,80 - 84 years,6,11,17
Ennis Town,2018,85 years and over,33,19,52
Ennis Town,2018,Under 1 year,0,0,0
Ennis Town,2019,1 - 4 years,0,0,0
Ennis Town,2019,10 - 14 years,0,1,1
Ennis Town,2019,15 - 19 years,0,2,2
Ennis Town,2019,20 - 24 years,0,0,0
Ennis Town,2019,25 - 29 years,0,0,0
Ennis Town,2019,30 - 34 years,0,0,0
Ennis Town,2019,35 - 39 years,0,0,0
Ennis Town,2019,40 - 44 years,2,0,2
Ennis Town,2019,45 - 49 years,1,4,5
Ennis Town,2019,5 - 9 years,0,0,0
Ennis Town,2019,50 - 54 years,0,1,1
Ennis Town,2019,55 - 59 years,2,3,5
Ennis Town,2019,60 - 64 years,2,5,7
Ennis Town,2019,65 - 69 years,5,8,13
Ennis Town,2019,70 - 74 years,7,8,15
Ennis Town,2019,75 - 79 years,3,10,13
Ennis Town,2019,80 - 84 years,6,11,17
Ennis Town,2019,85 years and over,33,19,52
Ennis Town,2019,Under 1 year,0,0,0
Ennis Town,2020,1 - 4 years,0,0,0
Ennis Town,2020,10 - 14 years,0,1,1
Ennis Town,2020,15 - 19 years,0,2,2
Ennis Town,2020,20 - 24 years,0,0,0
Ennis Town,2020,25 - 29 years,0,0,0
Ennis Town,2020,30 - 34 years,0,0,0
Ennis Town,2020,35 - 39 years,0,0,0
Ennis Town,2020,40 - 44 years,2,0,2
Ennis Town,2020,45 - 49 years,1,4,5
Ennis Town,2020,5 - 9 years,0,0,0
Ennis Town,2020,50 - 54 years,0,1,1
Ennis Town,2020,55 - 59 years,2,3,5
Ennis Town,2020,60 - 64 years,2,5,7
Ennis Town,2020,65 - 69 years,5,8,13
Ennis Town,2020,70 - 74 years,7,8,15
Ennis Town,2020,75 - 79 years,3,10,13
Ennis Town,2020,80 - 84 years,6,11,17
Ennis Town,2020,85 years and over,33,19,52
Ennis Town,2020,Under 1 year,0,0,0
Enniscorthy Town,2007,1 - 4 years,0,0,0
Enniscorthy Town,2007,10 - 14 years,0,0,0
Enniscorthy Town,2007,15 - 19 years,1,1,2
Enniscorthy Town,2007,20 - 24 years,0,1,1
Enniscorthy Town,2007,25 - 29 years,0,1,1
Enniscorthy Town,2007,30 - 34 years,0,1,1
Enniscorthy Town,2007,35 - 39 years,1,3,4
Enniscorthy Town,2007,40 - 44 years,0,3,3
Enniscorthy Town,2007,45 - 49 years,2,3,5
Enniscorthy Town,2007,5 - 9 years,0,0,0
Enniscorthy Town,2007,50 - 54 years,2,1,3
Enniscorthy Town,2007,55 - 59 years,3,4,7
Enniscorthy Town,2007,60 - 64 years,4,5,9
Enniscorthy Town,2007,65 - 69 years,4,8,12
Enniscorthy Town,2007,70 - 74 years,7,10,17
Enniscorthy Town,2007,75 - 79 years,7,11,18
Enniscorthy Town,2007,80 - 84 years,15,11,26
Enniscorthy Town,2007,85 years and over,21,12,33
Enniscorthy Town,2007,Under 1 year,0,2,2
Enniscorthy Town,2008,1 - 4 years,0,0,0
Enniscorthy Town,2008,10 - 14 years,0,0,0
Enniscorthy Town,2008,15 - 19 years,1,2,3
Enniscorthy Town,2008,20 - 24 years,0,1,1
Enniscorthy Town,2008,25 - 29 years,1,1,2
Enniscorthy Town,2008,30 - 34 years,1,1,2
Enniscorthy Town,2008,35 - 39 years,1,2,3
Enniscorthy Town,2008,40 - 44 years,0,3,3
Enniscorthy Town,2008,45 - 49 years,6,3,9
Enniscorthy Town,2008,5 - 9 years,0,0,0
Enniscorthy Town,2008,50 - 54 years,1,5,6
Enniscorthy Town,2008,55 - 59 years,3,5,8
Enniscorthy Town,2008,60 - 64 years,4,7,11
Enniscorthy Town,2008,65 - 69 years,3,13,16
Enniscorthy Town,2008,70 - 74 years,5,8,13
Enniscorthy Town,2008,75 - 79 years,7,11,18
Enniscorthy Town,2008,80 - 84 years,9,12,21
Enniscorthy Town,2008,85 years and over,33,12,45
Enniscorthy Town,2008,Under 1 year,3,1,4
Enniscorthy Town,2009,1 - 4 years,0,0,0
Enniscorthy Town,2009,10 - 14 years,0,0,0
Enniscorthy Town,2009,15 - 19 years,1,2,3
Enniscorthy Town,2009,20 - 24 years,0,1,1
Enniscorthy Town,2009,25 - 29 years,1,1,2
Enniscorthy Town,2009,30 - 34 years,1,1,2
Enniscorthy Town,2009,35 - 39 years,1,2,3
Enniscorthy Town,2009,40 - 44 years,1,3,4
Enniscorthy Town,2009,45 - 49 years,6,1,7
Enniscorthy Town,2009,5 - 9 years,0,0,0
Enniscorthy Town,2009,50 - 54 years,1,5,6
Enniscorthy Town,2009,55 - 59 years,2,3,5
Enniscorthy Town,2009,60 - 64 years,4,1,5
Enniscorthy Town,2009,65 - 69 years,4,6,10
Enniscorthy Town,2009,70 - 74 years,3,3,6
Enniscorthy Town,2009,75 - 79 years,4,1,5
Enniscorthy Town,2009,80 - 84 years,9,9,18
Enniscorthy Town,2009,85 years and over,13,6,19
Enniscorthy Town,2009,Under 1 year,1,1,2
Enniscorthy Town,2010,1 - 4 years,0,0,0
Enniscorthy Town,2010,10 - 14 years,0,0,0
Enniscorthy Town,2010,15 - 19 years,1,2,3
Enniscorthy Town,2010,20 - 24 years,0,1,1
Enniscorthy Town,2010,25 - 29 years,1,1,2
Enniscorthy Town,2010,30 - 34 years,1,1,2
Enniscorthy Town,2010,35 - 39 years,1,2,3
Enniscorthy Town,2010,40 - 44 years,1,3,4
Enniscorthy Town,2010,45 - 49 years,1,1,2
Enniscorthy Town,2010,5 - 9 years,0,0,0
Enniscorthy Town,2010,50 - 54 years,1,1,2
Enniscorthy Town,2010,55 - 59 years,1,5,6
Enniscorthy Town,2010,60 - 64 years,2,7,9
Enniscorthy Town,2010,65 - 69 years,2,1,3
Enniscorthy Town,2010,70 - 74 years,3,7,10
Enniscorthy Town,2010,75 - 79 years,11,4,15
Enniscorthy Town,2010,80 - 84 years,7,6,13
Enniscorthy Town,2010,85 years and over,18,5,23
Enniscorthy Town,2010,Under 1 year,1,1,2
Enniscorthy Town,2011,1 - 4 years,0,0,0
Enniscorthy Town,2011,10 - 14 years,0,0,0
Enniscorthy Town,2011,15 - 19 years,0,0,0
Enniscorthy Town,2011,20 - 24 years,0,1,1
Enniscorthy Town,2011,25 - 29 years,0,2,2
Enniscorthy Town,2011,30 - 34 years,0,2,2
Enniscorthy Town,2011,35 - 39 years,0,0,0
Enniscorthy Town,2011,40 - 44 years,1,2,3
Enniscorthy Town,2011,45 - 49 years,0,0,0
Enniscorthy Town,2011,5 - 9 years,0,0,0
Enniscorthy Town,2011,50 - 54 years,0,1,1
Enniscorthy Town,2011,55 - 59 years,0,0,0
Enniscorthy Town,2011,60 - 64 years,2,3,5
Enniscorthy Town,2011,65 - 69 years,1,0,1
Enniscorthy Town,2011,70 - 74 years,0,4,4
Enniscorthy Town,2011,75 - 79 years,4,3,7
Enniscorthy Town,2011,80 - 84 years,4,4,8
Enniscorthy Town,2011,85 years and over,18,7,25
Enniscorthy Town,2011,Under 1 year,0,1,1
Enniscorthy Town,2012,1 - 4 years,0,1,1
Enniscorthy Town,2012,10 - 14 years,0,0,0
Enniscorthy Town,2012,15 - 19 years,1,0,1
Enniscorthy Town,2012,20 - 24 years,0,1,1
Enniscorthy Town,2012,25 - 29 years,0,2,2
Enniscorthy Town,2012,30 - 34 years,0,2,2
Enniscorthy Town,2012,35 - 39 years,1,0,1
Enniscorthy Town,2012,40 - 44 years,1,2,3
Enniscorthy Town,2012,45 - 49 years,4,0,4
Enniscorthy Town,2012,5 - 9 years,0,0,0
Enniscorthy Town,2012,50 - 54 years,0,3,3
Enniscorthy Town,2012,55 - 59 years,2,2,4
Enniscorthy Town,2012,60 - 64 years,5,4,9
Enniscorthy Town,2012,65 - 69 years,2,8,10
Enniscorthy Town,2012,70 - 74 years,5,4,9
Enniscorthy Town,2012,75 - 79 years,8,5,13
Enniscorthy Town,2012,80 - 84 years,12,10,22
Enniscorthy Town,2012,85 years and over,27,12,39
Enniscorthy Town,2012,Under 1 year,2,1,3
Enniscorthy Town,2013,1 - 4 years,0,0,0
Enniscorthy Town,2013,10 - 14 years,0,0,0
Enniscorthy Town,2013,15 - 19 years,0,0,0
Enniscorthy Town,2013,20 - 24 years,0,0,0
Enniscorthy Town,2013,25 - 29 years,0,0,0
Enniscorthy Town,2013,30 - 34 years,0,1,1
Enniscorthy Town,2013,35 - 39 years,0,1,1
Enniscorthy Town,2013,40 - 44 years,0,0,0
Enniscorthy Town,2013,45 - 49 years,0,2,2
Enniscorthy Town,2013,5 - 9 years,0,0,0
Enniscorthy Town,2013,50 - 54 years,0,0,0
Enniscorthy Town,2013,55 - 59 years,1,3,4
Enniscorthy Town,2013,60 - 64 years,0,0,0
Enniscorthy Town,2013,65 - 69 years,4,5,9
Enniscorthy Town,2013,70 - 74 years,1,3,4
Enniscorthy Town,2013,75 - 79 years,5,6,11
Enniscorthy Town,2013,80 - 84 years,9,6,15
Enniscorthy Town,2013,85 years and over,12,8,20
Enniscorthy Town,2013,Under 1 year,0,0,0
Enniscorthy Town,2014,1 - 4 years,0,0,0
Enniscorthy Town,2014,10 - 14 years,0,0,0
Enniscorthy Town,2014,15 - 19 years,0,0,0
Enniscorthy Town,2014,20 - 24 years,0,0,0
Enniscorthy Town,2014,25 - 29 years,0,0,0
Enniscorthy Town,2014,30 - 34 years,0,1,1
Enniscorthy Town,2014,35 - 39 years,0,1,1
Enniscorthy Town,2014,40 - 44 years,0,0,0
Enniscorthy Town,2014,45 - 49 years,0,1,1
Enniscorthy Town,2014,5 - 9 years,0,0,0
Enniscorthy Town,2014,50 - 54 years,2,0,2
Enniscorthy Town,2014,55 - 59 years,1,4,5
Enniscorthy Town,2014,60 - 64 years,0,5,5
Enniscorthy Town,2014,65 - 69 years,1,2,3
Enniscorthy Town,2014,70 - 74 years,2,2,4
Enniscorthy Town,2014,75 - 79 years,3,5,8
Enniscorthy Town,2014,80 - 84 years,10,6,16
Enniscorthy Town,2014,85 years and over,11,4,15
Enniscorthy Town,2014,Under 1 year,0,0,0
Enniscorthy Town,2015,1 - 4 years,0,0,0
Enniscorthy Town,2015,10 - 14 years,0,0,0
Enniscorthy Town,2015,15 - 19 years,0,0,0
Enniscorthy Town,2015,20 - 24 years,0,0,0
Enniscorthy Town,2015,25 - 29 years,0,0,0
Enniscorthy Town,2015,30 - 34 years,0,1,1
Enniscorthy Town,2015,35 - 39 years,0,1,1
Enniscorthy Town,2015,40 - 44 years,0,0,0
Enniscorthy Town,2015,45 - 49 years,0,1,1
Enniscorthy Town,2015,5 - 9 years,0,0,0
Enniscorthy Town,2015,50 - 54 years,2,0,2
Enniscorthy Town,2015,55 - 59 years,1,4,5
Enniscorthy Town,2015,60 - 64 years,0,5,5
Enniscorthy Town,2015,65 - 69 years,1,2,3
Enniscorthy Town,2015,70 - 74 years,2,2,4
Enniscorthy Town,2015,75 - 79 years,3,5,8
Enniscorthy Town,2015,80 - 84 years,10,6,16
Enniscorthy Town,2015,85 years and over,11,4,15
Enniscorthy Town,2015,Under 1 year,0,0,0
Enniscorthy Town,2016,1 - 4 years,0,0,0
Enniscorthy Town,2016,10 - 14 years,0,0,0
Enniscorthy Town,2016,15 - 19 years,0,0,0
Enniscorthy Town,2016,20 - 24 years,0,0,0
Enniscorthy Town,2016,25 - 29 years,0,0,0
Enniscorthy Town,2016,30 - 34 years,0,1,1
Enniscorthy Town,2016,35 - 39 years,0,1,1
Enniscorthy Town,2016,40 - 44 years,0,0,0
Enniscorthy Town,2016,45 - 49 years,0,1,1
Enniscorthy Town,2016,5 - 9 years,0,0,0
Enniscorthy Town,2016,50 - 54 years,2,0,2
Enniscorthy Town,2016,55 - 59 years,1,4,5
Enniscorthy Town,2016,60 - 64 years,0,5,5
Enniscorthy Town,2016,65 - 69 years,1,2,3
Enniscorthy Town,2016,70 - 74 years,2,2,4
Enniscorthy Town,2016,75 - 79 years,3,5,8
Enniscorthy Town,2016,80 - 84 years,10,6,16
Enniscorthy Town,2016,85 years and over,11,4,15
Enniscorthy Town,2016,Under 1 year,0,0,0
Enniscorthy Town,2017,1 - 4 years,0,0,0
Enniscorthy Town,2017,10 - 14 years,0,0,0
Enniscorthy Town,2017,15 - 19 years,0,0,0
Enniscorthy Town,2017,20 - 24 years,0,0,0
Enniscorthy Town,2017,25 - 29 years,0,0,0
Enniscorthy Town,2017,30 - 34 years,0,1,1
Enniscorthy Town,2017,35 - 39 years,0,1,1
Enniscorthy Town,2017,40 - 44 years,0,0,0
Enniscorthy Town,2017,45 - 49 years,0,1,1
Enniscorthy Town,2017,5 - 9 years,0,0,0
Enniscorthy Town,2017,50 - 54 years,2,0,2
Enniscorthy Town,2017,55 - 59 years,1,3,4
Enniscorthy Town,2017,60 - 64 years,1,1,2
Enniscorthy Town,2017,65 - 69 years,4,2,6
Enniscorthy Town,2017,70 - 74 years,3,4,7
Enniscorthy Town,2017,75 - 79 years,3,4,7
Enniscorthy Town,2017,80 - 84 years,3,8,11
Enniscorthy Town,2017,85 years and over,7,4,11
Enniscorthy Town,2017,Under 1 year,0,0,0
Enniscorthy Town,2018,1 - 4 years,0,0,0
Enniscorthy Town,2018,10 - 14 years,0,0,0
Enniscorthy Town,2018,15 - 19 years,0,0,0
Enniscorthy Town,2018,20 - 24 years,0,0,0
Enniscorthy Town,2018,25 - 29 years,0,0,0
Enniscorthy Town,2018,30 - 34 years,0,1,1
Enniscorthy Town,2018,35 - 39 years,0,0,0
Enniscorthy Town,2018,40 - 44 years,1,1,2
Enniscorthy Town,2018,45 - 49 years,0,0,0
Enniscorthy Town,2018,5 - 9 years,0,0,0
Enniscorthy Town,2018,50 - 54 years,0,1,1
Enniscorthy Town,2018,55 - 59 years,2,2,4
Enniscorthy Town,2018,60 - 64 years,0,0,0
Enniscorthy Town,2018,65 - 69 years,1,1,2
Enniscorthy Town,2018,70 - 74 years,2,5,7
Enniscorthy Town,2018,75 - 79 years,6,4,10
Enniscorthy Town,2018,80 - 84 years,5,5,10
Enniscorthy Town,2018,85 years and over,13,13,26
Enniscorthy Town,2018,Under 1 year,0,0,0
Enniscorthy Town,2019,1 - 4 years,0,0,0
Enniscorthy Town,2019,10 - 14 years,0,0,0
Enniscorthy Town,2019,15 - 19 years,0,0,0
Enniscorthy Town,2019,20 - 24 years,0,0,0
Enniscorthy Town,2019,25 - 29 years,0,0,0
Enniscorthy Town,2019,30 - 34 years,0,1,1
Enniscorthy Town,2019,35 - 39 years,0,0,0
Enniscorthy Town,2019,40 - 44 years,1,1,2
Enniscorthy Town,2019,45 - 49 years,0,0,0
Enniscorthy Town,2019,5 - 9 years,0,0,0
Enniscorthy Town,2019,50 - 54 years,0,1,1
Enniscorthy Town,2019,55 - 59 years,2,2,4
Enniscorthy Town,2019,60 - 64 years,0,0,0
Enniscorthy Town,2019,65 - 69 years,1,1,2
Enniscorthy Town,2019,70 - 74 years,2,5,7
Enniscorthy Town,2019,75 - 79 years,6,4,10
Enniscorthy Town,2019,80 - 84 years,5,5,10
Enniscorthy Town,2019,85 years and over,13,13,26
Enniscorthy Town,2019,Under 1 year,0,0,0
Enniscorthy Town,2020,1 - 4 years,0,0,0
Enniscorthy Town,2020,10 - 14 years,0,0,0
Enniscorthy Town,2020,15 - 19 years,0,0,0
Enniscorthy Town,2020,20 - 24 years,0,0,0
Enniscorthy Town,2020,25 - 29 years,0,0,0
Enniscorthy Town,2020,30 - 34 years,0,1,1
Enniscorthy Town,2020,35 - 39 years,0,0,0
Enniscorthy Town,2020,40 - 44 years,1,1,2
Enniscorthy Town,2020,45 - 49 years,0,0,0
Enniscorthy Town,2020,5 - 9 years,0,0,0
Enniscorthy Town,2020,50 - 54 years,0,1,1
Enniscorthy Town,2020,55 - 59 years,2,2,4
Enniscorthy Town,2020,60 - 64 years,0,0,0
Enniscorthy Town,2020,65 - 69 years,1,1,2
Enniscorthy Town,2020,70 - 74 years,2,5,7
Enniscorthy Town,2020,75 - 79 years,6,4,10
Enniscorthy Town,2020,80 - 84 years,5,5,10
Enniscorthy Town,2020,85 years and over,13,13,26
Enniscorthy Town,2020,Under 1 year,0,0,0
Fermoy Town,2007,1 - 4 years,0,0,0
Fermoy Town,2007,10 - 14 years,0,1,1
Fermoy Town,2007,15 - 19 years,0,0,0
Fermoy Town,2007,20 - 24 years,0,0,0
Fermoy Town,2007,25 - 29 years,0,0,0
Fermoy Town,2007,30 - 34 years,0,0,0
Fermoy Town,2007,35 - 39 years,0,0,0
Fermoy Town,2007,40 - 44 years,0,0,0
Fermoy Town,2007,45 - 49 years,0,0,0
Fermoy Town,2007,5 - 9 years,0,0,0
Fermoy Town,2007,50 - 54 years,1,2,3
Fermoy Town,2007,55 - 59 years,3,0,3
Fermoy Town,2007,60 - 64 years,1,0,1
Fermoy Town,2007,65 - 69 years,2,4,6
Fermoy Town,2007,70 - 74 years,1,2,3
Fermoy Town,2007,75 - 79 years,2,6,8
Fermoy Town,2007,80 - 84 years,7,4,11
Fermoy Town,2007,85 years and over,13,5,18
Fermoy Town,2007,Under 1 year,2,0,2
Fermoy Town,2008,1 - 4 years,0,0,0
Fermoy Town,2008,10 - 14 years,0,1,1
Fermoy Town,2008,15 - 19 years,1,1,2
Fermoy Town,2008,20 - 24 years,0,0,0
Fermoy Town,2008,25 - 29 years,1,0,1
Fermoy Town,2008,30 - 34 years,0,0,0
Fermoy Town,2008,35 - 39 years,0,0,0
Fermoy Town,2008,40 - 44 years,0,1,1
Fermoy Town,2008,45 - 49 years,0,2,2
Fermoy Town,2008,5 - 9 years,0,0,0
Fermoy Town,2008,50 - 54 years,1,1,2
Fermoy Town,2008,55 - 59 years,1,0,1
Fermoy Town,2008,60 - 64 years,1,1,2
Fermoy Town,2008,65 - 69 years,3,2,5
Fermoy Town,2008,70 - 74 years,3,5,8
Fermoy Town,2008,75 - 79 years,2,5,7
Fermoy Town,2008,80 - 84 years,5,2,7
Fermoy Town,2008,85 years and over,11,6,17
Fermoy Town,2008,Under 1 year,2,0,2
Fermoy Town,2009,1 - 4 years,0,0,0
Fermoy Town,2009,10 - 14 years,0,1,1
Fermoy Town,2009,15 - 19 years,1,1,2
Fermoy Town,2009,20 - 24 years,0,0,0
Fermoy Town,2009,25 - 29 years,1,0,1
Fermoy Town,2009,30 - 34 years,0,0,0
Fermoy Town,2009,35 - 39 years,0,0,0
Fermoy Town,2009,40 - 44 years,0,1,1
Fermoy Town,2009,45 - 49 years,0,1,1
Fermoy Town,2009,5 - 9 years,0,0,0
Fermoy Town,2009,50 - 54 years,1,2,3
Fermoy Town,2009,55 - 59 years,1,1,2
Fermoy Town,2009,60 - 64 years,1,3,4
Fermoy Town,2009,65 - 69 years,3,4,7
Fermoy Town,2009,70 - 74 years,3,6,9
Fermoy Town,2009,75 - 79 years,3,3,6
Fermoy Town,2009,80 - 84 years,3,2,5
Fermoy Town,2009,85 years and over,13,4,17
Fermoy Town,2009,Under 1 year,2,0,2
Fermoy Town,2010,1 - 4 years,0,0,0
Fermoy Town,2010,10 - 14 years,0,1,1
Fermoy Town,2010,15 - 19 years,1,1,2
Fermoy Town,2010,20 - 24 years,0,0,0
Fermoy Town,2010,25 - 29 years,1,0,1
Fermoy Town,2010,30 - 34 years,0,0,0
Fermoy Town,2010,35 - 39 years,0,1,1
Fermoy Town,2010,40 - 44 years,0,1,1
Fermoy Town,2010,45 - 49 years,0,1,1
Fermoy Town,2010,5 - 9 years,0,0,0
Fermoy Town,2010,50 - 54 years,2,1,3
Fermoy Town,2010,55 - 59 years,1,1,2
Fermoy Town,2010,60 - 64 years,1,3,4
Fermoy Town,2010,65 - 69 years,3,3,6
Fermoy Town,2010,70 - 74 years,2,1,3
Fermoy Town,2010,75 - 79 years,3,5,8
Fermoy Town,2010,80 - 84 years,1,1,2
Fermoy Town,2010,85 years and over,8,3,11
Fermoy Town,2010,Under 1 year,2,0,2
Fermoy Town,2011,1 - 4 years,0,0,0
Fermoy Town,2011,10 - 14 years,0,0,0
Fermoy Town,2011,15 - 19 years,0,0,0
Fermoy Town,2011,20 - 24 years,0,1,1
Fermoy Town,2011,25 - 29 years,0,0,0
Fermoy Town,2011,30 - 34 years,0,1,1
Fermoy Town,2011,35 - 39 years,0,0,0
Fermoy Town,2011,40 - 44 years,0,0,0
Fermoy Town,2011,45 - 49 years,1,0,1
Fermoy Town,2011,5 - 9 years,0,0,0
Fermoy Town,2011,50 - 54 years,1,1,2
Fermoy Town,2011,55 - 59 years,0,0,0
Fermoy Town,2011,60 - 64 years,1,0,1
Fermoy Town,2011,65 - 69 years,0,3,3
Fermoy Town,2011,70 - 74 years,1,2,3
Fermoy Town,2011,75 - 79 years,2,2,4
Fermoy Town,2011,80 - 84 years,6,1,7
Fermoy Town,2011,85 years and over,4,1,5
Fermoy Town,2011,Under 1 year,0,0,0
Fermoy Town,2012,1 - 4 years,0,0,0
Fermoy Town,2012,10 - 14 years,0,0,0
Fermoy Town,2012,15 - 19 years,0,1,1
Fermoy Town,2012,20 - 24 years,0,1,1
Fermoy Town,2012,25 - 29 years,0,0,0
Fermoy Town,2012,30 - 34 years,0,1,1
Fermoy Town,2012,35 - 39 years,0,1,1
Fermoy Town,2012,40 - 44 years,0,0,0
Fermoy Town,2012,45 - 49 years,1,1,2
Fermoy Town,2012,5 - 9 years,0,0,0
Fermoy Town,2012,50 - 54 years,1,1,2
Fermoy Town,2012,55 - 59 years,0,2,2
Fermoy Town,2012,60 - 64 years,2,2,4
Fermoy Town,2012,65 - 69 years,3,4,7
Fermoy Town,2012,70 - 74 years,3,3,6
Fermoy Town,2012,75 - 79 years,4,2,6
Fermoy Town,2012,80 - 84 years,1,2,3
Fermoy Town,2012,85 years and over,11,6,17
Fermoy Town,2012,Under 1 year,0,1,1
Fermoy Town,2013,1 - 4 years,0,0,0
Fermoy Town,2013,10 - 14 years,0,0,0
Fermoy Town,2013,15 - 19 years,0,0,0
Fermoy Town,2013,20 - 24 years,1,0,1
Fermoy Town,2013,25 - 29 years,0,0,0
Fermoy Town,2013,30 - 34 years,0,0,0
Fermoy Town,2013,35 - 39 years,0,0,0
Fermoy Town,2013,40 - 44 years,0,0,0
Fermoy Town,2013,45 - 49 years,0,0,0
Fermoy Town,2013,5 - 9 years,0,0,0
Fermoy Town,2013,50 - 54 years,0,1,1
Fermoy Town,2013,55 - 59 years,0,1,1
Fermoy Town,2013,60 - 64 years,0,2,2
Fermoy Town,2013,65 - 69 years,2,2,4
Fermoy Town,2013,70 - 74 years,2,2,4
Fermoy Town,2013,75 - 79 years,3,0,3
Fermoy Town,2013,80 - 84 years,3,2,5
Fermoy Town,2013,85 years and over,4,6,10
Fermoy Town,2013,Under 1 year,0,2,2
Fermoy Town,2014,1 - 4 years,0,0,0
Fermoy Town,2014,10 - 14 years,0,0,0
Fermoy Town,2014,15 - 19 years,0,0,0
Fermoy Town,2014,20 - 24 years,1,0,1
Fermoy Town,2014,25 - 29 years,0,0,0
Fermoy Town,2014,30 - 34 years,0,0,0
Fermoy Town,2014,35 - 39 years,0,1,1
Fermoy Town,2014,40 - 44 years,0,0,0
Fermoy Town,2014,45 - 49 years,0,0,0
Fermoy Town,2014,5 - 9 years,0,0,0
Fermoy Town,2014,50 - 54 years,0,1,1
Fermoy Town,2014,55 - 59 years,1,3,4
Fermoy Town,2014,60 - 64 years,0,1,1
Fermoy Town,2014,65 - 69 years,1,2,3
Fermoy Town,2014,70 - 74 years,1,2,3
Fermoy Town,2014,75 - 79 years,1,3,4
Fermoy Town,2014,80 - 84 years,5,1,6
Fermoy Town,2014,85 years and over,8,2,10
Fermoy Town,2014,Under 1 year,0,2,2
Fermoy Town,2015,1 - 4 years,0,0,0
Fermoy Town,2015,10 - 14 years,0,0,0
Fermoy Town,2015,15 - 19 years,0,0,0
Fermoy Town,2015,20 - 24 years,1,0,1
Fermoy Town,2015,25 - 29 years,0,0,0
Fermoy Town,2015,30 - 34 years,0,0,0
Fermoy Town,2015,35 - 39 years,0,1,1
Fermoy Town,2015,40 - 44 years,0,0,0
Fermoy Town,2015,45 - 49 years,0,0,0
Fermoy Town,2015,5 - 9 years,0,0,0
Fermoy Town,2015,50 - 54 years,0,1,1
Fermoy Town,2015,55 - 59 years,1,3,4
Fermoy Town,2015,60 - 64 years,0,1,1
Fermoy Town,2015,65 - 69 years,1,2,3
Fermoy Town,2015,70 - 74 years,1,2,3
Fermoy Town,2015,75 - 79 years,1,3,4
Fermoy Town,2015,80 - 84 years,5,1,6
Fermoy Town,2015,85 years and over,8,2,10
Fermoy Town,2015,Under 1 year,0,2,2
Fermoy Town,2016,1 - 4 years,0,0,0
Fermoy Town,2016,10 - 14 years,0,0,0
Fermoy Town,2016,15 - 19 years,0,0,0
Fermoy Town,2016,20 - 24 years,1,0,1
Fermoy Town,2016,25 - 29 years,0,0,0
Fermoy Town,2016,30 - 34 years,0,0,0
Fermoy Town,2016,35 - 39 years,0,1,1
Fermoy Town,2016,40 - 44 years,0,0,0
Fermoy Town,2016,45 - 49 years,0,0,0
Fermoy Town,2016,5 - 9 years,0,0,0
Fermoy Town,2016,50 - 54 years,0,1,1
Fermoy Town,2016,55 - 59 years,1,3,4
Fermoy Town,2016,60 - 64 years,0,1,1
Fermoy Town,2016,65 - 69 years,1,2,3
Fermoy Town,2016,70 - 74 years,1,2,3
Fermoy Town,2016,75 - 79 years,1,3,4
Fermoy Town,2016,80 - 84 years,5,1,6
Fermoy Town,2016,85 years and over,8,2,10
Fermoy Town,2016,Under 1 year,0,2,2
Fermoy Town,2017,1 - 4 years,0,0,0
Fermoy Town,2017,10 - 14 years,0,0,0
Fermoy Town,2017,15 - 19 years,0,0,0
Fermoy Town,2017,20 - 24 years,1,0,1
Fermoy Town,2017,25 - 29 years,0,0,0
Fermoy Town,2017,30 - 34 years,0,0,0
Fermoy Town,2017,35 - 39 years,0,1,1
Fermoy Town,2017,40 - 44 years,0,0,0
Fermoy Town,2017,45 - 49 years,0,0,0
Fermoy Town,2017,5 - 9 years,0,0,0
Fermoy Town,2017,50 - 54 years,0,1,1
Fermoy Town,2017,55 - 59 years,1,3,4
Fermoy Town,2017,60 - 64 years,2,1,3
Fermoy Town,2017,65 - 69 years,1,2,3
Fermoy Town,2017,70 - 74 years,1,2,3
Fermoy Town,2017,75 - 79 years,3,2,5
Fermoy Town,2017,80 - 84 years,2,4,6
Fermoy Town,2017,85 years and over,1,1,2
Fermoy Town,2017,Under 1 year,0,2,2
Fermoy Town,2018,1 - 4 years,0,0,0
Fermoy Town,2018,10 - 14 years,0,0,0
Fermoy Town,2018,15 - 19 years,0,0,0
Fermoy Town,2018,20 - 24 years,0,0,0
Fermoy Town,2018,25 - 29 years,0,0,0
Fermoy Town,2018,30 - 34 years,0,0,0
Fermoy Town,2018,35 - 39 years,0,0,0
Fermoy Town,2018,40 - 44 years,0,0,0
Fermoy Town,2018,45 - 49 years,0,0,0
Fermoy Town,2018,5 - 9 years,0,0,0
Fermoy Town,2018,50 - 54 years,0,0,0
Fermoy Town,2018,55 - 59 years,0,1,1
Fermoy Town,2018,60 - 64 years,0,0,0
Fermoy Town,2018,65 - 69 years,0,2,2
Fermoy Town,2018,70 - 74 years,1,0,1
Fermoy Town,2018,75 - 79 years,3,0,3
Fermoy Town,2018,80 - 84 years,1,4,5
Fermoy Town,2018,85 years and over,9,2,11
Fermoy Town,2018,Under 1 year,0,0,0
Fermoy Town,2019,1 - 4 years,0,0,0
Fermoy Town,2019,10 - 14 years,0,0,0
Fermoy Town,2019,15 - 19 years,0,0,0
Fermoy Town,2019,20 - 24 years,0,0,0
Fermoy Town,2019,25 - 29 years,0,0,0
Fermoy Town,2019,30 - 34 years,0,0,0
Fermoy Town,2019,35 - 39 years,0,0,0
Fermoy Town,2019,40 - 44 years,0,0,0
Fermoy Town,2019,45 - 49 years,0,0,0
Fermoy Town,2019,5 - 9 years,0,0,0
Fermoy Town,2019,50 - 54 years,0,0,0
Fermoy Town,2019,55 - 59 years,0,1,1
Fermoy Town,2019,60 - 64 years,0,0,0
Fermoy Town,2019,65 - 69 years,0,2,2
Fermoy Town,2019,70 - 74 years,1,0,1
Fermoy Town,2019,75 - 79 years,3,0,3
Fermoy Town,2019,80 - 84 years,1,4,5
Fermoy Town,2019,85 years and over,9,2,11
Fermoy Town,2019,Under 1 year,0,0,0
Fermoy Town,2020,1 - 4 years,0,0,0
Fermoy Town,2020,10 - 14 years,0,0,0
Fermoy Town,2020,15 - 19 years,0,0,0
Fermoy Town,2020,20 - 24 years,0,0,0
Fermoy Town,2020,25 - 29 years,0,0,0
Fermoy Town,2020,30 - 34 years,0,0,0
Fermoy Town,2020,35 - 39 years,0,0,0
Fermoy Town,2020,40 - 44 years,0,0,0
Fermoy Town,2020,45 - 49 years,0,0,0
Fermoy Town,2020,5 - 9 years,0,0,0
Fermoy Town,2020,50 - 54 years,0,0,0
Fermoy Town,2020,55 - 59 years,0,1,1
Fermoy Town,2020,60 - 64 years,0,0,0
Fermoy Town,2020,65 - 69 years,0,2,2
Fermoy Town,2020,70 - 74 years,1,0,1
Fermoy Town,2020,75 - 79 years,3,0,3
Fermoy Town,2020,80 - 84 years,1,4,5
Fermoy Town,2020,85 years and over,9,2,11
Fermoy Town,2020,Under 1 year,0,0,0
Fingal,2007,1 - 4 years,0,2,2
Fingal,2007,10 - 14 years,2,1,3
Fingal,2007,15 - 19 years,2,4,6
Fingal,2007,20 - 24 years,1,5,6
Fingal,2007,25 - 29 years,3,10,13
Fingal,2007,30 - 34 years,6,6,12
Fingal,2007,35 - 39 years,4,10,14
Fingal,2007,40 - 44 years,6,7,13
Fingal,2007,45 - 49 years,10,14,24
Fingal,2007,5 - 9 years,0,0,0
Fingal,2007,50 - 54 years,16,23,39
Fingal,2007,55 - 59 years,21,24,45
Fingal,2007,60 - 64 years,15,36,51
Fingal,2007,65 - 69 years,31,58,89
Fingal,2007,70 - 74 years,40,46,86
Fingal,2007,75 - 79 years,54,58,112
Fingal,2007,80 - 84 years,53,45,98
Fingal,2007,85 years and over,129,70,199
Fingal,2007,Under 1 year,7,8,15
Fingal,2008,1 - 4 years,2,1,3
Fingal,2008,10 - 14 years,1,1,2
Fingal,2008,15 - 19 years,3,2,5
Fingal,2008,20 - 24 years,2,5,7
Fingal,2008,25 - 29 years,1,6,7
Fingal,2008,30 - 34 years,2,7,9
Fingal,2008,35 - 39 years,6,8,14
Fingal,2008,40 - 44 years,8,12,20
Fingal,2008,45 - 49 years,8,22,30
Fingal,2008,5 - 9 years,1,0,1
Fingal,2008,50 - 54 years,22,19,41
Fingal,2008,55 - 59 years,27,25,52
Fingal,2008,60 - 64 years,33,41,74
Fingal,2008,65 - 69 years,37,47,84
Fingal,2008,70 - 74 years,33,46,79
Fingal,2008,75 - 79 years,44,59,103
Fingal,2008,80 - 84 years,78,46,124
Fingal,2008,85 years and over,150,61,211
Fingal,2008,Under 1 year,12,8,20
Fingal,2009,1 - 4 years,2,1,3
Fingal,2009,10 - 14 years,1,1,2
Fingal,2009,15 - 19 years,2,3,5
Fingal,2009,20 - 24 years,2,8,10
Fingal,2009,25 - 29 years,3,12,15
Fingal,2009,30 - 34 years,4,8,12
Fingal,2009,35 - 39 years,2,14,16
Fingal,2009,40 - 44 years,8,19,27
Fingal,2009,45 - 49 years,13,19,32
Fingal,2009,5 - 9 years,2,2,4
Fingal,2009,50 - 54 years,24,24,48
Fingal,2009,55 - 59 years,21,25,46
Fingal,2009,60 - 64 years,30,37,67
Fingal,2009,65 - 69 years,31,54,85
Fingal,2009,70 - 74 years,40,55,95
Fingal,2009,75 - 79 years,47,66,113
Fingal,2009,80 - 84 years,74,64,138
Fingal,2009,85 years and over,133,73,206
Fingal,2009,Under 1 year,3,8,11
Fingal,2010,1 - 4 years,2,1,3
Fingal,2010,10 - 14 years,2,1,3
Fingal,2010,15 - 19 years,2,2,4
Fingal,2010,20 - 24 years,1,8,9
Fingal,2010,25 - 29 years,2,5,7
Fingal,2010,30 - 34 years,3,8,11
Fingal,2010,35 - 39 years,5,9,14
Fingal,2010,40 - 44 years,7,11,18
Fingal,2010,45 - 49 years,14,18,32
Fingal,2010,5 - 9 years,2,2,4
Fingal,2010,50 - 54 years,16,22,38
Fingal,2010,55 - 59 years,27,27,54
Fingal,2010,60 - 64 years,22,37,59
Fingal,2010,65 - 69 years,32,34,66
Fingal,2010,70 - 74 years,35,47,82
Fingal,2010,75 - 79 years,56,56,112
Fingal,2010,80 - 84 years,60,61,121
Fingal,2010,85 years and over,128,72,200
Fingal,2010,Under 1 year,8,5,13
Fingal,2011,1 - 4 years,0,1,1
Fingal,2011,10 - 14 years,0,1,1
Fingal,2011,15 - 19 years,1,1,2
Fingal,2011,20 - 24 years,2,3,5
Fingal,2011,25 - 29 years,3,5,8
Fingal,2011,30 - 34 years,4,12,16
Fingal,2011,35 - 39 years,5,10,15
Fingal,2011,40 - 44 years,6,7,13
Fingal,2011,45 - 49 years,11,20,31
Fingal,2011,5 - 9 years,1,0,1
Fingal,2011,50 - 54 years,13,16,29
Fingal,2011,55 - 59 years,25,22,47
Fingal,2011,60 - 64 years,37,36,73
Fingal,2011,65 - 69 years,38,63,101
Fingal,2011,70 - 74 years,45,52,97
Fingal,2011,75 - 79 years,58,59,117
Fingal,2011,80 - 84 years,71,53,124
Fingal,2011,85 years and over,127,62,189
Fingal,2011,Under 1 year,9,10,19
Fingal,2012,1 - 4 years,2,2,4
Fingal,2012,10 - 14 years,2,2,4
Fingal,2012,15 - 19 years,1,3,4
Fingal,2012,20 - 24 years,2,5,7
Fingal,2012,25 - 29 years,4,10,14
Fingal,2012,30 - 34 years,7,10,17
Fingal,2012,35 - 39 years,9,11,20
Fingal,2012,40 - 44 years,16,13,29
Fingal,2012,45 - 49 years,11,17,28
Fingal,2012,5 - 9 years,2,0,2
Fingal,2012,50 - 54 years,17,19,36
Fingal,2012,55 - 59 years,24,29,53
Fingal,2012,60 - 64 years,33,51,84
Fingal,2012,65 - 69 years,54,60,114
Fingal,2012,70 - 74 years,42,55,97
Fingal,2012,75 - 79 years,48,73,121
Fingal,2012,80 - 84 years,83,80,163
Fingal,2012,85 years and over,170,100,270
Fingal,2012,Under 1 year,4,9,13
Fingal,2013,1 - 4 years,3,3,6
Fingal,2013,10 - 14 years,0,0,0
Fingal,2013,15 - 19 years,3,1,4
Fingal,2013,20 - 24 years,4,4,8
Fingal,2013,25 - 29 years,2,4,6
Fingal,2013,30 - 34 years,5,9,14
Fingal,2013,35 - 39 years,7,6,13
Fingal,2013,40 - 44 years,6,12,18
Fingal,2013,45 - 49 years,13,15,28
Fingal,2013,5 - 9 years,1,2,3
Fingal,2013,50 - 54 years,16,20,36
Fingal,2013,55 - 59 years,21,32,53
Fingal,2013,60 - 64 years,21,36,57
Fingal,2013,65 - 69 years,39,52,91
Fingal,2013,70 - 74 years,45,62,107
Fingal,2013,75 - 79 years,53,60,113
Fingal,2013,80 - 84 years,55,65,120
Fingal,2013,85 years and over,156,81,237
Fingal,2013,Under 1 year,8,8,16
Fingal,2014,1 - 4 years,3,3,6
Fingal,2014,10 - 14 years,0,1,1
Fingal,2014,15 - 19 years,2,1,3
Fingal,2014,20 - 24 years,4,8,12
Fingal,2014,25 - 29 years,3,3,6
Fingal,2014,30 - 34 years,6,3,9
Fingal,2014,35 - 39 years,5,7,12
Fingal,2014,40 - 44 years,11,14,25
Fingal,2014,45 - 49 years,8,13,21
Fingal,2014,5 - 9 years,1,1,2
Fingal,2014,50 - 54 years,15,28,43
Fingal,2014,55 - 59 years,16,20,36
Fingal,2014,60 - 64 years,32,40,72
Fingal,2014,65 - 69 years,34,63,97
Fingal,2014,70 - 74 years,45,67,112
Fingal,2014,75 - 79 years,52,69,121
Fingal,2014,80 - 84 years,60,61,121
Fingal,2014,85 years and over,155,95,250
Fingal,2014,Under 1 year,6,9,15
Fingal,2015,1 - 4 years,3,2,5
Fingal,2015,10 - 14 years,1,1,2
Fingal,2015,15 - 19 years,2,4,6
Fingal,2015,20 - 24 years,4,3,7
Fingal,2015,25 - 29 years,3,6,9
Fingal,2015,30 - 34 years,1,6,7
Fingal,2015,35 - 39 years,5,8,13
Fingal,2015,40 - 44 years,9,12,21
Fingal,2015,45 - 49 years,9,13,22
Fingal,2015,5 - 9 years,2,1,3
Fingal,2015,50 - 54 years,9,23,32
Fingal,2015,55 - 59 years,20,29,49
Fingal,2015,60 - 64 years,26,41,67
Fingal,2015,65 - 69 years,39,51,90
Fingal,2015,70 - 74 years,66,60,126
Fingal,2015,75 - 79 years,57,75,132
Fingal,2015,80 - 84 years,72,79,151
Fingal,2015,85 years and over,156,104,260
Fingal,2015,Under 1 year,7,11,18
Fingal,2016,1 - 4 years,3,1,4
Fingal,2016,10 - 14 years,1,1,2
Fingal,2016,15 - 19 years,2,3,5
Fingal,2016,20 - 24 years,1,3,4
Fingal,2016,25 - 29 years,4,3,7
Fingal,2016,30 - 34 years,3,4,7
Fingal,2016,35 - 39 years,5,12,17
Fingal,2016,40 - 44 years,8,6,14
Fingal,2016,45 - 49 years,9,17,26
Fingal,2016,5 - 9 years,1,1,2
Fingal,2016,50 - 54 years,15,11,26
Fingal,2016,55 - 59 years,25,30,55
Fingal,2016,60 - 64 years,30,42,72
Fingal,2016,65 - 69 years,41,34,75
Fingal,2016,70 - 74 years,41,74,115
Fingal,2016,75 - 79 years,60,85,145
Fingal,2016,80 - 84 years,69,72,141
Fingal,2016,85 years and over,170,115,285
Fingal,2016,Under 1 year,4,9,13
Fingal,2017,1 - 4 years,3,1,4
Fingal,2017,10 - 14 years,1,1,2
Fingal,2017,15 - 19 years,2,3,5
Fingal,2017,20 - 24 years,1,1,2
Fingal,2017,25 - 29 years,2,5,7
Fingal,2017,30 - 34 years,2,5,7
Fingal,2017,35 - 39 years,4,7,11
Fingal,2017,40 - 44 years,6,9,15
Fingal,2017,45 - 49 years,7,16,23
Fingal,2017,5 - 9 years,1,1,2
Fingal,2017,50 - 54 years,19,10,29
Fingal,2017,55 - 59 years,12,27,39
Fingal,2017,60 - 64 years,29,38,67
Fingal,2017,65 - 69 years,31,52,83
Fingal,2017,70 - 74 years,54,64,118
Fingal,2017,75 - 79 years,73,77,150
Fingal,2017,80 - 84 years,69,82,151
Fingal,2017,85 years and over,165,112,277
Fingal,2017,Under 1 year,6,4,10
Fingal,2018,1 - 4 years,1,0,1
Fingal,2018,10 - 14 years,2,1,3
Fingal,2018,15 - 19 years,3,3,6
Fingal,2018,20 - 24 years,1,3,4
Fingal,2018,25 - 29 years,2,3,5
Fingal,2018,30 - 34 years,5,5,10
Fingal,2018,35 - 39 years,5,4,9
Fingal,2018,40 - 44 years,6,9,15
Fingal,2018,45 - 49 years,17,12,29
Fingal,2018,5 - 9 years,0,0,0
Fingal,2018,50 - 54 years,20,21,41
Fingal,2018,55 - 59 years,14,41,55
Fingal,2018,60 - 64 years,23,32,55
Fingal,2018,65 - 69 years,44,55,99
Fingal,2018,70 - 74 years,55,58,113
Fingal,2018,75 - 79 years,61,83,144
Fingal,2018,80 - 84 years,66,84,150
Fingal,2018,85 years and over,166,109,275
Fingal,2018,Under 1 year,6,4,10
Fingal,2019,1 - 4 years,2,0,2
Fingal,2019,10 - 14 years,1,0,1
Fingal,2019,15 - 19 years,2,2,4
Fingal,2019,20 - 24 years,1,3,4
Fingal,2019,25 - 29 years,4,7,11
Fingal,2019,30 - 34 years,5,8,13
Fingal,2019,35 - 39 years,3,2,5
Fingal,2019,40 - 44 years,1,12,13
Fingal,2019,45 - 49 years,7,20,27
Fingal,2019,5 - 9 years,0,5,5
Fingal,2019,50 - 54 years,17,19,36
Fingal,2019,55 - 59 years,16,33,49
Fingal,2019,60 - 64 years,34,26,60
Fingal,2019,65 - 69 years,44,55,99
Fingal,2019,70 - 74 years,49,75,124
Fingal,2019,75 - 79 years,70,100,170
Fingal,2019,80 - 84 years,77,92,169
Fingal,2019,85 years and over,205,117,322
Fingal,2019,Under 1 year,4,9,13
Fingal,2020,1 - 4 years,2,0,2
Fingal,2020,10 - 14 years,1,3,4
Fingal,2020,15 - 19 years,1,2,3
Fingal,2020,20 - 24 years,1,3,4
Fingal,2020,25 - 29 years,4,4,8
Fingal,2020,30 - 34 years,5,6,11
Fingal,2020,35 - 39 years,9,8,17
Fingal,2020,40 - 44 years,8,15,23
Fingal,2020,45 - 49 years,10,17,27
Fingal,2020,5 - 9 years,0,5,5
Fingal,2020,50 - 54 years,16,19,35
Fingal,2020,55 - 59 years,22,35,57
Fingal,2020,60 - 64 years,32,37,69
Fingal,2020,65 - 69 years,46,44,90
Fingal,2020,70 - 74 years,45,66,111
Fingal,2020,75 - 79 years,68,89,157
Fingal,2020,80 - 84 years,88,130,218
Fingal,2020,85 years and over,193,129,322
Fingal,2020,Under 1 year,5,3,8
Galway City,2007,1 - 4 years,0,1,1
Galway City,2007,10 - 14 years,0,0,0
Galway City,2007,15 - 19 years,2,0,2
Galway City,2007,20 - 24 years,1,3,4
Galway City,2007,25 - 29 years,3,3,6
Galway City,2007,30 - 34 years,1,2,3
Galway City,2007,35 - 39 years,1,3,4
Galway City,2007,40 - 44 years,0,11,11
Galway City,2007,45 - 49 years,5,4,9
Galway City,2007,5 - 9 years,0,0,0
Galway City,2007,50 - 54 years,3,8,11
Galway City,2007,55 - 59 years,11,12,23
Galway City,2007,60 - 64 years,6,9,15
Galway City,2007,65 - 69 years,10,16,26
Galway City,2007,70 - 74 years,15,21,36
Galway City,2007,75 - 79 years,20,25,45
Galway City,2007,80 - 84 years,31,27,58
Galway City,2007,85 years and over,71,36,107
Galway City,2007,Under 1 year,0,0,0
Galway City,2008,1 - 4 years,0,1,1
Galway City,2008,10 - 14 years,0,0,0
Galway City,2008,15 - 19 years,2,1,3
Galway City,2008,20 - 24 years,1,2,3
Galway City,2008,25 - 29 years,1,1,2
Galway City,2008,30 - 34 years,3,2,5
Galway City,2008,35 - 39 years,4,6,10
Galway City,2008,40 - 44 years,2,7,9
Galway City,2008,45 - 49 years,6,8,14
Galway City,2008,5 - 9 years,0,0,0
Galway City,2008,50 - 54 years,5,6,11
Galway City,2008,55 - 59 years,5,7,12
Galway City,2008,60 - 64 years,5,15,20
Galway City,2008,65 - 69 years,14,16,30
Galway City,2008,70 - 74 years,16,19,35
Galway City,2008,75 - 79 years,18,16,34
Galway City,2008,80 - 84 years,17,24,41
Galway City,2008,85 years and over,66,28,94
Galway City,2008,Under 1 year,4,4,8
Galway City,2009,1 - 4 years,2,1,3
Galway City,2009,10 - 14 years,0,0,0
Galway City,2009,15 - 19 years,2,1,3
Galway City,2009,20 - 24 years,1,2,3
Galway City,2009,25 - 29 years,1,2,3
Galway City,2009,30 - 34 years,1,3,4
Galway City,2009,35 - 39 years,4,2,6
Galway City,2009,40 - 44 years,1,6,7
Galway City,2009,45 - 49 years,1,4,5
Galway City,2009,5 - 9 years,0,1,1
Galway City,2009,50 - 54 years,4,11,15
Galway City,2009,55 - 59 years,7,7,14
Galway City,2009,60 - 64 years,8,3,11
Galway City,2009,65 - 69 years,5,9,14
Galway City,2009,70 - 74 years,12,19,31
Galway City,2009,75 - 79 years,21,15,36
Galway City,2009,80 - 84 years,17,21,38
Galway City,2009,85 years and over,54,24,78
Galway City,2009,Under 1 year,1,1,2
Galway City,2010,1 - 4 years,2,2,4
Galway City,2010,10 - 14 years,0,0,0
Galway City,2010,15 - 19 years,1,1,2
Galway City,2010,20 - 24 years,1,1,2
Galway City,2010,25 - 29 years,1,3,4
Galway City,2010,30 - 34 years,1,3,4
Galway City,2010,35 - 39 years,2,2,4
Galway City,2010,40 - 44 years,2,5,7
Galway City,2010,45 - 49 years,3,3,6
Galway City,2010,5 - 9 years,0,1,1
Galway City,2010,50 - 54 years,7,3,10
Galway City,2010,55 - 59 years,3,12,15
Galway City,2010,60 - 64 years,6,10,16
Galway City,2010,65 - 69 years,4,12,16
Galway City,2010,70 - 74 years,13,15,28
Galway City,2010,75 - 79 years,14,26,40
Galway City,2010,80 - 84 years,18,18,36
Galway City,2010,85 years and over,52,26,78
Galway City,2010,Under 1 year,1,4,5
Galway City,2011,1 - 4 years,0,0,0
Galway City,2011,10 - 14 years,0,0,0
Galway City,2011,15 - 19 years,2,2,4
Galway City,2011,20 - 24 years,1,1,2
Galway City,2011,25 - 29 years,0,3,3
Galway City,2011,30 - 34 years,1,2,3
Galway City,2011,35 - 39 years,4,1,5
Galway City,2011,40 - 44 years,2,8,10
Galway City,2011,45 - 49 years,4,7,11
Galway City,2011,5 - 9 years,1,0,1
Galway City,2011,50 - 54 years,5,7,12
Galway City,2011,55 - 59 years,5,8,13
Galway City,2011,60 - 64 years,8,16,24
Galway City,2011,65 - 69 years,4,15,19
Galway City,2011,70 - 74 years,12,21,33
Galway City,2011,75 - 79 years,21,20,41
Galway City,2011,80 - 84 years,30,14,44
Galway City,2011,85 years and over,70,41,111
Galway City,2011,Under 1 year,1,1,2
Galway City,2012,1 - 4 years,0,0,0
Galway City,2012,10 - 14 years,0,0,0
Galway City,2012,15 - 19 years,2,2,4
Galway City,2012,20 - 24 years,1,1,2
Galway City,2012,25 - 29 years,0,3,3
Galway City,2012,30 - 34 years,2,1,3
Galway City,2012,35 - 39 years,1,4,5
Galway City,2012,40 - 44 years,2,3,5
Galway City,2012,45 - 49 years,2,6,8
Galway City,2012,5 - 9 years,1,0,1
Galway City,2012,50 - 54 years,1,10,11
Galway City,2012,55 - 59 years,5,8,13
Galway City,2012,60 - 64 years,4,12,16
Galway City,2012,65 - 69 years,10,13,23
Galway City,2012,70 - 74 years,10,15,25
Galway City,2012,75 - 79 years,5,15,20
Galway City,2012,80 - 84 years,20,22,42
Galway City,2012,85 years and over,55,20,75
Galway City,2012,Under 1 year,3,1,4
Galway City,2013,1 - 4 years,0,1,1
Galway City,2013,10 - 14 years,0,0,0
Galway City,2013,15 - 19 years,1,0,1
Galway City,2013,20 - 24 years,1,1,2
Galway City,2013,25 - 29 years,0,0,0
Galway City,2013,30 - 34 years,1,7,8
Galway City,2013,35 - 39 years,2,4,6
Galway City,2013,40 - 44 years,2,1,3
Galway City,2013,45 - 49 years,3,9,12
Galway City,2013,5 - 9 years,0,0,0
Galway City,2013,50 - 54 years,2,2,4
Galway City,2013,55 - 59 years,3,8,11
Galway City,2013,60 - 64 years,6,9,15
Galway City,2013,65 - 69 years,7,18,25
Galway City,2013,70 - 74 years,11,24,35
Galway City,2013,75 - 79 years,14,12,26
Galway City,2013,80 - 84 years,18,29,47
Galway City,2013,85 years and over,65,42,107
Galway City,2013,Under 1 year,3,2,5
Galway City,2014,1 - 4 years,1,1,2
Galway City,2014,10 - 14 years,0,0,0
Galway City,2014,15 - 19 years,1,3,4
Galway City,2014,20 - 24 years,2,1,3
Galway City,2014,25 - 29 years,1,2,3
Galway City,2014,30 - 34 years,2,2,4
Galway City,2014,35 - 39 years,2,3,5
Galway City,2014,40 - 44 years,2,2,4
Galway City,2014,45 - 49 years,5,3,8
Galway City,2014,5 - 9 years,0,0,0
Galway City,2014,50 - 54 years,5,9,14
Galway City,2014,55 - 59 years,4,6,10
Galway City,2014,60 - 64 years,7,15,22
Galway City,2014,65 - 69 years,14,20,34
Galway City,2014,70 - 74 years,12,24,36
Galway City,2014,75 - 79 years,19,22,41
Galway City,2014,80 - 84 years,20,23,43
Galway City,2014,85 years and over,62,37,99
Galway City,2014,Under 1 year,2,2,4
Galway City,2015,1 - 4 years,1,1,2
Galway City,2015,10 - 14 years,0,0,0
Galway City,2015,15 - 19 years,1,1,2
Galway City,2015,20 - 24 years,2,1,3
Galway City,2015,25 - 29 years,1,1,2
Galway City,2015,30 - 34 years,1,2,3
Galway City,2015,35 - 39 years,4,2,6
Galway City,2015,40 - 44 years,4,2,6
Galway City,2015,45 - 49 years,4,2,6
Galway City,2015,5 - 9 years,0,0,0
Galway City,2015,50 - 54 years,2,6,8
Galway City,2015,55 - 59 years,7,16,23
Galway City,2015,60 - 64 years,13,17,30
Galway City,2015,65 - 69 years,11,25,36
Galway City,2015,70 - 74 years,10,20,30
Galway City,2015,75 - 79 years,9,29,38
Galway City,2015,80 - 84 years,21,27,48
Galway City,2015,85 years and over,75,34,109
Galway City,2015,Under 1 year,2,2,4
Galway City,2016,1 - 4 years,1,1,2
Galway City,2016,10 - 14 years,1,0,1
Galway City,2016,15 - 19 years,1,2,3
Galway City,2016,20 - 24 years,1,2,3
Galway City,2016,25 - 29 years,1,1,2
Galway City,2016,30 - 34 years,3,2,5
Galway City,2016,35 - 39 years,1,2,3
Galway City,2016,40 - 44 years,2,5,7
Galway City,2016,45 - 49 years,5,3,8
Galway City,2016,5 - 9 years,0,0,0
Galway City,2016,50 - 54 years,5,10,15
Galway City,2016,55 - 59 years,5,9,14
Galway City,2016,60 - 64 years,3,20,23
Galway City,2016,65 - 69 years,13,15,28
Galway City,2016,70 - 74 years,14,23,37
Galway City,2016,75 - 79 years,19,30,49
Galway City,2016,80 - 84 years,27,22,49
Galway City,2016,85 years and over,70,34,104
Galway City,2016,Under 1 year,1,2,3
Galway City,2017,1 - 4 years,2,1,3
Galway City,2017,10 - 14 years,1,0,1
Galway City,2017,15 - 19 years,1,2,3
Galway City,2017,20 - 24 years,1,1,2
Galway City,2017,25 - 29 years,1,4,5
Galway City,2017,30 - 34 years,1,6,7
Galway City,2017,35 - 39 years,1,4,5
Galway City,2017,40 - 44 years,1,9,10
Galway City,2017,45 - 49 years,2,12,14
Galway City,2017,5 - 9 years,0,0,0
Galway City,2017,50 - 54 years,5,5,10
Galway City,2017,55 - 59 years,7,10,17
Galway City,2017,60 - 64 years,8,16,24
Galway City,2017,65 - 69 years,8,14,22
Galway City,2017,70 - 74 years,13,18,31
Galway City,2017,75 - 79 years,14,28,42
Galway City,2017,80 - 84 years,19,30,49
Galway City,2017,85 years and over,95,45,140
Galway City,2017,Under 1 year,1,2,3
Galway City,2018,1 - 4 years,0,0,0
Galway City,2018,10 - 14 years,0,1,1
Galway City,2018,15 - 19 years,2,0,2
Galway City,2018,20 - 24 years,0,0,0
Galway City,2018,25 - 29 years,1,1,2
Galway City,2018,30 - 34 years,1,2,3
Galway City,2018,35 - 39 years,1,5,6
Galway City,2018,40 - 44 years,2,6,8
Galway City,2018,45 - 49 years,2,3,5
Galway City,2018,5 - 9 years,0,0,0
Galway City,2018,50 - 54 years,1,4,5
Galway City,2018,55 - 59 years,1,14,15
Galway City,2018,60 - 64 years,8,10,18
Galway City,2018,65 - 69 years,11,23,34
Galway City,2018,70 - 74 years,21,21,42
Galway City,2018,75 - 79 years,12,13,25
Galway City,2018,80 - 84 years,31,38,69
Galway City,2018,85 years and over,81,40,121
Galway City,2018,Under 1 year,0,0,0
Galway City,2019,1 - 4 years,1,0,1
Galway City,2019,10 - 14 years,0,1,1
Galway City,2019,15 - 19 years,2,0,2
Galway City,2019,20 - 24 years,0,1,1
Galway City,2019,25 - 29 years,0,1,1
Galway City,2019,30 - 34 years,1,3,4
Galway City,2019,35 - 39 years,1,4,5
Galway City,2019,40 - 44 years,4,7,11
Galway City,2019,45 - 49 years,5,6,11
Galway City,2019,5 - 9 years,0,0,0
Galway City,2019,50 - 54 years,3,5,8
Galway City,2019,55 - 59 years,8,17,25
Galway City,2019,60 - 64 years,12,14,26
Galway City,2019,65 - 69 years,10,17,27
Galway City,2019,70 - 74 years,10,18,28
Galway City,2019,75 - 79 years,21,19,40
Galway City,2019,80 - 84 years,33,35,68
Galway City,2019,85 years and over,90,56,146
Galway City,2019,Under 1 year,0,0,0
Galway City,2020,1 - 4 years,1,0,1
Galway City,2020,10 - 14 years,1,1,2
Galway City,2020,15 - 19 years,2,1,3
Galway City,2020,20 - 24 years,0,1,1
Galway City,2020,25 - 29 years,0,1,1
Galway City,2020,30 - 34 years,1,2,3
Galway City,2020,35 - 39 years,2,3,5
Galway City,2020,40 - 44 years,3,3,6
Galway City,2020,45 - 49 years,3,3,6
Galway City,2020,5 - 9 years,0,0,0
Galway City,2020,50 - 54 years,3,6,9
Galway City,2020,55 - 59 years,5,5,10
Galway City,2020,60 - 64 years,6,16,22
Galway City,2020,65 - 69 years,10,15,25
Galway City,2020,70 - 74 years,13,23,36
Galway City,2020,75 - 79 years,11,26,37
Galway City,2020,80 - 84 years,28,21,49
Galway City,2020,85 years and over,72,44,116
Galway City,2020,Under 1 year,1,2,3
Galway County,2007,1 - 4 years,1,0,1
Galway County,2007,10 - 14 years,2,0,2
Galway County,2007,15 - 19 years,0,3,3
Galway County,2007,20 - 24 years,1,7,8
Galway County,2007,25 - 29 years,3,3,6
Galway County,2007,30 - 34 years,3,7,10
Galway County,2007,35 - 39 years,2,8,10
Galway County,2007,40 - 44 years,12,7,19
Galway County,2007,45 - 49 years,6,12,18
Galway County,2007,5 - 9 years,0,0,0
Galway County,2007,50 - 54 years,5,18,23
Galway County,2007,55 - 59 years,18,23,41
Galway County,2007,60 - 64 years,24,37,61
Galway County,2007,65 - 69 years,23,48,71
Galway County,2007,70 - 74 years,39,57,96
Galway County,2007,75 - 79 years,61,96,157
Galway County,2007,80 - 84 years,110,95,205
Galway County,2007,85 years and over,201,136,337
Galway County,2007,Under 1 year,0,3,3
Galway County,2008,1 - 4 years,1,1,2
Galway County,2008,10 - 14 years,2,1,3
Galway County,2008,15 - 19 years,1,2,3
Galway County,2008,20 - 24 years,1,8,9
Galway County,2008,25 - 29 years,2,4,6
Galway County,2008,30 - 34 years,2,4,6
Galway County,2008,35 - 39 years,6,10,16
Galway County,2008,40 - 44 years,5,7,12
Galway County,2008,45 - 49 years,11,14,25
Galway County,2008,5 - 9 years,0,0,0
Galway County,2008,50 - 54 years,10,22,32
Galway County,2008,55 - 59 years,15,15,30
Galway County,2008,60 - 64 years,21,44,65
Galway County,2008,65 - 69 years,29,61,90
Galway County,2008,70 - 74 years,35,67,102
Galway County,2008,75 - 79 years,62,110,172
Galway County,2008,80 - 84 years,101,117,218
Galway County,2008,85 years and over,265,135,400
Galway County,2008,Under 1 year,1,5,6
Galway County,2009,1 - 4 years,1,2,3
Galway County,2009,10 - 14 years,1,1,2
Galway County,2009,15 - 19 years,5,2,7
Galway County,2009,20 - 24 years,3,2,5
Galway County,2009,25 - 29 years,3,3,6
Galway County,2009,30 - 34 years,2,9,11
Galway County,2009,35 - 39 years,6,4,10
Galway County,2009,40 - 44 years,3,7,10
Galway County,2009,45 - 49 years,11,17,28
Galway County,2009,5 - 9 years,0,1,1
Galway County,2009,50 - 54 years,11,21,32
Galway County,2009,55 - 59 years,19,36,55
Galway County,2009,60 - 64 years,20,44,64
Galway County,2009,65 - 69 years,29,61,90
Galway County,2009,70 - 74 years,33,62,95
Galway County,2009,75 - 79 years,75,103,178
Galway County,2009,80 - 84 years,96,99,195
Galway County,2009,85 years and over,229,166,395
Galway County,2009,Under 1 year,9,5,14
Galway County,2010,1 - 4 years,1,1,2
Galway County,2010,10 - 14 years,1,1,2
Galway County,2010,15 - 19 years,5,3,8
Galway County,2010,20 - 24 years,3,2,5
Galway County,2010,25 - 29 years,1,5,6
Galway County,2010,30 - 34 years,4,1,5
Galway County,2010,35 - 39 years,3,9,12
Galway County,2010,40 - 44 years,5,15,20
Galway County,2010,45 - 49 years,6,17,23
Galway County,2010,5 - 9 years,0,1,1
Galway County,2010,50 - 54 years,14,19,33
Galway County,2010,55 - 59 years,16,25,41
Galway County,2010,60 - 64 years,31,40,71
Galway County,2010,65 - 69 years,29,56,85
Galway County,2010,70 - 74 years,35,67,102
Galway County,2010,75 - 79 years,63,93,156
Galway County,2010,80 - 84 years,80,112,192
Galway County,2010,85 years and over,232,166,398
Galway County,2010,Under 1 year,2,4,6
Galway County,2011,1 - 4 years,1,0,1
Galway County,2011,10 - 14 years,0,0,0
Galway County,2011,15 - 19 years,2,1,3
Galway County,2011,20 - 24 years,2,3,5
Galway County,2011,25 - 29 years,1,7,8
Galway County,2011,30 - 34 years,5,6,11
Galway County,2011,35 - 39 years,4,3,7
Galway County,2011,40 - 44 years,9,7,16
Galway County,2011,45 - 49 years,12,7,19
Galway County,2011,5 - 9 years,1,0,1
Galway County,2011,50 - 54 years,11,19,30
Galway County,2011,55 - 59 years,18,26,44
Galway County,2011,60 - 64 years,28,34,62
Galway County,2011,65 - 69 years,37,56,93
Galway County,2011,70 - 74 years,35,58,93
Galway County,2011,75 - 79 years,59,80,139
Galway County,2011,80 - 84 years,85,98,183
Galway County,2011,85 years and over,224,162,386
Galway County,2011,Under 1 year,8,8,16
Galway County,2012,1 - 4 years,2,1,3
Galway County,2012,10 - 14 years,0,1,1
Galway County,2012,15 - 19 years,2,2,4
Galway County,2012,20 - 24 years,1,4,5
Galway County,2012,25 - 29 years,2,4,6
Galway County,2012,30 - 34 years,3,7,10
Galway County,2012,35 - 39 years,6,10,16
Galway County,2012,40 - 44 years,9,11,20
Galway County,2012,45 - 49 years,9,21,30
Galway County,2012,5 - 9 years,1,1,2
Galway County,2012,50 - 54 years,10,22,32
Galway County,2012,55 - 59 years,21,19,40
Galway County,2012,60 - 64 years,20,44,64
Galway County,2012,65 - 69 years,29,57,86
Galway County,2012,70 - 74 years,37,68,105
Galway County,2012,75 - 79 years,52,104,156
Galway County,2012,80 - 84 years,92,110,202
Galway County,2012,85 years and over,284,183,467
Galway County,2012,Under 1 year,4,5,9
Galway County,2013,1 - 4 years,2,0,2
Galway County,2013,10 - 14 years,0,1,1
Galway County,2013,15 - 19 years,0,0,0
Galway County,2013,20 - 24 years,1,8,9
Galway County,2013,25 - 29 years,0,3,3
Galway County,2013,30 - 34 years,1,3,4
Galway County,2013,35 - 39 years,1,4,5
Galway County,2013,40 - 44 years,4,5,9
Galway County,2013,45 - 49 years,4,13,17
Galway County,2013,5 - 9 years,0,0,0
Galway County,2013,50 - 54 years,16,29,45
Galway County,2013,55 - 59 years,20,28,48
Galway County,2013,60 - 64 years,28,41,69
Galway County,2013,65 - 69 years,27,59,86
Galway County,2013,70 - 74 years,44,73,117
Galway County,2013,75 - 79 years,48,85,133
Galway County,2013,80 - 84 years,90,110,200
Galway County,2013,85 years and over,277,161,438
Galway County,2013,Under 1 year,3,4,7
Galway County,2014,1 - 4 years,2,2,4
Galway County,2014,10 - 14 years,0,1,1
Galway County,2014,15 - 19 years,1,2,3
Galway County,2014,20 - 24 years,1,7,8
Galway County,2014,25 - 29 years,0,5,5
Galway County,2014,30 - 34 years,3,6,9
Galway County,2014,35 - 39 years,5,4,9
Galway County,2014,40 - 44 years,5,9,14
Galway County,2014,45 - 49 years,6,11,17
Galway County,2014,5 - 9 years,2,1,3
Galway County,2014,50 - 54 years,14,18,32
Galway County,2014,55 - 59 years,20,34,54
Galway County,2014,60 - 64 years,36,33,69
Galway County,2014,65 - 69 years,41,53,94
Galway County,2014,70 - 74 years,43,55,98
Galway County,2014,75 - 79 years,55,99,154
Galway County,2014,80 - 84 years,92,108,200
Galway County,2014,85 years and over,236,170,406
Galway County,2014,Under 1 year,4,2,6
Galway County,2015,1 - 4 years,2,2,4
Galway County,2015,10 - 14 years,1,1,2
Galway County,2015,15 - 19 years,1,2,3
Galway County,2015,20 - 24 years,1,4,5
Galway County,2015,25 - 29 years,0,4,4
Galway County,2015,30 - 34 years,1,5,6
Galway County,2015,35 - 39 years,3,6,9
Galway County,2015,40 - 44 years,2,9,11
Galway County,2015,45 - 49 years,10,11,21
Galway County,2015,5 - 9 years,2,1,3
Galway County,2015,50 - 54 years,7,19,26
Galway County,2015,55 - 59 years,21,19,40
Galway County,2015,60 - 64 years,27,34,61
Galway County,2015,65 - 69 years,37,52,89
Galway County,2015,70 - 74 years,44,74,118
Galway County,2015,75 - 79 years,61,78,139
Galway County,2015,80 - 84 years,89,106,195
Galway County,2015,85 years and over,253,180,433
Galway County,2015,Under 1 year,5,9,14
Galway County,2016,1 - 4 years,2,2,4
Galway County,2016,10 - 14 years,1,1,2
Galway County,2016,15 - 19 years,1,4,5
Galway County,2016,20 - 24 years,1,1,2
Galway County,2016,25 - 29 years,1,3,4
Galway County,2016,30 - 34 years,2,3,5
Galway County,2016,35 - 39 years,4,5,9
Galway County,2016,40 - 44 years,4,9,13
Galway County,2016,45 - 49 years,4,11,15
Galway County,2016,5 - 9 years,2,1,3
Galway County,2016,50 - 54 years,8,13,21
Galway County,2016,55 - 59 years,14,35,49
Galway County,2016,60 - 64 years,19,48,67
Galway County,2016,65 - 69 years,32,51,83
Galway County,2016,70 - 74 years,41,75,116
Galway County,2016,75 - 79 years,61,94,155
Galway County,2016,80 - 84 years,93,124,217
Galway County,2016,85 years and over,269,176,445
Galway County,2016,Under 1 year,2,2,4
Galway County,2017,1 - 4 years,2,2,4
Galway County,2017,10 - 14 years,1,1,2
Galway County,2017,15 - 19 years,1,3,4
Galway County,2017,20 - 24 years,1,2,3
Galway County,2017,25 - 29 years,1,2,3
Galway County,2017,30 - 34 years,3,3,6
Galway County,2017,35 - 39 years,1,5,6
Galway County,2017,40 - 44 years,3,9,12
Galway County,2017,45 - 49 years,4,13,17
Galway County,2017,5 - 9 years,2,2,4
Galway County,2017,50 - 54 years,9,24,33
Galway County,2017,55 - 59 years,20,21,41
Galway County,2017,60 - 64 years,12,29,41
Galway County,2017,65 - 69 years,23,48,71
Galway County,2017,70 - 74 years,41,74,115
Galway County,2017,75 - 79 years,44,80,124
Galway County,2017,80 - 84 years,92,118,210
Galway County,2017,85 years and over,273,186,459
Galway County,2017,Under 1 year,1,4,5
Galway County,2018,1 - 4 years,0,0,0
Galway County,2018,10 - 14 years,1,0,1
Galway County,2018,15 - 19 years,1,2,3
Galway County,2018,20 - 24 years,1,1,2
Galway County,2018,25 - 29 years,0,4,4
Galway County,2018,30 - 34 years,2,3,5
Galway County,2018,35 - 39 years,3,4,7
Galway County,2018,40 - 44 years,3,11,14
Galway County,2018,45 - 49 years,7,12,19
Galway County,2018,5 - 9 years,0,1,1
Galway County,2018,50 - 54 years,13,19,32
Galway County,2018,55 - 59 years,19,34,53
Galway County,2018,60 - 64 years,19,45,64
Galway County,2018,65 - 69 years,30,63,93
Galway County,2018,70 - 74 years,36,83,119
Galway County,2018,75 - 79 years,52,81,133
Galway County,2018,80 - 84 years,79,103,182
Galway County,2018,85 years and over,267,202,469
Galway County,2018,Under 1 year,3,5,8
Galway County,2019,1 - 4 years,0,0,0
Galway County,2019,10 - 14 years,0,0,0
Galway County,2019,15 - 19 years,0,0,0
Galway County,2019,20 - 24 years,1,1,2
Galway County,2019,25 - 29 years,2,4,6
Galway County,2019,30 - 34 years,1,2,3
Galway County,2019,35 - 39 years,2,4,6
Galway County,2019,40 - 44 years,3,9,12
Galway County,2019,45 - 49 years,6,18,24
Galway County,2019,5 - 9 years,0,0,0
Galway County,2019,50 - 54 years,13,16,29
Galway County,2019,55 - 59 years,23,32,55
Galway County,2019,60 - 64 years,24,36,60
Galway County,2019,65 - 69 years,31,68,99
Galway County,2019,70 - 74 years,52,80,132
Galway County,2019,75 - 79 years,54,73,127
Galway County,2019,80 - 84 years,97,110,207
Galway County,2019,85 years and over,288,218,506
Galway County,2019,Under 1 year,3,5,8
Galway County,2020,1 - 4 years,1,1,2
Galway County,2020,10 - 14 years,0,0,0
Galway County,2020,15 - 19 years,0,4,4
Galway County,2020,20 - 24 years,1,2,3
Galway County,2020,25 - 29 years,1,2,3
Galway County,2020,30 - 34 years,1,1,2
Galway County,2020,35 - 39 years,3,5,8
Galway County,2020,40 - 44 years,8,10,18
Galway County,2020,45 - 49 years,5,12,17
Galway County,2020,5 - 9 years,0,1,1
Galway County,2020,50 - 54 years,6,19,25
Galway County,2020,55 - 59 years,15,26,41
Galway County,2020,60 - 64 years,25,24,49
Galway County,2020,65 - 69 years,25,75,100
Galway County,2020,70 - 74 years,49,71,120
Galway County,2020,75 - 79 years,54,103,157
Galway County,2020,80 - 84 years,76,115,191
Galway County,2020,85 years and over,258,208,466
Galway County,2020,Under 1 year,6,3,9
Kells Town,2007,1 - 4 years,0,1,1
Kells Town,2007,10 - 14 years,0,0,0
Kells Town,2007,15 - 19 years,0,0,0
Kells Town,2007,20 - 24 years,1,0,1
Kells Town,2007,25 - 29 years,0,0,0
Kells Town,2007,30 - 34 years,0,0,0
Kells Town,2007,35 - 39 years,0,1,1
Kells Town,2007,40 - 44 years,0,2,2
Kells Town,2007,45 - 49 years,2,0,2
Kells Town,2007,5 - 9 years,0,0,0
Kells Town,2007,50 - 54 years,0,1,1
Kells Town,2007,55 - 59 years,1,2,3
Kells Town,2007,60 - 64 years,1,4,5
Kells Town,2007,65 - 69 years,2,2,4
Kells Town,2007,70 - 74 years,3,3,6
Kells Town,2007,75 - 79 years,4,3,7
Kells Town,2007,80 - 84 years,7,1,8
Kells Town,2007,85 years and over,18,9,27
Kells Town,2007,Under 1 year,0,1,1
Kells Town,2008,1 - 4 years,0,1,1
Kells Town,2008,10 - 14 years,0,0,0
Kells Town,2008,15 - 19 years,0,0,0
Kells Town,2008,20 - 24 years,1,1,2
Kells Town,2008,25 - 29 years,0,1,1
Kells Town,2008,30 - 34 years,0,1,1
Kells Town,2008,35 - 39 years,0,2,2
Kells Town,2008,40 - 44 years,0,1,1
Kells Town,2008,45 - 49 years,3,0,3
Kells Town,2008,5 - 9 years,0,0,0
Kells Town,2008,50 - 54 years,0,1,1
Kells Town,2008,55 - 59 years,1,3,4
Kells Town,2008,60 - 64 years,1,1,2
Kells Town,2008,65 - 69 years,1,3,4
Kells Town,2008,70 - 74 years,5,7,12
Kells Town,2008,75 - 79 years,8,8,16
Kells Town,2008,80 - 84 years,4,8,12
Kells Town,2008,85 years and over,12,7,19
Kells Town,2008,Under 1 year,0,1,1
Kells Town,2009,1 - 4 years,0,1,1
Kells Town,2009,10 - 14 years,0,0,0
Kells Town,2009,15 - 19 years,0,0,0
Kells Town,2009,20 - 24 years,1,1,2
Kells Town,2009,25 - 29 years,0,1,1
Kells Town,2009,30 - 34 years,0,1,1
Kells Town,2009,35 - 39 years,0,1,1
Kells Town,2009,40 - 44 years,0,1,1
Kells Town,2009,45 - 49 years,3,1,4
Kells Town,2009,5 - 9 years,0,0,0
Kells Town,2009,50 - 54 years,1,2,3
Kells Town,2009,55 - 59 years,1,3,4
Kells Town,2009,60 - 64 years,3,1,4
Kells Town,2009,65 - 69 years,1,1,2
Kells Town,2009,70 - 74 years,5,6,11
Kells Town,2009,75 - 79 years,1,3,4
Kells Town,2009,80 - 84 years,4,4,8
Kells Town,2009,85 years and over,4,7,11
Kells Town,2009,Under 1 year,0,1,1
Kells Town,2010,1 - 4 years,0,1,1
Kells Town,2010,10 - 14 years,0,0,0
Kells Town,2010,15 - 19 years,0,0,0
Kells Town,2010,20 - 24 years,1,1,2
Kells Town,2010,25 - 29 years,0,1,1
Kells Town,2010,30 - 34 years,0,1,1
Kells Town,2010,35 - 39 years,0,1,1
Kells Town,2010,40 - 44 years,0,2,2
Kells Town,2010,45 - 49 years,3,1,4
Kells Town,2010,5 - 9 years,0,0,0
Kells Town,2010,50 - 54 years,1,2,3
Kells Town,2010,55 - 59 years,1,3,4
Kells Town,2010,60 - 64 years,3,1,4
Kells Town,2010,65 - 69 years,2,3,5
Kells Town,2010,70 - 74 years,4,2,6
Kells Town,2010,75 - 79 years,2,2,4
Kells Town,2010,80 - 84 years,6,2,8
Kells Town,2010,85 years and over,10,3,13
Kells Town,2010,Under 1 year,0,1,1
Kells Town,2011,1 - 4 years,0,0,0
Kells Town,2011,10 - 14 years,0,0,0
Kells Town,2011,15 - 19 years,0,0,0
Kells Town,2011,20 - 24 years,0,0,0
Kells Town,2011,25 - 29 years,0,0,0
Kells Town,2011,30 - 34 years,1,0,1
Kells Town,2011,35 - 39 years,0,1,1
Kells Town,2011,40 - 44 years,0,0,0
Kells Town,2011,45 - 49 years,0,0,0
Kells Town,2011,5 - 9 years,0,0,0
Kells Town,2011,50 - 54 years,0,0,0
Kells Town,2011,55 - 59 years,1,0,1
Kells Town,2011,60 - 64 years,0,1,1
Kells Town,2011,65 - 69 years,0,2,2
Kells Town,2011,70 - 74 years,2,4,6
Kells Town,2011,75 - 79 years,1,1,2
Kells Town,2011,80 - 84 years,1,1,2
Kells Town,2011,85 years and over,5,2,7
Kells Town,2011,Under 1 year,0,0,0
Kells Town,2012,1 - 4 years,0,0,0
Kells Town,2012,10 - 14 years,0,0,0
Kells Town,2012,15 - 19 years,0,0,0
Kells Town,2012,20 - 24 years,0,0,0
Kells Town,2012,25 - 29 years,0,1,1
Kells Town,2012,30 - 34 years,1,1,2
Kells Town,2012,35 - 39 years,1,1,2
Kells Town,2012,40 - 44 years,0,0,0
Kells Town,2012,45 - 49 years,0,0,0
Kells Town,2012,5 - 9 years,0,0,0
Kells Town,2012,50 - 54 years,0,1,1
Kells Town,2012,55 - 59 years,1,2,3
Kells Town,2012,60 - 64 years,0,4,4
Kells Town,2012,65 - 69 years,1,2,3
Kells Town,2012,70 - 74 years,4,1,5
Kells Town,2012,75 - 79 years,4,5,9
Kells Town,2012,80 - 84 years,4,4,8
Kells Town,2012,85 years and over,6,7,13
Kells Town,2012,Under 1 year,0,2,2
Kells Town,2013,1 - 4 years,0,0,0
Kells Town,2013,10 - 14 years,0,0,0
Kells Town,2013,15 - 19 years,0,0,0
Kells Town,2013,20 - 24 years,0,0,0
Kells Town,2013,25 - 29 years,0,0,0
Kells Town,2013,30 - 34 years,0,0,0
Kells Town,2013,35 - 39 years,0,0,0
Kells Town,2013,40 - 44 years,0,2,2
Kells Town,2013,45 - 49 years,0,2,2
Kells Town,2013,5 - 9 years,0,0,0
Kells Town,2013,50 - 54 years,0,0,0
Kells Town,2013,55 - 59 years,0,1,1
Kells Town,2013,60 - 64 years,0,0,0
Kells Town,2013,65 - 69 years,0,2,2
Kells Town,2013,70 - 74 years,1,4,5
Kells Town,2013,75 - 79 years,5,2,7
Kells Town,2013,80 - 84 years,4,1,5
Kells Town,2013,85 years and over,8,5,13
Kells Town,2013,Under 1 year,0,2,2
Kells Town,2014,1 - 4 years,0,0,0
Kells Town,2014,10 - 14 years,0,0,0
Kells Town,2014,15 - 19 years,0,0,0
Kells Town,2014,20 - 24 years,0,0,0
Kells Town,2014,25 - 29 years,0,0,0
Kells Town,2014,30 - 34 years,0,0,0
Kells Town,2014,35 - 39 years,0,0,0
Kells Town,2014,40 - 44 years,1,1,2
Kells Town,2014,45 - 49 years,0,1,1
Kells Town,2014,5 - 9 years,0,0,0
Kells Town,2014,50 - 54 years,0,1,1
Kells Town,2014,55 - 59 years,0,2,2
Kells Town,2014,60 - 64 years,2,1,3
Kells Town,2014,65 - 69 years,1,2,3
Kells Town,2014,70 - 74 years,1,1,2
Kells Town,2014,75 - 79 years,4,2,6
Kells Town,2014,80 - 84 years,2,5,7
Kells Town,2014,85 years and over,11,1,12
Kells Town,2014,Under 1 year,0,2,2
Kells Town,2015,1 - 4 years,0,0,0
Kells Town,2015,10 - 14 years,0,0,0
Kells Town,2015,15 - 19 years,0,0,0
Kells Town,2015,20 - 24 years,0,0,0
Kells Town,2015,25 - 29 years,0,0,0
Kells Town,2015,30 - 34 years,0,0,0
Kells Town,2015,35 - 39 years,0,0,0
Kells Town,2015,40 - 44 years,1,1,2
Kells Town,2015,45 - 49 years,0,1,1
Kells Town,2015,5 - 9 years,0,0,0
Kells Town,2015,50 - 54 years,0,1,1
Kells Town,2015,55 - 59 years,0,2,2
Kells Town,2015,60 - 64 years,2,1,3
Kells Town,2015,65 - 69 years,1,2,3
Kells Town,2015,70 - 74 years,1,1,2
Kells Town,2015,75 - 79 years,4,2,6
Kells Town,2015,80 - 84 years,2,5,7
Kells Town,2015,85 years and over,11,1,12
Kells Town,2015,Under 1 year,0,2,2
Kells Town,2016,1 - 4 years,0,0,0
Kells Town,2016,10 - 14 years,0,0,0
Kells Town,2016,15 - 19 years,0,0,0
Kells Town,2016,20 - 24 years,0,0,0
Kells Town,2016,25 - 29 years,0,0,0
Kells Town,2016,30 - 34 years,0,0,0
Kells Town,2016,35 - 39 years,0,0,0
Kells Town,2016,40 - 44 years,1,1,2
Kells Town,2016,45 - 49 years,0,1,1
Kells Town,2016,5 - 9 years,0,0,0
Kells Town,2016,50 - 54 years,0,1,1
Kells Town,2016,55 - 59 years,0,2,2
Kells Town,2016,60 - 64 years,2,1,3
Kells Town,2016,65 - 69 years,1,2,3
Kells Town,2016,70 - 74 years,1,1,2
Kells Town,2016,75 - 79 years,4,2,6
Kells Town,2016,80 - 84 years,2,5,7
Kells Town,2016,85 years and over,11,1,12
Kells Town,2016,Under 1 year,0,2,2
Kells Town,2017,1 - 4 years,0,0,0
Kells Town,2017,10 - 14 years,0,0,0
Kells Town,2017,15 - 19 years,0,0,0
Kells Town,2017,20 - 24 years,0,0,0
Kells Town,2017,25 - 29 years,0,1,1
Kells Town,2017,30 - 34 years,0,0,0
Kells Town,2017,35 - 39 years,0,0,0
Kells Town,2017,40 - 44 years,1,1,2
Kells Town,2017,45 - 49 years,0,1,1
Kells Town,2017,5 - 9 years,1,0,1
Kells Town,2017,50 - 54 years,0,1,1
Kells Town,2017,55 - 59 years,0,2,2
Kells Town,2017,60 - 64 years,1,1,2
Kells Town,2017,65 - 69 years,1,2,3
Kells Town,2017,70 - 74 years,1,1,2
Kells Town,2017,75 - 79 years,3,2,5
Kells Town,2017,80 - 84 years,2,4,6
Kells Town,2017,85 years and over,9,2,11
Kells Town,2017,Under 1 year,0,2,2
Kells Town,2018,1 - 4 years,0,0,0
Kells Town,2018,10 - 14 years,0,0,0
Kells Town,2018,15 - 19 years,0,0,0
Kells Town,2018,20 - 24 years,0,0,0
Kells Town,2018,25 - 29 years,0,0,0
Kells Town,2018,30 - 34 years,1,0,1
Kells Town,2018,35 - 39 years,1,0,1
Kells Town,2018,40 - 44 years,0,0,0
Kells Town,2018,45 - 49 years,0,0,0
Kells Town,2018,5 - 9 years,0,0,0
Kells Town,2018,50 - 54 years,0,0,0
Kells Town,2018,55 - 59 years,0,1,1
Kells Town,2018,60 - 64 years,2,1,3
Kells Town,2018,65 - 69 years,0,1,1
Kells Town,2018,70 - 74 years,1,1,2
Kells Town,2018,75 - 79 years,1,0,1
Kells Town,2018,80 - 84 years,2,4,6
Kells Town,2018,85 years and over,7,1,8
Kells Town,2018,Under 1 year,0,0,0
Kells Town,2019,1 - 4 years,0,0,0
Kells Town,2019,10 - 14 years,0,0,0
Kells Town,2019,15 - 19 years,0,0,0
Kells Town,2019,20 - 24 years,0,0,0
Kells Town,2019,25 - 29 years,0,0,0
Kells Town,2019,30 - 34 years,1,0,1
Kells Town,2019,35 - 39 years,1,0,1
Kells Town,2019,40 - 44 years,0,0,0
Kells Town,2019,45 - 49 years,0,0,0
Kells Town,2019,5 - 9 years,0,0,0
Kells Town,2019,50 - 54 years,0,0,0
Kells Town,2019,55 - 59 years,0,1,1
Kells Town,2019,60 - 64 years,2,1,3
Kells Town,2019,65 - 69 years,0,1,1
Kells Town,2019,70 - 74 years,1,1,2
Kells Town,2019,75 - 79 years,1,0,1
Kells Town,2019,80 - 84 years,2,4,6
Kells Town,2019,85 years and over,7,1,8
Kells Town,2019,Under 1 year,0,0,0
Kells Town,2020,1 - 4 years,0,0,0
Kells Town,2020,10 - 14 years,0,0,0
Kells Town,2020,15 - 19 years,0,0,0
Kells Town,2020,20 - 24 years,0,0,0
Kells Town,2020,25 - 29 years,0,0,0
Kells Town,2020,30 - 34 years,1,0,1
Kells Town,2020,35 - 39 years,1,0,1
Kells Town,2020,40 - 44 years,0,0,0
Kells Town,2020,45 - 49 years,0,0,0
Kells Town,2020,5 - 9 years,0,0,0
Kells Town,2020,50 - 54 years,0,0,0
Kells Town,2020,55 - 59 years,0,1,1
Kells Town,2020,60 - 64 years,2,1,3
Kells Town,2020,65 - 69 years,0,1,1
Kells Town,2020,70 - 74 years,1,1,2
Kells Town,2020,75 - 79 years,1,0,1
Kells Town,2020,80 - 84 years,2,4,6
Kells Town,2020,85 years and over,7,1,8
Kells Town,2020,Under 1 year,0,0,0
Kerry,2007,1 - 4 years,0,0,0
Kerry,2007,10 - 14 years,2,3,5
Kerry,2007,15 - 19 years,1,2,3
Kerry,2007,20 - 24 years,1,7,8
Kerry,2007,25 - 29 years,2,11,13
Kerry,2007,30 - 34 years,3,2,5
Kerry,2007,35 - 39 years,4,1,5
Kerry,2007,40 - 44 years,5,13,18
Kerry,2007,45 - 49 years,7,7,14
Kerry,2007,5 - 9 years,0,0,0
Kerry,2007,50 - 54 years,11,25,36
Kerry,2007,55 - 59 years,14,42,56
Kerry,2007,60 - 64 years,18,50,68
Kerry,2007,65 - 69 years,27,51,78
Kerry,2007,70 - 74 years,42,75,117
Kerry,2007,75 - 79 years,75,97,172
Kerry,2007,80 - 84 years,102,125,227
Kerry,2007,85 years and over,192,127,319
Kerry,2007,Under 1 year,5,4,9
Kerry,2008,1 - 4 years,1,3,4
Kerry,2008,10 - 14 years,1,3,4
Kerry,2008,15 - 19 years,1,2,3
Kerry,2008,20 - 24 years,1,6,7
Kerry,2008,25 - 29 years,2,3,5
Kerry,2008,30 - 34 years,1,4,5
Kerry,2008,35 - 39 years,5,3,8
Kerry,2008,40 - 44 years,4,9,13
Kerry,2008,45 - 49 years,11,18,29
Kerry,2008,5 - 9 years,1,1,2
Kerry,2008,50 - 54 years,9,25,34
Kerry,2008,55 - 59 years,16,29,45
Kerry,2008,60 - 64 years,25,52,77
Kerry,2008,65 - 69 years,24,67,91
Kerry,2008,70 - 74 years,40,76,116
Kerry,2008,75 - 79 years,77,71,148
Kerry,2008,80 - 84 years,111,109,220
Kerry,2008,85 years and over,202,143,345
Kerry,2008,Under 1 year,3,6,9
Kerry,2009,1 - 4 years,1,3,4
Kerry,2009,10 - 14 years,1,1,2
Kerry,2009,15 - 19 years,1,6,7
Kerry,2009,20 - 24 years,1,6,7
Kerry,2009,25 - 29 years,2,5,7
Kerry,2009,30 - 34 years,2,3,5
Kerry,2009,35 - 39 years,3,10,13
Kerry,2009,40 - 44 years,6,10,16
Kerry,2009,45 - 49 years,7,13,20
Kerry,2009,5 - 9 years,1,1,2
Kerry,2009,50 - 54 years,12,21,33
Kerry,2009,55 - 59 years,19,21,40
Kerry,2009,60 - 64 years,26,36,62
Kerry,2009,65 - 69 years,20,55,75
Kerry,2009,70 - 74 years,32,73,105
Kerry,2009,75 - 79 years,68,106,174
Kerry,2009,80 - 84 years,101,120,221
Kerry,2009,85 years and over,204,140,344
Kerry,2009,Under 1 year,3,2,5
Kerry,2010,1 - 4 years,1,3,4
Kerry,2010,10 - 14 years,1,1,2
Kerry,2010,15 - 19 years,1,10,11
Kerry,2010,20 - 24 years,1,6,7
Kerry,2010,25 - 29 years,2,7,9
Kerry,2010,30 - 34 years,2,2,4
Kerry,2010,35 - 39 years,4,5,9
Kerry,2010,40 - 44 years,10,5,15
Kerry,2010,45 - 49 years,5,13,18
Kerry,2010,5 - 9 years,1,1,2
Kerry,2010,50 - 54 years,13,21,34
Kerry,2010,55 - 59 years,14,37,51
Kerry,2010,60 - 64 years,17,54,71
Kerry,2010,65 - 69 years,43,62,105
Kerry,2010,70 - 74 years,40,65,105
Kerry,2010,75 - 79 years,55,88,143
Kerry,2010,80 - 84 years,84,92,176
Kerry,2010,85 years and over,220,139,359
Kerry,2010,Under 1 year,3,8,11
Kerry,2011,1 - 4 years,0,3,3
Kerry,2011,10 - 14 years,0,0,0
Kerry,2011,15 - 19 years,2,3,5
Kerry,2011,20 - 24 years,2,2,4
Kerry,2011,25 - 29 years,3,7,10
Kerry,2011,30 - 34 years,3,3,6
Kerry,2011,35 - 39 years,3,7,10
Kerry,2011,40 - 44 years,7,3,10
Kerry,2011,45 - 49 years,8,11,19
Kerry,2011,5 - 9 years,1,1,2
Kerry,2011,50 - 54 years,15,20,35
Kerry,2011,55 - 59 years,17,21,38
Kerry,2011,60 - 64 years,37,53,90
Kerry,2011,65 - 69 years,30,57,87
Kerry,2011,70 - 74 years,31,71,102
Kerry,2011,75 - 79 years,59,77,136
Kerry,2011,80 - 84 years,85,100,185
Kerry,2011,85 years and over,232,142,374
Kerry,2011,Under 1 year,2,6,8
Kerry,2012,1 - 4 years,1,3,4
Kerry,2012,10 - 14 years,0,2,2
Kerry,2012,15 - 19 years,2,1,3
Kerry,2012,20 - 24 years,1,8,9
Kerry,2012,25 - 29 years,3,5,8
Kerry,2012,30 - 34 years,1,3,4
Kerry,2012,35 - 39 years,4,7,11
Kerry,2012,40 - 44 years,4,10,14
Kerry,2012,45 - 49 years,12,13,25
Kerry,2012,5 - 9 years,1,1,2
Kerry,2012,50 - 54 years,14,15,29
Kerry,2012,55 - 59 years,19,43,62
Kerry,2012,60 - 64 years,21,41,62
Kerry,2012,65 - 69 years,23,57,80
Kerry,2012,70 - 74 years,34,62,96
Kerry,2012,75 - 79 years,56,85,141
Kerry,2012,80 - 84 years,99,125,224
Kerry,2012,85 years and over,218,144,362
Kerry,2012,Under 1 year,4,4,8
Kerry,2013,1 - 4 years,0,1,1
Kerry,2013,10 - 14 years,0,1,1
Kerry,2013,15 - 19 years,1,7,8
Kerry,2013,20 - 24 years,1,5,6
Kerry,2013,25 - 29 years,4,7,11
Kerry,2013,30 - 34 years,2,7,9
Kerry,2013,35 - 39 years,3,6,9
Kerry,2013,40 - 44 years,5,10,15
Kerry,2013,45 - 49 years,11,10,21
Kerry,2013,5 - 9 years,0,0,0
Kerry,2013,50 - 54 years,14,15,29
Kerry,2013,55 - 59 years,14,29,43
Kerry,2013,60 - 64 years,21,29,50
Kerry,2013,65 - 69 years,27,72,99
Kerry,2013,70 - 74 years,41,79,120
Kerry,2013,75 - 79 years,60,93,153
Kerry,2013,80 - 84 years,86,96,182
Kerry,2013,85 years and over,254,169,423
Kerry,2013,Under 1 year,3,7,10
Kerry,2014,1 - 4 years,0,1,1
Kerry,2014,10 - 14 years,0,1,1
Kerry,2014,15 - 19 years,1,2,3
Kerry,2014,20 - 24 years,2,5,7
Kerry,2014,25 - 29 years,1,3,4
Kerry,2014,30 - 34 years,1,4,5
Kerry,2014,35 - 39 years,1,3,4
Kerry,2014,40 - 44 years,2,13,15
Kerry,2014,45 - 49 years,7,16,23
Kerry,2014,5 - 9 years,1,1,2
Kerry,2014,50 - 54 years,10,19,29
Kerry,2014,55 - 59 years,14,36,50
Kerry,2014,60 - 64 years,30,33,63
Kerry,2014,65 - 69 years,39,64,103
Kerry,2014,70 - 74 years,45,62,107
Kerry,2014,75 - 79 years,61,84,145
Kerry,2014,80 - 84 years,103,119,222
Kerry,2014,85 years and over,239,144,383
Kerry,2014,Under 1 year,6,3,9
Kerry,2015,1 - 4 years,0,1,1
Kerry,2015,10 - 14 years,0,1,1
Kerry,2015,15 - 19 years,2,1,3
Kerry,2015,20 - 24 years,2,2,4
Kerry,2015,25 - 29 years,1,6,7
Kerry,2015,30 - 34 years,3,2,5
Kerry,2015,35 - 39 years,2,6,8
Kerry,2015,40 - 44 years,3,5,8
Kerry,2015,45 - 49 years,9,3,12
Kerry,2015,5 - 9 years,1,1,2
Kerry,2015,50 - 54 years,13,28,41
Kerry,2015,55 - 59 years,22,20,42
Kerry,2015,60 - 64 years,15,41,56
Kerry,2015,65 - 69 years,28,56,84
Kerry,2015,70 - 74 years,41,78,119
Kerry,2015,75 - 79 years,61,94,155
Kerry,2015,80 - 84 years,101,102,203
Kerry,2015,85 years and over,282,136,418
Kerry,2015,Under 1 year,3,4,7
Kerry,2016,1 - 4 years,0,1,1
Kerry,2016,10 - 14 years,1,1,2
Kerry,2016,15 - 19 years,2,1,3
Kerry,2016,20 - 24 years,2,1,3
Kerry,2016,25 - 29 years,1,4,5
Kerry,2016,30 - 34 years,2,2,4
Kerry,2016,35 - 39 years,5,5,10
Kerry,2016,40 - 44 years,6,6,12
Kerry,2016,45 - 49 years,5,13,18
Kerry,2016,5 - 9 years,1,1,2
Kerry,2016,50 - 54 years,13,19,32
Kerry,2016,55 - 59 years,25,30,55
Kerry,2016,60 - 64 years,20,43,63
Kerry,2016,65 - 69 years,33,60,93
Kerry,2016,70 - 74 years,55,70,125
Kerry,2016,75 - 79 years,67,91,158
Kerry,2016,80 - 84 years,91,122,213
Kerry,2016,85 years and over,260,158,418
Kerry,2016,Under 1 year,1,4,5
Kerry,2017,1 - 4 years,0,1,1
Kerry,2017,10 - 14 years,1,1,2
Kerry,2017,15 - 19 years,1,1,2
Kerry,2017,20 - 24 years,1,1,2
Kerry,2017,25 - 29 years,1,1,2
Kerry,2017,30 - 34 years,4,5,9
Kerry,2017,35 - 39 years,2,2,4
Kerry,2017,40 - 44 years,5,5,10
Kerry,2017,45 - 49 years,8,8,16
Kerry,2017,5 - 9 years,1,1,2
Kerry,2017,50 - 54 years,4,19,23
Kerry,2017,55 - 59 years,14,22,36
Kerry,2017,60 - 64 years,20,34,54
Kerry,2017,65 - 69 years,27,43,70
Kerry,2017,70 - 74 years,55,68,123
Kerry,2017,75 - 79 years,47,97,144
Kerry,2017,80 - 84 years,84,105,189
Kerry,2017,85 years and over,265,171,436
Kerry,2017,Under 1 year,4,3,7
Kerry,2018,1 - 4 years,0,0,0
Kerry,2018,10 - 14 years,1,1,2
Kerry,2018,15 - 19 years,1,1,2
Kerry,2018,20 - 24 years,2,2,4
Kerry,2018,25 - 29 years,3,2,5
Kerry,2018,30 - 34 years,1,6,7
Kerry,2018,35 - 39 years,3,4,7
Kerry,2018,40 - 44 years,3,11,14
Kerry,2018,45 - 49 years,5,13,18
Kerry,2018,5 - 9 years,0,0,0
Kerry,2018,50 - 54 years,8,26,34
Kerry,2018,55 - 59 years,17,29,46
Kerry,2018,60 - 64 years,30,41,71
Kerry,2018,65 - 69 years,30,60,90
Kerry,2018,70 - 74 years,49,77,126
Kerry,2018,75 - 79 years,64,106,170
Kerry,2018,80 - 84 years,98,92,190
Kerry,2018,85 years and over,242,169,411
Kerry,2018,Under 1 year,1,5,6
Kerry,2019,1 - 4 years,0,0,0
Kerry,2019,10 - 14 years,0,1,1
Kerry,2019,15 - 19 years,1,0,1
Kerry,2019,20 - 24 years,1,1,2
Kerry,2019,25 - 29 years,2,2,4
Kerry,2019,30 - 34 years,1,5,6
Kerry,2019,35 - 39 years,3,4,7
Kerry,2019,40 - 44 years,5,8,13
Kerry,2019,45 - 49 years,5,12,17
Kerry,2019,5 - 9 years,0,0,0
Kerry,2019,50 - 54 years,18,14,32
Kerry,2019,55 - 59 years,12,25,37
Kerry,2019,60 - 64 years,24,30,54
Kerry,2019,65 - 69 years,30,60,90
Kerry,2019,70 - 74 years,62,87,149
Kerry,2019,75 - 79 years,70,100,170
Kerry,2019,80 - 84 years,95,113,208
Kerry,2019,85 years and over,252,192,444
Kerry,2019,Under 1 year,0,5,5
Kerry,2020,1 - 4 years,0,0,0
Kerry,2020,10 - 14 years,0,1,1
Kerry,2020,15 - 19 years,1,1,2
Kerry,2020,20 - 24 years,1,2,3
Kerry,2020,25 - 29 years,2,2,4
Kerry,2020,30 - 34 years,2,5,7
Kerry,2020,35 - 39 years,3,5,8
Kerry,2020,40 - 44 years,2,8,10
Kerry,2020,45 - 49 years,11,16,27
Kerry,2020,5 - 9 years,1,0,1
Kerry,2020,50 - 54 years,10,12,22
Kerry,2020,55 - 59 years,20,21,41
Kerry,2020,60 - 64 years,22,34,56
Kerry,2020,65 - 69 years,29,59,88
Kerry,2020,70 - 74 years,49,93,142
Kerry,2020,75 - 79 years,70,102,172
Kerry,2020,80 - 84 years,82,112,194
Kerry,2020,85 years and over,247,171,418
Kerry,2020,Under 1 year,3,5,8
Kildare,2007,1 - 4 years,2,3,5
Kildare,2007,10 - 14 years,2,2,4
Kildare,2007,15 - 19 years,2,6,8
Kildare,2007,20 - 24 years,4,9,13
Kildare,2007,25 - 29 years,3,10,13
Kildare,2007,30 - 34 years,2,8,10
Kildare,2007,35 - 39 years,8,5,13
Kildare,2007,40 - 44 years,6,10,16
Kildare,2007,45 - 49 years,9,14,23
Kildare,2007,5 - 9 years,1,0,1
Kildare,2007,50 - 54 years,10,22,32
Kildare,2007,55 - 59 years,8,26,34
Kildare,2007,60 - 64 years,20,41,61
Kildare,2007,65 - 69 years,19,46,65
Kildare,2007,70 - 74 years,36,42,78
Kildare,2007,75 - 79 years,44,62,106
Kildare,2007,80 - 84 years,69,60,129
Kildare,2007,85 years and over,124,72,196
Kildare,2007,Under 1 year,4,10,14
Kildare,2008,1 - 4 years,1,1,2
Kildare,2008,10 - 14 years,2,1,3
Kildare,2008,15 - 19 years,4,5,9
Kildare,2008,20 - 24 years,1,5,6
Kildare,2008,25 - 29 years,3,9,12
Kildare,2008,30 - 34 years,3,3,6
Kildare,2008,35 - 39 years,9,13,22
Kildare,2008,40 - 44 years,3,12,15
Kildare,2008,45 - 49 years,4,17,21
Kildare,2008,5 - 9 years,2,3,5
Kildare,2008,50 - 54 years,10,22,32
Kildare,2008,55 - 59 years,24,25,49
Kildare,2008,60 - 64 years,30,46,76
Kildare,2008,65 - 69 years,29,43,72
Kildare,2008,70 - 74 years,32,47,79
Kildare,2008,75 - 79 years,41,75,116
Kildare,2008,80 - 84 years,65,56,121
Kildare,2008,85 years and over,145,91,236
Kildare,2008,Under 1 year,8,12,20
Kildare,2009,1 - 4 years,2,2,4
Kildare,2009,10 - 14 years,4,1,5
Kildare,2009,15 - 19 years,1,5,6
Kildare,2009,20 - 24 years,1,3,4
Kildare,2009,25 - 29 years,3,12,15
Kildare,2009,30 - 34 years,3,5,8
Kildare,2009,35 - 39 years,2,10,12
Kildare,2009,40 - 44 years,3,18,21
Kildare,2009,45 - 49 years,7,18,25
Kildare,2009,5 - 9 years,2,3,5
Kildare,2009,50 - 54 years,16,19,35
Kildare,2009,55 - 59 years,18,29,47
Kildare,2009,60 - 64 years,32,39,71
Kildare,2009,65 - 69 years,31,42,73
Kildare,2009,70 - 74 years,45,41,86
Kildare,2009,75 - 79 years,52,45,97
Kildare,2009,80 - 84 years,67,66,133
Kildare,2009,85 years and over,156,92,248
Kildare,2009,Under 1 year,7,6,13
Kildare,2010,1 - 4 years,1,1,2
Kildare,2010,10 - 14 years,4,2,6
Kildare,2010,15 - 19 years,1,1,2
Kildare,2010,20 - 24 years,4,6,10
Kildare,2010,25 - 29 years,3,10,13
Kildare,2010,30 - 34 years,7,10,17
Kildare,2010,35 - 39 years,3,3,6
Kildare,2010,40 - 44 years,2,9,11
Kildare,2010,45 - 49 years,11,16,27
Kildare,2010,5 - 9 years,2,1,3
Kildare,2010,50 - 54 years,17,24,41
Kildare,2010,55 - 59 years,16,29,45
Kildare,2010,60 - 64 years,27,33,60
Kildare,2010,65 - 69 years,33,53,86
Kildare,2010,70 - 74 years,31,42,73
Kildare,2010,75 - 79 years,40,63,103
Kildare,2010,80 - 84 years,48,69,117
Kildare,2010,85 years and over,160,76,236
Kildare,2010,Under 1 year,6,5,11
Kildare,2011,1 - 4 years,0,0,0
Kildare,2011,10 - 14 years,1,1,2
Kildare,2011,15 - 19 years,5,3,8
Kildare,2011,20 - 24 years,1,5,6
Kildare,2011,25 - 29 years,1,7,8
Kildare,2011,30 - 34 years,1,5,6
Kildare,2011,35 - 39 years,5,12,17
Kildare,2011,40 - 44 years,7,21,28
Kildare,2011,45 - 49 years,12,16,28
Kildare,2011,5 - 9 years,0,1,1
Kildare,2011,50 - 54 years,6,17,23
Kildare,2011,55 - 59 years,15,31,46
Kildare,2011,60 - 64 years,22,35,57
Kildare,2011,65 - 69 years,43,60,103
Kildare,2011,70 - 74 years,40,45,85
Kildare,2011,75 - 79 years,40,60,100
Kildare,2011,80 - 84 years,58,52,110
Kildare,2011,85 years and over,152,79,231
Kildare,2011,Under 1 year,3,8,11
Kildare,2012,1 - 4 years,1,2,3
Kildare,2012,10 - 14 years,1,1,2
Kildare,2012,15 - 19 years,5,1,6
Kildare,2012,20 - 24 years,6,4,10
Kildare,2012,25 - 29 years,2,4,6
Kildare,2012,30 - 34 years,1,7,8
Kildare,2012,35 - 39 years,5,9,14
Kildare,2012,40 - 44 years,5,13,18
Kildare,2012,45 - 49 years,15,11,26
Kildare,2012,5 - 9 years,0,1,1
Kildare,2012,50 - 54 years,13,15,28
Kildare,2012,55 - 59 years,27,29,56
Kildare,2012,60 - 64 years,28,37,65
Kildare,2012,65 - 69 years,28,55,83
Kildare,2012,70 - 74 years,39,61,100
Kildare,2012,75 - 79 years,47,65,112
Kildare,2012,80 - 84 years,62,60,122
Kildare,2012,85 years and over,170,86,256
Kildare,2012,Under 1 year,5,10,15
Kildare,2013,1 - 4 years,0,0,0
Kildare,2013,10 - 14 years,0,0,0
Kildare,2013,15 - 19 years,0,1,1
Kildare,2013,20 - 24 years,3,3,6
Kildare,2013,25 - 29 years,1,10,11
Kildare,2013,30 - 34 years,2,13,15
Kildare,2013,35 - 39 years,7,4,11
Kildare,2013,40 - 44 years,9,15,24
Kildare,2013,45 - 49 years,5,15,20
Kildare,2013,5 - 9 years,0,1,1
Kildare,2013,50 - 54 years,15,22,37
Kildare,2013,55 - 59 years,20,21,41
Kildare,2013,60 - 64 years,33,47,80
Kildare,2013,65 - 69 years,29,50,79
Kildare,2013,70 - 74 years,38,57,95
Kildare,2013,75 - 79 years,50,57,107
Kildare,2013,80 - 84 years,66,56,122
Kildare,2013,85 years and over,178,90,268
Kildare,2013,Under 1 year,1,5,6
Kildare,2014,1 - 4 years,1,0,1
Kildare,2014,10 - 14 years,0,0,0
Kildare,2014,15 - 19 years,1,1,2
Kildare,2014,20 - 24 years,1,6,7
Kildare,2014,25 - 29 years,1,3,4
Kildare,2014,30 - 34 years,1,5,6
Kildare,2014,35 - 39 years,4,8,12
Kildare,2014,40 - 44 years,7,11,18
Kildare,2014,45 - 49 years,10,10,20
Kildare,2014,5 - 9 years,1,1,2
Kildare,2014,50 - 54 years,10,25,35
Kildare,2014,55 - 59 years,23,23,46
Kildare,2014,60 - 64 years,25,48,73
Kildare,2014,65 - 69 years,38,45,83
Kildare,2014,70 - 74 years,45,47,92
Kildare,2014,75 - 79 years,54,66,120
Kildare,2014,80 - 84 years,68,58,126
Kildare,2014,85 years and over,181,103,284
Kildare,2014,Under 1 year,1,2,3
Kildare,2015,1 - 4 years,1,1,2
Kildare,2015,10 - 14 years,0,0,0
Kildare,2015,15 - 19 years,1,6,7
Kildare,2015,20 - 24 years,1,5,6
Kildare,2015,25 - 29 years,5,2,7
Kildare,2015,30 - 34 years,3,4,7
Kildare,2015,35 - 39 years,7,4,11
Kildare,2015,40 - 44 years,4,7,11
Kildare,2015,45 - 49 years,6,20,26
Kildare,2015,5 - 9 years,1,1,2
Kildare,2015,50 - 54 years,16,17,33
Kildare,2015,55 - 59 years,18,22,40
Kildare,2015,60 - 64 years,18,54,72
Kildare,2015,65 - 69 years,31,53,84
Kildare,2015,70 - 74 years,45,64,109
Kildare,2015,75 - 79 years,48,78,126
Kildare,2015,80 - 84 years,43,69,112
Kildare,2015,85 years and over,178,83,261
Kildare,2015,Under 1 year,2,3,5
Kildare,2016,1 - 4 years,1,1,2
Kildare,2016,10 - 14 years,0,3,3
Kildare,2016,15 - 19 years,2,4,6
Kildare,2016,20 - 24 years,1,4,5
Kildare,2016,25 - 29 years,2,2,4
Kildare,2016,30 - 34 years,1,7,8
Kildare,2016,35 - 39 years,2,8,10
Kildare,2016,40 - 44 years,8,7,15
Kildare,2016,45 - 49 years,8,14,22
Kildare,2016,5 - 9 years,1,1,2
Kildare,2016,50 - 54 years,16,25,41
Kildare,2016,55 - 59 years,21,22,43
Kildare,2016,60 - 64 years,25,33,58
Kildare,2016,65 - 69 years,43,57,100
Kildare,2016,70 - 74 years,51,82,133
Kildare,2016,75 - 79 years,52,65,117
Kildare,2016,80 - 84 years,61,78,139
Kildare,2016,85 years and over,177,99,276
Kildare,2016,Under 1 year,2,5,7
Kildare,2017,1 - 4 years,2,1,3
Kildare,2017,10 - 14 years,0,3,3
Kildare,2017,15 - 19 years,1,3,4
Kildare,2017,20 - 24 years,1,2,3
Kildare,2017,25 - 29 years,2,3,5
Kildare,2017,30 - 34 years,4,4,8
Kildare,2017,35 - 39 years,1,9,10
Kildare,2017,40 - 44 years,3,10,13
Kildare,2017,45 - 49 years,10,8,18
Kildare,2017,5 - 9 years,1,1,2
Kildare,2017,50 - 54 years,9,25,34
Kildare,2017,55 - 59 years,17,26,43
Kildare,2017,60 - 64 years,30,42,72
Kildare,2017,65 - 69 years,28,55,83
Kildare,2017,70 - 74 years,52,77,129
Kildare,2017,75 - 79 years,54,71,125
Kildare,2017,80 - 84 years,69,71,140
Kildare,2017,85 years and over,185,119,304
Kildare,2017,Under 1 year,5,6,11
Kildare,2018,1 - 4 years,3,0,3
Kildare,2018,10 - 14 years,1,2,3
Kildare,2018,15 - 19 years,1,2,3
Kildare,2018,20 - 24 years,1,7,8
Kildare,2018,25 - 29 years,1,6,7
Kildare,2018,30 - 34 years,5,5,10
Kildare,2018,35 - 39 years,9,8,17
Kildare,2018,40 - 44 years,10,11,21
Kildare,2018,45 - 49 years,9,21,30
Kildare,2018,5 - 9 years,1,0,1
Kildare,2018,50 - 54 years,10,22,32
Kildare,2018,55 - 59 years,17,26,43
Kildare,2018,60 - 64 years,29,39,68
Kildare,2018,65 - 69 years,22,53,75
Kildare,2018,70 - 74 years,48,73,121
Kildare,2018,75 - 79 years,47,81,128
Kildare,2018,80 - 84 years,65,93,158
Kildare,2018,85 years and over,162,113,275
Kildare,2018,Under 1 year,1,7,8
Kildare,2019,1 - 4 years,2,0,2
Kildare,2019,10 - 14 years,0,1,1
Kildare,2019,15 - 19 years,1,4,5
Kildare,2019,20 - 24 years,1,4,5
Kildare,2019,25 - 29 years,0,5,5
Kildare,2019,30 - 34 years,3,5,8
Kildare,2019,35 - 39 years,5,7,12
Kildare,2019,40 - 44 years,9,10,19
Kildare,2019,45 - 49 years,6,16,22
Kildare,2019,5 - 9 years,0,2,2
Kildare,2019,50 - 54 years,14,23,37
Kildare,2019,55 - 59 years,19,40,59
Kildare,2019,60 - 64 years,21,41,62
Kildare,2019,65 - 69 years,38,56,94
Kildare,2019,70 - 74 years,42,81,123
Kildare,2019,75 - 79 years,55,82,137
Kildare,2019,80 - 84 years,57,92,149
Kildare,2019,85 years and over,164,136,300
Kildare,2019,Under 1 year,4,8,12
Kildare,2020,1 - 4 years,2,1,3
Kildare,2020,10 - 14 years,0,1,1
Kildare,2020,15 - 19 years,2,4,6
Kildare,2020,20 - 24 years,3,1,4
Kildare,2020,25 - 29 years,2,5,7
Kildare,2020,30 - 34 years,1,3,4
Kildare,2020,35 - 39 years,2,4,6
Kildare,2020,40 - 44 years,3,13,16
Kildare,2020,45 - 49 years,13,13,26
Kildare,2020,5 - 9 years,1,1,2
Kildare,2020,50 - 54 years,5,28,33
Kildare,2020,55 - 59 years,26,29,55
Kildare,2020,60 - 64 years,31,46,77
Kildare,2020,65 - 69 years,42,63,105
Kildare,2020,70 - 74 years,60,86,146
Kildare,2020,75 - 79 years,74,71,145
Kildare,2020,80 - 84 years,88,94,182
Kildare,2020,85 years and over,208,128,336
Kildare,2020,Under 1 year,3,6,9
Kilkenny,2007,1 - 4 years,3,0,3
Kilkenny,2007,10 - 14 years,0,2,2
Kilkenny,2007,15 - 19 years,2,7,9
Kilkenny,2007,20 - 24 years,0,0,0
Kilkenny,2007,25 - 29 years,0,1,1
Kilkenny,2007,30 - 34 years,2,3,5
Kilkenny,2007,35 - 39 years,0,6,6
Kilkenny,2007,40 - 44 years,3,1,4
Kilkenny,2007,45 - 49 years,5,12,17
Kilkenny,2007,5 - 9 years,0,0,0
Kilkenny,2007,50 - 54 years,4,9,13
Kilkenny,2007,55 - 59 years,8,16,24
Kilkenny,2007,60 - 64 years,9,26,35
Kilkenny,2007,65 - 69 years,15,17,32
Kilkenny,2007,70 - 74 years,21,39,60
Kilkenny,2007,75 - 79 years,38,48,86
Kilkenny,2007,80 - 84 years,50,44,94
Kilkenny,2007,85 years and over,94,70,164
Kilkenny,2007,Under 1 year,1,3,4
Kilkenny,2008,1 - 4 years,1,1,2
Kilkenny,2008,10 - 14 years,1,1,2
Kilkenny,2008,15 - 19 years,2,1,3
Kilkenny,2008,20 - 24 years,1,3,4
Kilkenny,2008,25 - 29 years,1,1,2
Kilkenny,2008,30 - 34 years,2,2,4
Kilkenny,2008,35 - 39 years,2,2,4
Kilkenny,2008,40 - 44 years,3,7,10
Kilkenny,2008,45 - 49 years,5,8,13
Kilkenny,2008,5 - 9 years,0,1,1
Kilkenny,2008,50 - 54 years,10,8,18
Kilkenny,2008,55 - 59 years,9,13,22
Kilkenny,2008,60 - 64 years,9,21,30
Kilkenny,2008,65 - 69 years,19,26,45
Kilkenny,2008,70 - 74 years,13,45,58
Kilkenny,2008,75 - 79 years,53,40,93
Kilkenny,2008,80 - 84 years,50,57,107
Kilkenny,2008,85 years and over,106,61,167
Kilkenny,2008,Under 1 year,2,2,4
Kilkenny,2009,1 - 4 years,1,1,2
Kilkenny,2009,10 - 14 years,1,1,2
Kilkenny,2009,15 - 19 years,1,1,2
Kilkenny,2009,20 - 24 years,2,1,3
Kilkenny,2009,25 - 29 years,1,1,2
Kilkenny,2009,30 - 34 years,2,2,4
Kilkenny,2009,35 - 39 years,3,4,7
Kilkenny,2009,40 - 44 years,3,6,9
Kilkenny,2009,45 - 49 years,2,5,7
Kilkenny,2009,5 - 9 years,0,1,1
Kilkenny,2009,50 - 54 years,6,8,14
Kilkenny,2009,55 - 59 years,9,17,26
Kilkenny,2009,60 - 64 years,18,23,41
Kilkenny,2009,65 - 69 years,10,25,35
Kilkenny,2009,70 - 74 years,20,32,52
Kilkenny,2009,75 - 79 years,40,43,83
Kilkenny,2009,80 - 84 years,44,53,97
Kilkenny,2009,85 years and over,120,68,188
Kilkenny,2009,Under 1 year,3,2,5
Kilkenny,2010,1 - 4 years,1,4,5
Kilkenny,2010,10 - 14 years,1,1,2
Kilkenny,2010,15 - 19 years,1,3,4
Kilkenny,2010,20 - 24 years,2,2,4
Kilkenny,2010,25 - 29 years,2,3,5
Kilkenny,2010,30 - 34 years,1,2,3
Kilkenny,2010,35 - 39 years,3,1,4
Kilkenny,2010,40 - 44 years,4,9,13
Kilkenny,2010,45 - 49 years,5,5,10
Kilkenny,2010,5 - 9 years,0,1,1
Kilkenny,2010,50 - 54 years,6,6,12
Kilkenny,2010,55 - 59 years,7,11,18
Kilkenny,2010,60 - 64 years,13,15,28
Kilkenny,2010,65 - 69 years,18,33,51
Kilkenny,2010,70 - 74 years,20,38,58
Kilkenny,2010,75 - 79 years,28,43,71
Kilkenny,2010,80 - 84 years,50,57,107
Kilkenny,2010,85 years and over,134,74,208
Kilkenny,2010,Under 1 year,2,7,9
Kilkenny,2011,1 - 4 years,0,1,1
Kilkenny,2011,10 - 14 years,0,1,1
Kilkenny,2011,15 - 19 years,0,3,3
Kilkenny,2011,20 - 24 years,0,2,2
Kilkenny,2011,25 - 29 years,1,3,4
Kilkenny,2011,30 - 34 years,2,5,7
Kilkenny,2011,35 - 39 years,3,5,8
Kilkenny,2011,40 - 44 years,5,4,9
Kilkenny,2011,45 - 49 years,4,11,15
Kilkenny,2011,5 - 9 years,1,0,1
Kilkenny,2011,50 - 54 years,3,7,10
Kilkenny,2011,55 - 59 years,11,14,25
Kilkenny,2011,60 - 64 years,11,20,31
Kilkenny,2011,65 - 69 years,16,29,45
Kilkenny,2011,70 - 74 years,24,35,59
Kilkenny,2011,75 - 79 years,31,38,69
Kilkenny,2011,80 - 84 years,49,48,97
Kilkenny,2011,85 years and over,129,77,206
Kilkenny,2011,Under 1 year,1,3,4
Kilkenny,2012,1 - 4 years,1,1,2
Kilkenny,2012,10 - 14 years,0,1,1
Kilkenny,2012,15 - 19 years,0,1,1
Kilkenny,2012,20 - 24 years,0,3,3
Kilkenny,2012,25 - 29 years,2,5,7
Kilkenny,2012,30 - 34 years,1,3,4
Kilkenny,2012,35 - 39 years,1,2,3
Kilkenny,2012,40 - 44 years,3,3,6
Kilkenny,2012,45 - 49 years,3,3,6
Kilkenny,2012,5 - 9 years,1,0,1
Kilkenny,2012,50 - 54 years,10,16,26
Kilkenny,2012,55 - 59 years,9,14,23
Kilkenny,2012,60 - 64 years,11,19,30
Kilkenny,2012,65 - 69 years,27,29,56
Kilkenny,2012,70 - 74 years,19,28,47
Kilkenny,2012,75 - 79 years,38,36,74
Kilkenny,2012,80 - 84 years,46,47,93
Kilkenny,2012,85 years and over,132,86,218
Kilkenny,2012,Under 1 year,2,2,4
Kilkenny,2013,1 - 4 years,0,0,0
Kilkenny,2013,10 - 14 years,0,0,0
Kilkenny,2013,15 - 19 years,0,1,1
Kilkenny,2013,20 - 24 years,1,0,1
Kilkenny,2013,25 - 29 years,1,5,6
Kilkenny,2013,30 - 34 years,0,3,3
Kilkenny,2013,35 - 39 years,0,3,3
Kilkenny,2013,40 - 44 years,3,5,8
Kilkenny,2013,45 - 49 years,4,7,11
Kilkenny,2013,5 - 9 years,0,0,0
Kilkenny,2013,50 - 54 years,7,17,24
Kilkenny,2013,55 - 59 years,10,22,32
Kilkenny,2013,60 - 64 years,13,28,41
Kilkenny,2013,65 - 69 years,26,32,58
Kilkenny,2013,70 - 74 years,20,33,53
Kilkenny,2013,75 - 79 years,37,50,87
Kilkenny,2013,80 - 84 years,49,54,103
Kilkenny,2013,85 years and over,117,88,205
Kilkenny,2013,Under 1 year,3,4,7
Kilkenny,2014,1 - 4 years,1,0,1
Kilkenny,2014,10 - 14 years,0,0,0
Kilkenny,2014,15 - 19 years,0,1,1
Kilkenny,2014,20 - 24 years,1,3,4
Kilkenny,2014,25 - 29 years,1,3,4
Kilkenny,2014,30 - 34 years,1,4,5
Kilkenny,2014,35 - 39 years,3,6,9
Kilkenny,2014,40 - 44 years,2,5,7
Kilkenny,2014,45 - 49 years,2,2,4
Kilkenny,2014,5 - 9 years,1,0,1
Kilkenny,2014,50 - 54 years,6,4,10
Kilkenny,2014,55 - 59 years,7,7,14
Kilkenny,2014,60 - 64 years,13,24,37
Kilkenny,2014,65 - 69 years,18,27,45
Kilkenny,2014,70 - 74 years,18,30,48
Kilkenny,2014,75 - 79 years,33,41,74
Kilkenny,2014,80 - 84 years,44,49,93
Kilkenny,2014,85 years and over,123,77,200
Kilkenny,2014,Under 1 year,2,1,3
Kilkenny,2015,1 - 4 years,1,0,1
Kilkenny,2015,10 - 14 years,0,1,1
Kilkenny,2015,15 - 19 years,0,1,1
Kilkenny,2015,20 - 24 years,2,2,4
Kilkenny,2015,25 - 29 years,2,1,3
Kilkenny,2015,30 - 34 years,1,4,5
Kilkenny,2015,35 - 39 years,2,6,8
Kilkenny,2015,40 - 44 years,1,2,3
Kilkenny,2015,45 - 49 years,7,2,9
Kilkenny,2015,5 - 9 years,1,0,1
Kilkenny,2015,50 - 54 years,4,14,18
Kilkenny,2015,55 - 59 years,8,14,22
Kilkenny,2015,60 - 64 years,13,14,27
Kilkenny,2015,65 - 69 years,15,21,36
Kilkenny,2015,70 - 74 years,26,39,65
Kilkenny,2015,75 - 79 years,34,48,82
Kilkenny,2015,80 - 84 years,53,34,87
Kilkenny,2015,85 years and over,148,100,248
Kilkenny,2015,Under 1 year,1,3,4
Kilkenny,2016,1 - 4 years,1,1,2
Kilkenny,2016,10 - 14 years,1,1,2
Kilkenny,2016,15 - 19 years,1,1,2
Kilkenny,2016,20 - 24 years,2,6,8
Kilkenny,2016,25 - 29 years,2,1,3
Kilkenny,2016,30 - 34 years,1,3,4
Kilkenny,2016,35 - 39 years,1,1,2
Kilkenny,2016,40 - 44 years,1,5,6
Kilkenny,2016,45 - 49 years,3,6,9
Kilkenny,2016,5 - 9 years,1,0,1
Kilkenny,2016,50 - 54 years,5,8,13
Kilkenny,2016,55 - 59 years,9,9,18
Kilkenny,2016,60 - 64 years,14,25,39
Kilkenny,2016,65 - 69 years,16,28,44
Kilkenny,2016,70 - 74 years,21,40,61
Kilkenny,2016,75 - 79 years,38,59,97
Kilkenny,2016,80 - 84 years,44,64,108
Kilkenny,2016,85 years and over,137,116,253
Kilkenny,2016,Under 1 year,2,1,3
Kilkenny,2017,1 - 4 years,1,2,3
Kilkenny,2017,10 - 14 years,1,1,2
Kilkenny,2017,15 - 19 years,1,1,2
Kilkenny,2017,20 - 24 years,1,6,7
Kilkenny,2017,25 - 29 years,1,1,2
Kilkenny,2017,30 - 34 years,1,3,4
Kilkenny,2017,35 - 39 years,1,6,7
Kilkenny,2017,40 - 44 years,3,7,10
Kilkenny,2017,45 - 49 years,8,5,13
Kilkenny,2017,5 - 9 years,1,0,1
Kilkenny,2017,50 - 54 years,9,9,18
Kilkenny,2017,55 - 59 years,9,26,35
Kilkenny,2017,60 - 64 years,9,12,21
Kilkenny,2017,65 - 69 years,23,25,48
Kilkenny,2017,70 - 74 years,32,44,76
Kilkenny,2017,75 - 79 years,33,51,84
Kilkenny,2017,80 - 84 years,45,53,98
Kilkenny,2017,85 years and over,124,83,207
Kilkenny,2017,Under 1 year,2,2,4
Kilkenny,2018,1 - 4 years,0,0,0
Kilkenny,2018,10 - 14 years,0,0,0
Kilkenny,2018,15 - 19 years,1,1,2
Kilkenny,2018,20 - 24 years,1,6,7
Kilkenny,2018,25 - 29 years,0,3,3
Kilkenny,2018,30 - 34 years,1,3,4
Kilkenny,2018,35 - 39 years,2,1,3
Kilkenny,2018,40 - 44 years,3,6,9
Kilkenny,2018,45 - 49 years,2,7,9
Kilkenny,2018,5 - 9 years,0,0,0
Kilkenny,2018,50 - 54 years,5,8,13
Kilkenny,2018,55 - 59 years,6,14,20
Kilkenny,2018,60 - 64 years,22,13,35
Kilkenny,2018,65 - 69 years,28,31,59
Kilkenny,2018,70 - 74 years,23,38,61
Kilkenny,2018,75 - 79 years,40,45,85
Kilkenny,2018,80 - 84 years,54,58,112
Kilkenny,2018,85 years and over,145,100,245
Kilkenny,2018,Under 1 year,1,1,2
Kilkenny,2019,1 - 4 years,0,0,0
Kilkenny,2019,10 - 14 years,0,1,1
Kilkenny,2019,15 - 19 years,1,1,2
Kilkenny,2019,20 - 24 years,0,5,5
Kilkenny,2019,25 - 29 years,2,2,4
Kilkenny,2019,30 - 34 years,1,3,4
Kilkenny,2019,35 - 39 years,2,3,5
Kilkenny,2019,40 - 44 years,4,5,9
Kilkenny,2019,45 - 49 years,3,3,6
Kilkenny,2019,5 - 9 years,0,0,0
Kilkenny,2019,50 - 54 years,5,9,14
Kilkenny,2019,55 - 59 years,6,15,21
Kilkenny,2019,60 - 64 years,12,17,29
Kilkenny,2019,65 - 69 years,20,25,45
Kilkenny,2019,70 - 74 years,33,41,74
Kilkenny,2019,75 - 79 years,36,53,89
Kilkenny,2019,80 - 84 years,49,59,108
Kilkenny,2019,85 years and over,120,109,229
Kilkenny,2019,Under 1 year,0,1,1
Kilkenny,2020,1 - 4 years,0,1,1
Kilkenny,2020,10 - 14 years,0,1,1
Kilkenny,2020,15 - 19 years,1,1,2
Kilkenny,2020,20 - 24 years,2,5,7
Kilkenny,2020,25 - 29 years,2,2,4
Kilkenny,2020,30 - 34 years,1,1,2
Kilkenny,2020,35 - 39 years,3,2,5
Kilkenny,2020,40 - 44 years,2,3,5
Kilkenny,2020,45 - 49 years,2,2,4
Kilkenny,2020,5 - 9 years,0,0,0
Kilkenny,2020,50 - 54 years,3,13,16
Kilkenny,2020,55 - 59 years,4,12,16
Kilkenny,2020,60 - 64 years,5,20,25
Kilkenny,2020,65 - 69 years,20,33,53
Kilkenny,2020,70 - 74 years,29,42,71
Kilkenny,2020,75 - 79 years,33,52,85
Kilkenny,2020,80 - 84 years,40,51,91
Kilkenny,2020,85 years and over,173,105,278
Kilkenny,2020,Under 1 year,0,2,2
Kilkenny Borough,2007,1 - 4 years,0,0,0
Kilkenny Borough,2007,10 - 14 years,0,0,0
Kilkenny Borough,2007,15 - 19 years,0,2,2
Kilkenny Borough,2007,20 - 24 years,0,0,0
Kilkenny Borough,2007,25 - 29 years,0,1,1
Kilkenny Borough,2007,30 - 34 years,0,0,0
Kilkenny Borough,2007,35 - 39 years,0,2,2
Kilkenny Borough,2007,40 - 44 years,0,0,0
Kilkenny Borough,2007,45 - 49 years,0,3,3
Kilkenny Borough,2007,5 - 9 years,0,0,0
Kilkenny Borough,2007,50 - 54 years,1,2,3
Kilkenny Borough,2007,55 - 59 years,2,2,4
Kilkenny Borough,2007,60 - 64 years,3,4,7
Kilkenny Borough,2007,65 - 69 years,2,1,3
Kilkenny Borough,2007,70 - 74 years,1,5,6
Kilkenny Borough,2007,75 - 79 years,8,4,12
Kilkenny Borough,2007,80 - 84 years,6,8,14
Kilkenny Borough,2007,85 years and over,13,7,20
Kilkenny Borough,2007,Under 1 year,0,0,0
Kilkenny Borough,2008,1 - 4 years,1,0,1
Kilkenny Borough,2008,10 - 14 years,0,0,0
Kilkenny Borough,2008,15 - 19 years,0,2,2
Kilkenny Borough,2008,20 - 24 years,0,1,1
Kilkenny Borough,2008,25 - 29 years,0,1,1
Kilkenny Borough,2008,30 - 34 years,0,0,0
Kilkenny Borough,2008,35 - 39 years,0,1,1
Kilkenny Borough,2008,40 - 44 years,0,0,0
Kilkenny Borough,2008,45 - 49 years,1,4,5
Kilkenny Borough,2008,5 - 9 years,0,0,0
Kilkenny Borough,2008,50 - 54 years,1,1,2
Kilkenny Borough,2008,55 - 59 years,2,4,6
Kilkenny Borough,2008,60 - 64 years,1,5,6
Kilkenny Borough,2008,65 - 69 years,5,4,9
Kilkenny Borough,2008,70 - 74 years,2,5,7
Kilkenny Borough,2008,75 - 79 years,13,3,16
Kilkenny Borough,2008,80 - 84 years,13,6,19
Kilkenny Borough,2008,85 years and over,18,4,22
Kilkenny Borough,2008,Under 1 year,1,0,1
Kilkenny Borough,2009,1 - 4 years,1,0,1
Kilkenny Borough,2009,10 - 14 years,0,0,0
Kilkenny Borough,2009,15 - 19 years,0,2,2
Kilkenny Borough,2009,20 - 24 years,1,1,2
Kilkenny Borough,2009,25 - 29 years,0,1,1
Kilkenny Borough,2009,30 - 34 years,0,0,0
Kilkenny Borough,2009,35 - 39 years,1,1,2
Kilkenny Borough,2009,40 - 44 years,0,0,0
Kilkenny Borough,2009,45 - 49 years,1,4,5
Kilkenny Borough,2009,5 - 9 years,0,0,0
Kilkenny Borough,2009,50 - 54 years,3,1,4
Kilkenny Borough,2009,55 - 59 years,5,3,8
Kilkenny Borough,2009,60 - 64 years,9,4,13
Kilkenny Borough,2009,65 - 69 years,3,5,8
Kilkenny Borough,2009,70 - 74 years,3,8,11
Kilkenny Borough,2009,75 - 79 years,6,13,19
Kilkenny Borough,2009,80 - 84 years,13,8,21
Kilkenny Borough,2009,85 years and over,25,14,39
Kilkenny Borough,2009,Under 1 year,1,0,1
Kilkenny Borough,2010,1 - 4 years,1,1,2
Kilkenny Borough,2010,10 - 14 years,0,0,0
Kilkenny Borough,2010,15 - 19 years,0,1,1
Kilkenny Borough,2010,20 - 24 years,1,1,2
Kilkenny Borough,2010,25 - 29 years,0,1,1
Kilkenny Borough,2010,30 - 34 years,1,0,1
Kilkenny Borough,2010,35 - 39 years,1,1,2
Kilkenny Borough,2010,40 - 44 years,1,0,1
Kilkenny Borough,2010,45 - 49 years,3,3,6
Kilkenny Borough,2010,5 - 9 years,0,1,1
Kilkenny Borough,2010,50 - 54 years,3,2,5
Kilkenny Borough,2010,55 - 59 years,2,3,5
Kilkenny Borough,2010,60 - 64 years,2,2,4
Kilkenny Borough,2010,65 - 69 years,2,8,10
Kilkenny Borough,2010,70 - 74 years,6,6,12
Kilkenny Borough,2010,75 - 79 years,8,6,14
Kilkenny Borough,2010,80 - 84 years,7,9,16
Kilkenny Borough,2010,85 years and over,24,7,31
Kilkenny Borough,2010,Under 1 year,1,1,2
Kilkenny Borough,2011,1 - 4 years,0,0,0
Kilkenny Borough,2011,10 - 14 years,0,0,0
Kilkenny Borough,2011,15 - 19 years,0,1,1
Kilkenny Borough,2011,20 - 24 years,0,1,1
Kilkenny Borough,2011,25 - 29 years,1,1,2
Kilkenny Borough,2011,30 - 34 years,0,1,1
Kilkenny Borough,2011,35 - 39 years,1,2,3
Kilkenny Borough,2011,40 - 44 years,0,1,1
Kilkenny Borough,2011,45 - 49 years,0,3,3
Kilkenny Borough,2011,5 - 9 years,0,0,0
Kilkenny Borough,2011,50 - 54 years,1,2,3
Kilkenny Borough,2011,55 - 59 years,3,2,5
Kilkenny Borough,2011,60 - 64 years,3,5,8
Kilkenny Borough,2011,65 - 69 years,3,4,7
Kilkenny Borough,2011,70 - 74 years,7,5,12
Kilkenny Borough,2011,75 - 79 years,5,7,12
Kilkenny Borough,2011,80 - 84 years,8,5,13
Kilkenny Borough,2011,85 years and over,26,10,36
Kilkenny Borough,2011,Under 1 year,0,0,0
Kilkenny Borough,2012,1 - 4 years,0,0,0
Kilkenny Borough,2012,10 - 14 years,0,0,0
Kilkenny Borough,2012,15 - 19 years,0,1,1
Kilkenny Borough,2012,20 - 24 years,0,2,2
Kilkenny Borough,2012,25 - 29 years,1,1,2
Kilkenny Borough,2012,30 - 34 years,0,1,1
Kilkenny Borough,2012,35 - 39 years,1,2,3
Kilkenny Borough,2012,40 - 44 years,1,2,3
Kilkenny Borough,2012,45 - 49 years,2,3,5
Kilkenny Borough,2012,5 - 9 years,0,0,0
Kilkenny Borough,2012,50 - 54 years,3,4,7
Kilkenny Borough,2012,55 - 59 years,3,4,7
Kilkenny Borough,2012,60 - 64 years,2,6,8
Kilkenny Borough,2012,65 - 69 years,5,7,12
Kilkenny Borough,2012,70 - 74 years,7,5,12
Kilkenny Borough,2012,75 - 79 years,8,7,15
Kilkenny Borough,2012,80 - 84 years,10,10,20
Kilkenny Borough,2012,85 years and over,37,14,51
Kilkenny Borough,2012,Under 1 year,0,1,1
Kilkenny Borough,2013,1 - 4 years,0,0,0
Kilkenny Borough,2013,10 - 14 years,0,0,0
Kilkenny Borough,2013,15 - 19 years,0,0,0
Kilkenny Borough,2013,20 - 24 years,0,0,0
Kilkenny Borough,2013,25 - 29 years,0,3,3
Kilkenny Borough,2013,30 - 34 years,0,2,2
Kilkenny Borough,2013,35 - 39 years,0,1,1
Kilkenny Borough,2013,40 - 44 years,1,0,1
Kilkenny Borough,2013,45 - 49 years,0,1,1
Kilkenny Borough,2013,5 - 9 years,0,0,0
Kilkenny Borough,2013,50 - 54 years,2,7,9
Kilkenny Borough,2013,55 - 59 years,3,5,8
Kilkenny Borough,2013,60 - 64 years,1,4,5
Kilkenny Borough,2013,65 - 69 years,7,6,13
Kilkenny Borough,2013,70 - 74 years,3,5,8
Kilkenny Borough,2013,75 - 79 years,7,16,23
Kilkenny Borough,2013,80 - 84 years,13,9,22
Kilkenny Borough,2013,85 years and over,26,15,41
Kilkenny Borough,2013,Under 1 year,0,0,0
Kilkenny Borough,2014,1 - 4 years,0,0,0
Kilkenny Borough,2014,10 - 14 years,0,0,0
Kilkenny Borough,2014,15 - 19 years,0,0,0
Kilkenny Borough,2014,20 - 24 years,0,1,1
Kilkenny Borough,2014,25 - 29 years,0,1,1
Kilkenny Borough,2014,30 - 34 years,0,3,3
Kilkenny Borough,2014,35 - 39 years,1,3,4
Kilkenny Borough,2014,40 - 44 years,1,1,2
Kilkenny Borough,2014,45 - 49 years,0,1,1
Kilkenny Borough,2014,5 - 9 years,0,0,0
Kilkenny Borough,2014,50 - 54 years,2,3,5
Kilkenny Borough,2014,55 - 59 years,4,2,6
Kilkenny Borough,2014,60 - 64 years,2,4,6
Kilkenny Borough,2014,65 - 69 years,3,7,10
Kilkenny Borough,2014,70 - 74 years,6,2,8
Kilkenny Borough,2014,75 - 79 years,4,12,16
Kilkenny Borough,2014,80 - 84 years,14,6,20
Kilkenny Borough,2014,85 years and over,25,12,37
Kilkenny Borough,2014,Under 1 year,0,0,0
Kilkenny Borough,2015,1 - 4 years,0,0,0
Kilkenny Borough,2015,10 - 14 years,0,0,0
Kilkenny Borough,2015,15 - 19 years,0,0,0
Kilkenny Borough,2015,20 - 24 years,0,1,1
Kilkenny Borough,2015,25 - 29 years,0,1,1
Kilkenny Borough,2015,30 - 34 years,0,3,3
Kilkenny Borough,2015,35 - 39 years,1,3,4
Kilkenny Borough,2015,40 - 44 years,1,1,2
Kilkenny Borough,2015,45 - 49 years,0,1,1
Kilkenny Borough,2015,5 - 9 years,0,0,0
Kilkenny Borough,2015,50 - 54 years,2,3,5
Kilkenny Borough,2015,55 - 59 years,4,2,6
Kilkenny Borough,2015,60 - 64 years,2,4,6
Kilkenny Borough,2015,65 - 69 years,3,7,10
Kilkenny Borough,2015,70 - 74 years,6,2,8
Kilkenny Borough,2015,75 - 79 years,4,12,16
Kilkenny Borough,2015,80 - 84 years,14,6,20
Kilkenny Borough,2015,85 years and over,25,12,37
Kilkenny Borough,2015,Under 1 year,0,0,0
Kilkenny Borough,2016,1 - 4 years,0,0,0
Kilkenny Borough,2016,10 - 14 years,0,0,0
Kilkenny Borough,2016,15 - 19 years,0,0,0
Kilkenny Borough,2016,20 - 24 years,0,1,1
Kilkenny Borough,2016,25 - 29 years,0,1,1
Kilkenny Borough,2016,30 - 34 years,0,3,3
Kilkenny Borough,2016,35 - 39 years,1,3,4
Kilkenny Borough,2016,40 - 44 years,1,1,2
Kilkenny Borough,2016,45 - 49 years,0,1,1
Kilkenny Borough,2016,5 - 9 years,0,0,0
Kilkenny Borough,2016,50 - 54 years,2,3,5
Kilkenny Borough,2016,55 - 59 years,4,2,6
Kilkenny Borough,2016,60 - 64 years,2,4,6
Kilkenny Borough,2016,65 - 69 years,3,7,10
Kilkenny Borough,2016,70 - 74 years,6,2,8
Kilkenny Borough,2016,75 - 79 years,4,12,16
Kilkenny Borough,2016,80 - 84 years,14,6,20
Kilkenny Borough,2016,85 years and over,25,12,37
Kilkenny Borough,2016,Under 1 year,0,0,0
Kilkenny Borough,2017,1 - 4 years,0,0,0
Kilkenny Borough,2017,10 - 14 years,0,0,0
Kilkenny Borough,2017,15 - 19 years,0,0,0
Kilkenny Borough,2017,20 - 24 years,0,1,1
Kilkenny Borough,2017,25 - 29 years,0,1,1
Kilkenny Borough,2017,30 - 34 years,0,3,3
Kilkenny Borough,2017,35 - 39 years,1,2,3
Kilkenny Borough,2017,40 - 44 years,1,1,2
Kilkenny Borough,2017,45 - 49 years,5,2,7
Kilkenny Borough,2017,5 - 9 years,0,0,0
Kilkenny Borough,2017,50 - 54 years,2,3,5
Kilkenny Borough,2017,55 - 59 years,2,6,8
Kilkenny Borough,2017,60 - 64 years,2,3,5
Kilkenny Borough,2017,65 - 69 years,2,2,4
Kilkenny Borough,2017,70 - 74 years,5,7,12
Kilkenny Borough,2017,75 - 79 years,7,8,15
Kilkenny Borough,2017,80 - 84 years,5,9,14
Kilkenny Borough,2017,85 years and over,27,12,39
Kilkenny Borough,2017,Under 1 year,0,0,0
Kilkenny Borough,2018,1 - 4 years,0,0,0
Kilkenny Borough,2018,10 - 14 years,0,0,0
Kilkenny Borough,2018,15 - 19 years,0,0,0
Kilkenny Borough,2018,20 - 24 years,0,1,1
Kilkenny Borough,2018,25 - 29 years,0,0,0
Kilkenny Borough,2018,30 - 34 years,0,0,0
Kilkenny Borough,2018,35 - 39 years,0,0,0
Kilkenny Borough,2018,40 - 44 years,0,0,0
Kilkenny Borough,2018,45 - 49 years,0,1,1
Kilkenny Borough,2018,5 - 9 years,0,0,0
Kilkenny Borough,2018,50 - 54 years,2,1,3
Kilkenny Borough,2018,55 - 59 years,3,1,4
Kilkenny Borough,2018,60 - 64 years,5,2,7
Kilkenny Borough,2018,65 - 69 years,3,3,6
Kilkenny Borough,2018,70 - 74 years,6,3,9
Kilkenny Borough,2018,75 - 79 years,3,6,9
Kilkenny Borough,2018,80 - 84 years,7,5,12
Kilkenny Borough,2018,85 years and over,31,11,42
Kilkenny Borough,2018,Under 1 year,0,0,0
Kilkenny Borough,2019,1 - 4 years,0,0,0
Kilkenny Borough,2019,10 - 14 years,0,0,0
Kilkenny Borough,2019,15 - 19 years,0,0,0
Kilkenny Borough,2019,20 - 24 years,0,1,1
Kilkenny Borough,2019,25 - 29 years,0,0,0
Kilkenny Borough,2019,30 - 34 years,0,0,0
Kilkenny Borough,2019,35 - 39 years,0,0,0
Kilkenny Borough,2019,40 - 44 years,0,0,0
Kilkenny Borough,2019,45 - 49 years,0,1,1
Kilkenny Borough,2019,5 - 9 years,0,0,0
Kilkenny Borough,2019,50 - 54 years,2,1,3
Kilkenny Borough,2019,55 - 59 years,3,1,4
Kilkenny Borough,2019,60 - 64 years,5,2,7
Kilkenny Borough,2019,65 - 69 years,3,3,6
Kilkenny Borough,2019,70 - 74 years,6,3,9
Kilkenny Borough,2019,75 - 79 years,3,6,9
Kilkenny Borough,2019,80 - 84 years,7,5,12
Kilkenny Borough,2019,85 years and over,31,11,42
Kilkenny Borough,2019,Under 1 year,0,0,0
Kilkenny Borough,2020,1 - 4 years,0,0,0
Kilkenny Borough,2020,10 - 14 years,0,0,0
Kilkenny Borough,2020,15 - 19 years,0,0,0
Kilkenny Borough,2020,20 - 24 years,0,1,1
Kilkenny Borough,2020,25 - 29 years,0,0,0
Kilkenny Borough,2020,30 - 34 years,0,0,0
Kilkenny Borough,2020,35 - 39 years,0,0,0
Kilkenny Borough,2020,40 - 44 years,0,0,0
Kilkenny Borough,2020,45 - 49 years,0,1,1
Kilkenny Borough,2020,5 - 9 years,0,0,0
Kilkenny Borough,2020,50 - 54 years,2,1,3
Kilkenny Borough,2020,55 - 59 years,3,1,4
Kilkenny Borough,2020,60 - 64 years,5,2,7
Kilkenny Borough,2020,65 - 69 years,3,3,6
Kilkenny Borough,2020,70 - 74 years,6,3,9
Kilkenny Borough,2020,75 - 79 years,3,6,9
Kilkenny Borough,2020,80 - 84 years,7,5,12
Kilkenny Borough,2020,85 years and over,31,11,42
Kilkenny Borough,2020,Under 1 year,0,0,0
Killarney Town,2007,1 - 4 years,0,0,0
Killarney Town,2007,10 - 14 years,0,1,1
Killarney Town,2007,15 - 19 years,0,0,0
Killarney Town,2007,20 - 24 years,0,1,1
Killarney Town,2007,25 - 29 years,0,4,4
Killarney Town,2007,30 - 34 years,2,1,3
Killarney Town,2007,35 - 39 years,0,0,0
Killarney Town,2007,40 - 44 years,0,2,2
Killarney Town,2007,45 - 49 years,1,3,4
Killarney Town,2007,5 - 9 years,0,0,0
Killarney Town,2007,50 - 54 years,0,1,1
Killarney Town,2007,55 - 59 years,2,9,11
Killarney Town,2007,60 - 64 years,3,6,9
Killarney Town,2007,65 - 69 years,3,5,8
Killarney Town,2007,70 - 74 years,1,12,13
Killarney Town,2007,75 - 79 years,7,8,15
Killarney Town,2007,80 - 84 years,12,11,23
Killarney Town,2007,85 years and over,23,12,35
Killarney Town,2007,Under 1 year,1,0,1
Killarney Town,2008,1 - 4 years,0,0,0
Killarney Town,2008,10 - 14 years,0,1,1
Killarney Town,2008,15 - 19 years,0,0,0
Killarney Town,2008,20 - 24 years,0,1,1
Killarney Town,2008,25 - 29 years,0,1,1
Killarney Town,2008,30 - 34 years,1,2,3
Killarney Town,2008,35 - 39 years,1,0,1
Killarney Town,2008,40 - 44 years,1,1,2
Killarney Town,2008,45 - 49 years,1,2,3
Killarney Town,2008,5 - 9 years,0,0,0
Killarney Town,2008,50 - 54 years,1,2,3
Killarney Town,2008,55 - 59 years,2,7,9
Killarney Town,2008,60 - 64 years,5,11,16
Killarney Town,2008,65 - 69 years,3,14,17
Killarney Town,2008,70 - 74 years,7,14,21
Killarney Town,2008,75 - 79 years,9,11,20
Killarney Town,2008,80 - 84 years,22,12,34
Killarney Town,2008,85 years and over,32,22,54
Killarney Town,2008,Under 1 year,1,1,2
Killarney Town,2009,1 - 4 years,0,0,0
Killarney Town,2009,10 - 14 years,0,1,1
Killarney Town,2009,15 - 19 years,0,0,0
Killarney Town,2009,20 - 24 years,0,1,1
Killarney Town,2009,25 - 29 years,0,1,1
Killarney Town,2009,30 - 34 years,1,2,3
Killarney Town,2009,35 - 39 years,1,3,4
Killarney Town,2009,40 - 44 years,1,1,2
Killarney Town,2009,45 - 49 years,2,1,3
Killarney Town,2009,5 - 9 years,0,0,0
Killarney Town,2009,50 - 54 years,1,2,3
Killarney Town,2009,55 - 59 years,2,2,4
Killarney Town,2009,60 - 64 years,2,4,6
Killarney Town,2009,65 - 69 years,2,4,6
Killarney Town,2009,70 - 74 years,2,6,8
Killarney Town,2009,75 - 79 years,7,6,13
Killarney Town,2009,80 - 84 years,8,7,15
Killarney Town,2009,85 years and over,5,7,12
Killarney Town,2009,Under 1 year,1,1,2
Killarney Town,2010,1 - 4 years,0,0,0
Killarney Town,2010,10 - 14 years,0,1,1
Killarney Town,2010,15 - 19 years,0,0,0
Killarney Town,2010,20 - 24 years,0,1,1
Killarney Town,2010,25 - 29 years,0,1,1
Killarney Town,2010,30 - 34 years,1,1,2
Killarney Town,2010,35 - 39 years,1,3,4
Killarney Town,2010,40 - 44 years,1,1,2
Killarney Town,2010,45 - 49 years,2,1,3
Killarney Town,2010,5 - 9 years,0,0,0
Killarney Town,2010,50 - 54 years,1,2,3
Killarney Town,2010,55 - 59 years,1,4,5
Killarney Town,2010,60 - 64 years,1,5,6
Killarney Town,2010,65 - 69 years,5,5,10
Killarney Town,2010,70 - 74 years,3,3,6
Killarney Town,2010,75 - 79 years,6,15,21
Killarney Town,2010,80 - 84 years,8,6,14
Killarney Town,2010,85 years and over,17,10,27
Killarney Town,2010,Under 1 year,1,2,3
Killarney Town,2011,1 - 4 years,0,1,1
Killarney Town,2011,10 - 14 years,0,0,0
Killarney Town,2011,15 - 19 years,0,0,0
Killarney Town,2011,20 - 24 years,0,0,0
Killarney Town,2011,25 - 29 years,0,0,0
Killarney Town,2011,30 - 34 years,0,0,0
Killarney Town,2011,35 - 39 years,0,0,0
Killarney Town,2011,40 - 44 years,0,0,0
Killarney Town,2011,45 - 49 years,0,1,1
Killarney Town,2011,5 - 9 years,0,0,0
Killarney Town,2011,50 - 54 years,1,3,4
Killarney Town,2011,55 - 59 years,2,1,3
Killarney Town,2011,60 - 64 years,0,2,2
Killarney Town,2011,65 - 69 years,1,3,4
Killarney Town,2011,70 - 74 years,1,3,4
Killarney Town,2011,75 - 79 years,7,6,13
Killarney Town,2011,80 - 84 years,6,6,12
Killarney Town,2011,85 years and over,14,10,24
Killarney Town,2011,Under 1 year,0,0,0
Killarney Town,2012,1 - 4 years,0,1,1
Killarney Town,2012,10 - 14 years,0,1,1
Killarney Town,2012,15 - 19 years,0,1,1
Killarney Town,2012,20 - 24 years,0,1,1
Killarney Town,2012,25 - 29 years,0,1,1
Killarney Town,2012,30 - 34 years,0,0,0
Killarney Town,2012,35 - 39 years,2,0,2
Killarney Town,2012,40 - 44 years,0,0,0
Killarney Town,2012,45 - 49 years,0,1,1
Killarney Town,2012,5 - 9 years,0,0,0
Killarney Town,2012,50 - 54 years,1,2,3
Killarney Town,2012,55 - 59 years,2,6,8
Killarney Town,2012,60 - 64 years,3,4,7
Killarney Town,2012,65 - 69 years,2,7,9
Killarney Town,2012,70 - 74 years,2,2,4
Killarney Town,2012,75 - 79 years,7,8,15
Killarney Town,2012,80 - 84 years,11,11,22
Killarney Town,2012,85 years and over,19,15,34
Killarney Town,2012,Under 1 year,0,1,1
Killarney Town,2013,1 - 4 years,0,0,0
Killarney Town,2013,10 - 14 years,0,0,0
Killarney Town,2013,15 - 19 years,0,1,1
Killarney Town,2013,20 - 24 years,0,2,2
Killarney Town,2013,25 - 29 years,0,2,2
Killarney Town,2013,30 - 34 years,0,0,0
Killarney Town,2013,35 - 39 years,0,1,1
Killarney Town,2013,40 - 44 years,0,0,0
Killarney Town,2013,45 - 49 years,3,3,6
Killarney Town,2013,5 - 9 years,0,0,0
Killarney Town,2013,50 - 54 years,0,1,1
Killarney Town,2013,55 - 59 years,1,2,3
Killarney Town,2013,60 - 64 years,5,1,6
Killarney Town,2013,65 - 69 years,6,9,15
Killarney Town,2013,70 - 74 years,3,7,10
Killarney Town,2013,75 - 79 years,4,5,9
Killarney Town,2013,80 - 84 years,9,3,12
Killarney Town,2013,85 years and over,19,10,29
Killarney Town,2013,Under 1 year,2,3,5
Killarney Town,2014,1 - 4 years,0,0,0
Killarney Town,2014,10 - 14 years,0,0,0
Killarney Town,2014,15 - 19 years,0,1,1
Killarney Town,2014,20 - 24 years,0,1,1
Killarney Town,2014,25 - 29 years,0,2,2
Killarney Town,2014,30 - 34 years,0,0,0
Killarney Town,2014,35 - 39 years,0,1,1
Killarney Town,2014,40 - 44 years,1,2,3
Killarney Town,2014,45 - 49 years,1,3,4
Killarney Town,2014,5 - 9 years,0,0,0
Killarney Town,2014,50 - 54 years,3,1,4
Killarney Town,2014,55 - 59 years,2,7,9
Killarney Town,2014,60 - 64 years,3,3,6
Killarney Town,2014,65 - 69 years,3,2,5
Killarney Town,2014,70 - 74 years,2,6,8
Killarney Town,2014,75 - 79 years,9,7,16
Killarney Town,2014,80 - 84 years,6,13,19
Killarney Town,2014,85 years and over,18,7,25
Killarney Town,2014,Under 1 year,1,1,2
Killarney Town,2015,1 - 4 years,0,0,0
Killarney Town,2015,10 - 14 years,0,0,0
Killarney Town,2015,15 - 19 years,0,1,1
Killarney Town,2015,20 - 24 years,0,1,1
Killarney Town,2015,25 - 29 years,0,2,2
Killarney Town,2015,30 - 34 years,0,0,0
Killarney Town,2015,35 - 39 years,0,1,1
Killarney Town,2015,40 - 44 years,1,2,3
Killarney Town,2015,45 - 49 years,1,3,4
Killarney Town,2015,5 - 9 years,0,0,0
Killarney Town,2015,50 - 54 years,3,1,4
Killarney Town,2015,55 - 59 years,2,7,9
Killarney Town,2015,60 - 64 years,3,3,6
Killarney Town,2015,65 - 69 years,3,2,5
Killarney Town,2015,70 - 74 years,2,6,8
Killarney Town,2015,75 - 79 years,9,7,16
Killarney Town,2015,80 - 84 years,6,13,19
Killarney Town,2015,85 years and over,18,7,25
Killarney Town,2015,Under 1 year,1,1,2
Killarney Town,2016,1 - 4 years,0,0,0
Killarney Town,2016,10 - 14 years,0,0,0
Killarney Town,2016,15 - 19 years,0,1,1
Killarney Town,2016,20 - 24 years,0,1,1
Killarney Town,2016,25 - 29 years,0,2,2
Killarney Town,2016,30 - 34 years,0,0,0
Killarney Town,2016,35 - 39 years,0,1,1
Killarney Town,2016,40 - 44 years,1,2,3
Killarney Town,2016,45 - 49 years,1,3,4
Killarney Town,2016,5 - 9 years,0,0,0
Killarney Town,2016,50 - 54 years,3,1,4
Killarney Town,2016,55 - 59 years,2,7,9
Killarney Town,2016,60 - 64 years,3,3,6
Killarney Town,2016,65 - 69 years,3,2,5
Killarney Town,2016,70 - 74 years,2,6,8
Killarney Town,2016,75 - 79 years,9,7,16
Killarney Town,2016,80 - 84 years,6,13,19
Killarney Town,2016,85 years and over,18,7,25
Killarney Town,2016,Under 1 year,1,1,2
Killarney Town,2017,1 - 4 years,0,0,0
Killarney Town,2017,10 - 14 years,0,0,0
Killarney Town,2017,15 - 19 years,0,1,1
Killarney Town,2017,20 - 24 years,0,1,1
Killarney Town,2017,25 - 29 years,0,2,2
Killarney Town,2017,30 - 34 years,1,0,1
Killarney Town,2017,35 - 39 years,0,1,1
Killarney Town,2017,40 - 44 years,1,2,3
Killarney Town,2017,45 - 49 years,1,3,4
Killarney Town,2017,5 - 9 years,0,0,0
Killarney Town,2017,50 - 54 years,3,1,4
Killarney Town,2017,55 - 59 years,1,7,8
Killarney Town,2017,60 - 64 years,1,5,6
Killarney Town,2017,65 - 69 years,3,1,4
Killarney Town,2017,70 - 74 years,3,2,5
Killarney Town,2017,75 - 79 years,4,7,11
Killarney Town,2017,80 - 84 years,10,8,18
Killarney Town,2017,85 years and over,22,17,39
Killarney Town,2017,Under 1 year,1,1,2
Killarney Town,2018,1 - 4 years,0,0,0
Killarney Town,2018,10 - 14 years,1,0,1
Killarney Town,2018,15 - 19 years,0,0,0
Killarney Town,2018,20 - 24 years,1,0,1
Killarney Town,2018,25 - 29 years,0,0,0
Killarney Town,2018,30 - 34 years,0,1,1
Killarney Town,2018,35 - 39 years,0,0,0
Killarney Town,2018,40 - 44 years,0,1,1
Killarney Town,2018,45 - 49 years,2,2,4
Killarney Town,2018,5 - 9 years,0,0,0
Killarney Town,2018,50 - 54 years,2,1,3
Killarney Town,2018,55 - 59 years,1,3,4
Killarney Town,2018,60 - 64 years,1,2,3
Killarney Town,2018,65 - 69 years,4,5,9
Killarney Town,2018,70 - 74 years,3,6,9
Killarney Town,2018,75 - 79 years,7,10,17
Killarney Town,2018,80 - 84 years,12,7,19
Killarney Town,2018,85 years and over,31,10,41
Killarney Town,2018,Under 1 year,0,1,1
Killarney Town,2019,1 - 4 years,0,0,0
Killarney Town,2019,10 - 14 years,1,0,1
Killarney Town,2019,15 - 19 years,0,0,0
Killarney Town,2019,20 - 24 years,1,0,1
Killarney Town,2019,25 - 29 years,0,0,0
Killarney Town,2019,30 - 34 years,0,1,1
Killarney Town,2019,35 - 39 years,0,0,0
Killarney Town,2019,40 - 44 years,0,1,1
Killarney Town,2019,45 - 49 years,2,2,4
Killarney Town,2019,5 - 9 years,0,0,0
Killarney Town,2019,50 - 54 years,2,1,3
Killarney Town,2019,55 - 59 years,1,3,4
Killarney Town,2019,60 - 64 years,1,2,3
Killarney Town,2019,65 - 69 years,4,5,9
Killarney Town,2019,70 - 74 years,3,6,9
Killarney Town,2019,75 - 79 years,7,10,17
Killarney Town,2019,80 - 84 years,12,7,19
Killarney Town,2019,85 years and over,31,10,41
Killarney Town,2019,Under 1 year,0,1,1
Killarney Town,2020,1 - 4 years,0,0,0
Killarney Town,2020,10 - 14 years,1,0,1
Killarney Town,2020,15 - 19 years,0,0,0
Killarney Town,2020,20 - 24 years,1,0,1
Killarney Town,2020,25 - 29 years,0,0,0
Killarney Town,2020,30 - 34 years,0,1,1
Killarney Town,2020,35 - 39 years,0,0,0
Killarney Town,2020,40 - 44 years,0,1,1
Killarney Town,2020,45 - 49 years,2,2,4
Killarney Town,2020,5 - 9 years,0,0,0
Killarney Town,2020,50 - 54 years,2,1,3
Killarney Town,2020,55 - 59 years,1,3,4
Killarney Town,2020,60 - 64 years,1,2,3
Killarney Town,2020,65 - 69 years,4,5,9
Killarney Town,2020,70 - 74 years,3,6,9
Killarney Town,2020,75 - 79 years,7,10,17
Killarney Town,2020,80 - 84 years,12,7,19
Killarney Town,2020,85 years and over,31,10,41
Killarney Town,2020,Under 1 year,0,1,1
Kilrush Town,2007,1 - 4 years,0,0,0
Kilrush Town,2007,10 - 14 years,0,0,0
Kilrush Town,2007,15 - 19 years,0,1,1
Kilrush Town,2007,20 - 24 years,0,0,0
Kilrush Town,2007,25 - 29 years,0,0,0
Kilrush Town,2007,30 - 34 years,0,0,0
Kilrush Town,2007,35 - 39 years,0,0,0
Kilrush Town,2007,40 - 44 years,0,0,0
Kilrush Town,2007,45 - 49 years,2,1,3
Kilrush Town,2007,5 - 9 years,0,0,0
Kilrush Town,2007,50 - 54 years,0,2,2
Kilrush Town,2007,55 - 59 years,1,0,1
Kilrush Town,2007,60 - 64 years,1,2,3
Kilrush Town,2007,65 - 69 years,0,3,3
Kilrush Town,2007,70 - 74 years,1,2,3
Kilrush Town,2007,75 - 79 years,3,5,8
Kilrush Town,2007,80 - 84 years,8,3,11
Kilrush Town,2007,85 years and over,12,2,14
Kilrush Town,2007,Under 1 year,0,0,0
Kilrush Town,2008,1 - 4 years,0,0,0
Kilrush Town,2008,10 - 14 years,0,0,0
Kilrush Town,2008,15 - 19 years,0,1,1
Kilrush Town,2008,20 - 24 years,0,0,0
Kilrush Town,2008,25 - 29 years,0,0,0
Kilrush Town,2008,30 - 34 years,0,0,0
Kilrush Town,2008,35 - 39 years,2,0,2
Kilrush Town,2008,40 - 44 years,0,0,0
Kilrush Town,2008,45 - 49 years,2,1,3
Kilrush Town,2008,5 - 9 years,0,0,0
Kilrush Town,2008,50 - 54 years,1,2,3
Kilrush Town,2008,55 - 59 years,1,2,3
Kilrush Town,2008,60 - 64 years,2,5,7
Kilrush Town,2008,65 - 69 years,2,1,3
Kilrush Town,2008,70 - 74 years,3,5,8
Kilrush Town,2008,75 - 79 years,4,4,8
Kilrush Town,2008,80 - 84 years,5,8,13
Kilrush Town,2008,85 years and over,14,10,24
Kilrush Town,2008,Under 1 year,0,0,0
Kilrush Town,2009,1 - 4 years,0,0,0
Kilrush Town,2009,10 - 14 years,0,0,0
Kilrush Town,2009,15 - 19 years,1,1,2
Kilrush Town,2009,20 - 24 years,0,0,0
Kilrush Town,2009,25 - 29 years,0,1,1
Kilrush Town,2009,30 - 34 years,0,1,1
Kilrush Town,2009,35 - 39 years,2,0,2
Kilrush Town,2009,40 - 44 years,0,0,0
Kilrush Town,2009,45 - 49 years,2,1,3
Kilrush Town,2009,5 - 9 years,0,0,0
Kilrush Town,2009,50 - 54 years,1,2,3
Kilrush Town,2009,55 - 59 years,1,1,2
Kilrush Town,2009,60 - 64 years,2,2,4
Kilrush Town,2009,65 - 69 years,2,3,5
Kilrush Town,2009,70 - 74 years,2,2,4
Kilrush Town,2009,75 - 79 years,5,4,9
Kilrush Town,2009,80 - 84 years,2,2,4
Kilrush Town,2009,85 years and over,7,1,8
Kilrush Town,2009,Under 1 year,0,0,0
Kilrush Town,2010,1 - 4 years,0,0,0
Kilrush Town,2010,10 - 14 years,0,0,0
Kilrush Town,2010,15 - 19 years,1,1,2
Kilrush Town,2010,20 - 24 years,0,0,0
Kilrush Town,2010,25 - 29 years,0,1,1
Kilrush Town,2010,30 - 34 years,0,1,1
Kilrush Town,2010,35 - 39 years,2,0,2
Kilrush Town,2010,40 - 44 years,1,0,1
Kilrush Town,2010,45 - 49 years,2,1,3
Kilrush Town,2010,5 - 9 years,0,0,0
Kilrush Town,2010,50 - 54 years,2,2,4
Kilrush Town,2010,55 - 59 years,1,1,2
Kilrush Town,2010,60 - 64 years,2,2,4
Kilrush Town,2010,65 - 69 years,2,4,6
Kilrush Town,2010,70 - 74 years,1,2,3
Kilrush Town,2010,75 - 79 years,3,5,8
Kilrush Town,2010,80 - 84 years,3,3,6
Kilrush Town,2010,85 years and over,7,8,15
Kilrush Town,2010,Under 1 year,0,0,0
Kilrush Town,2011,1 - 4 years,0,0,0
Kilrush Town,2011,10 - 14 years,0,0,0
Kilrush Town,2011,15 - 19 years,0,0,0
Kilrush Town,2011,20 - 24 years,0,0,0
Kilrush Town,2011,25 - 29 years,0,0,0
Kilrush Town,2011,30 - 34 years,0,0,0
Kilrush Town,2011,35 - 39 years,0,0,0
Kilrush Town,2011,40 - 44 years,0,0,0
Kilrush Town,2011,45 - 49 years,1,0,1
Kilrush Town,2011,5 - 9 years,0,0,0
Kilrush Town,2011,50 - 54 years,0,2,2
Kilrush Town,2011,55 - 59 years,0,1,1
Kilrush Town,2011,60 - 64 years,3,5,8
Kilrush Town,2011,65 - 69 years,0,1,1
Kilrush Town,2011,70 - 74 years,0,2,2
Kilrush Town,2011,75 - 79 years,2,0,2
Kilrush Town,2011,80 - 84 years,0,3,3
Kilrush Town,2011,85 years and over,5,3,8
Kilrush Town,2011,Under 1 year,0,0,0
Kilrush Town,2012,1 - 4 years,0,0,0
Kilrush Town,2012,10 - 14 years,0,0,0
Kilrush Town,2012,15 - 19 years,0,1,1
Kilrush Town,2012,20 - 24 years,0,1,1
Kilrush Town,2012,25 - 29 years,0,0,0
Kilrush Town,2012,30 - 34 years,0,0,0
Kilrush Town,2012,35 - 39 years,0,0,0
Kilrush Town,2012,40 - 44 years,2,0,2
Kilrush Town,2012,45 - 49 years,1,1,2
Kilrush Town,2012,5 - 9 years,0,0,0
Kilrush Town,2012,50 - 54 years,0,2,2
Kilrush Town,2012,55 - 59 years,0,1,1
Kilrush Town,2012,60 - 64 years,2,2,4
Kilrush Town,2012,65 - 69 years,2,4,6
Kilrush Town,2012,70 - 74 years,3,4,7
Kilrush Town,2012,75 - 79 years,1,4,5
Kilrush Town,2012,80 - 84 years,3,8,11
Kilrush Town,2012,85 years and over,14,11,25
Kilrush Town,2012,Under 1 year,0,0,0
Kilrush Town,2013,1 - 4 years,0,0,0
Kilrush Town,2013,10 - 14 years,0,0,0
Kilrush Town,2013,15 - 19 years,0,0,0
Kilrush Town,2013,20 - 24 years,0,0,0
Kilrush Town,2013,25 - 29 years,0,0,0
Kilrush Town,2013,30 - 34 years,0,0,0
Kilrush Town,2013,35 - 39 years,1,0,1
Kilrush Town,2013,40 - 44 years,0,0,0
Kilrush Town,2013,45 - 49 years,0,0,0
Kilrush Town,2013,5 - 9 years,0,0,0
Kilrush Town,2013,50 - 54 years,0,1,1
Kilrush Town,2013,55 - 59 years,0,1,1
Kilrush Town,2013,60 - 64 years,1,3,4
Kilrush Town,2013,65 - 69 years,1,5,6
Kilrush Town,2013,70 - 74 years,1,3,4
Kilrush Town,2013,75 - 79 years,1,2,3
Kilrush Town,2013,80 - 84 years,3,3,6
Kilrush Town,2013,85 years and over,5,7,12
Kilrush Town,2013,Under 1 year,0,0,0
Kilrush Town,2014,1 - 4 years,0,0,0
Kilrush Town,2014,10 - 14 years,0,0,0
Kilrush Town,2014,15 - 19 years,0,0,0
Kilrush Town,2014,20 - 24 years,0,0,0
Kilrush Town,2014,25 - 29 years,0,0,0
Kilrush Town,2014,30 - 34 years,0,0,0
Kilrush Town,2014,35 - 39 years,1,0,1
Kilrush Town,2014,40 - 44 years,0,0,0
Kilrush Town,2014,45 - 49 years,0,0,0
Kilrush Town,2014,5 - 9 years,0,0,0
Kilrush Town,2014,50 - 54 years,1,1,2
Kilrush Town,2014,55 - 59 years,1,1,2
Kilrush Town,2014,60 - 64 years,2,1,3
Kilrush Town,2014,65 - 69 years,4,3,7
Kilrush Town,2014,70 - 74 years,1,3,4
Kilrush Town,2014,75 - 79 years,1,3,4
Kilrush Town,2014,80 - 84 years,3,3,6
Kilrush Town,2014,85 years and over,7,8,15
Kilrush Town,2014,Under 1 year,0,1,1
Kilrush Town,2015,1 - 4 years,0,0,0
Kilrush Town,2015,10 - 14 years,0,0,0
Kilrush Town,2015,15 - 19 years,0,0,0
Kilrush Town,2015,20 - 24 years,0,0,0
Kilrush Town,2015,25 - 29 years,0,0,0
Kilrush Town,2015,30 - 34 years,0,0,0
Kilrush Town,2015,35 - 39 years,1,0,1
Kilrush Town,2015,40 - 44 years,0,0,0
Kilrush Town,2015,45 - 49 years,0,0,0
Kilrush Town,2015,5 - 9 years,0,0,0
Kilrush Town,2015,50 - 54 years,1,1,2
Kilrush Town,2015,55 - 59 years,1,1,2
Kilrush Town,2015,60 - 64 years,2,1,3
Kilrush Town,2015,65 - 69 years,4,3,7
Kilrush Town,2015,70 - 74 years,1,3,4
Kilrush Town,2015,75 - 79 years,1,3,4
Kilrush Town,2015,80 - 84 years,3,3,6
Kilrush Town,2015,85 years and over,7,8,15
Kilrush Town,2015,Under 1 year,0,1,1
Kilrush Town,2016,1 - 4 years,0,0,0
Kilrush Town,2016,10 - 14 years,0,0,0
Kilrush Town,2016,15 - 19 years,0,0,0
Kilrush Town,2016,20 - 24 years,0,0,0
Kilrush Town,2016,25 - 29 years,0,0,0
Kilrush Town,2016,30 - 34 years,0,0,0
Kilrush Town,2016,35 - 39 years,1,0,1
Kilrush Town,2016,40 - 44 years,0,0,0
Kilrush Town,2016,45 - 49 years,0,0,0
Kilrush Town,2016,5 - 9 years,0,0,0
Kilrush Town,2016,50 - 54 years,1,1,2
Kilrush Town,2016,55 - 59 years,1,1,2
Kilrush Town,2016,60 - 64 years,2,1,3
Kilrush Town,2016,65 - 69 years,4,3,7
Kilrush Town,2016,70 - 74 years,1,3,4
Kilrush Town,2016,75 - 79 years,1,3,4
Kilrush Town,2016,80 - 84 years,3,3,6
Kilrush Town,2016,85 years and over,7,8,15
Kilrush Town,2016,Under 1 year,0,1,1
Kilrush Town,2017,1 - 4 years,0,0,0
Kilrush Town,2017,10 - 14 years,0,0,0
Kilrush Town,2017,15 - 19 years,0,0,0
Kilrush Town,2017,20 - 24 years,0,0,0
Kilrush Town,2017,25 - 29 years,0,0,0
Kilrush Town,2017,30 - 34 years,0,0,0
Kilrush Town,2017,35 - 39 years,1,1,2
Kilrush Town,2017,40 - 44 years,0,0,0
Kilrush Town,2017,45 - 49 years,0,0,0
Kilrush Town,2017,5 - 9 years,0,0,0
Kilrush Town,2017,50 - 54 years,1,1,2
Kilrush Town,2017,55 - 59 years,1,1,2
Kilrush Town,2017,60 - 64 years,2,1,3
Kilrush Town,2017,65 - 69 years,2,3,5
Kilrush Town,2017,70 - 74 years,1,1,2
Kilrush Town,2017,75 - 79 years,4,5,9
Kilrush Town,2017,80 - 84 years,3,4,7
Kilrush Town,2017,85 years and over,6,4,10
Kilrush Town,2017,Under 1 year,0,1,1
Kilrush Town,2018,1 - 4 years,0,0,0
Kilrush Town,2018,10 - 14 years,0,0,0
Kilrush Town,2018,15 - 19 years,0,0,0
Kilrush Town,2018,20 - 24 years,0,1,1
Kilrush Town,2018,25 - 29 years,0,0,0
Kilrush Town,2018,30 - 34 years,0,0,0
Kilrush Town,2018,35 - 39 years,0,0,0
Kilrush Town,2018,40 - 44 years,0,0,0
Kilrush Town,2018,45 - 49 years,1,1,2
Kilrush Town,2018,5 - 9 years,0,0,0
Kilrush Town,2018,50 - 54 years,0,0,0
Kilrush Town,2018,55 - 59 years,1,0,1
Kilrush Town,2018,60 - 64 years,1,2,3
Kilrush Town,2018,65 - 69 years,1,0,1
Kilrush Town,2018,70 - 74 years,0,4,4
Kilrush Town,2018,75 - 79 years,2,7,9
Kilrush Town,2018,80 - 84 years,6,5,11
Kilrush Town,2018,85 years and over,9,4,13
Kilrush Town,2018,Under 1 year,0,0,0
Kilrush Town,2019,1 - 4 years,0,0,0
Kilrush Town,2019,10 - 14 years,0,0,0
Kilrush Town,2019,15 - 19 years,0,0,0
Kilrush Town,2019,20 - 24 years,0,1,1
Kilrush Town,2019,25 - 29 years,0,0,0
Kilrush Town,2019,30 - 34 years,0,0,0
Kilrush Town,2019,35 - 39 years,0,0,0
Kilrush Town,2019,40 - 44 years,0,0,0
Kilrush Town,2019,45 - 49 years,1,1,2
Kilrush Town,2019,5 - 9 years,0,0,0
Kilrush Town,2019,50 - 54 years,0,0,0
Kilrush Town,2019,55 - 59 years,1,0,1
Kilrush Town,2019,60 - 64 years,1,2,3
Kilrush Town,2019,65 - 69 years,1,0,1
Kilrush Town,2019,70 - 74 years,0,4,4
Kilrush Town,2019,75 - 79 years,2,7,9
Kilrush Town,2019,80 - 84 years,6,5,11
Kilrush Town,2019,85 years and over,9,4,13
Kilrush Town,2019,Under 1 year,0,0,0
Kilrush Town,2020,1 - 4 years,0,0,0
Kilrush Town,2020,10 - 14 years,0,0,0
Kilrush Town,2020,15 - 19 years,0,0,0
Kilrush Town,2020,20 - 24 years,0,1,1
Kilrush Town,2020,25 - 29 years,0,0,0
Kilrush Town,2020,30 - 34 years,0,0,0
Kilrush Town,2020,35 - 39 years,0,0,0
Kilrush Town,2020,40 - 44 years,0,0,0
Kilrush Town,2020,45 - 49 years,1,1,2
Kilrush Town,2020,5 - 9 years,0,0,0
Kilrush Town,2020,50 - 54 years,0,0,0
Kilrush Town,2020,55 - 59 years,1,0,1
Kilrush Town,2020,60 - 64 years,1,2,3
Kilrush Town,2020,65 - 69 years,1,0,1
Kilrush Town,2020,70 - 74 years,0,4,4
Kilrush Town,2020,75 - 79 years,2,7,9
Kilrush Town,2020,80 - 84 years,6,5,11
Kilrush Town,2020,85 years and over,9,4,13
Kilrush Town,2020,Under 1 year,0,0,0
Kinsale Town,2007,1 - 4 years,0,0,0
Kinsale Town,2007,10 - 14 years,0,0,0
Kinsale Town,2007,15 - 19 years,0,0,0
Kinsale Town,2007,20 - 24 years,0,0,0
Kinsale Town,2007,25 - 29 years,0,0,0
Kinsale Town,2007,30 - 34 years,0,0,0
Kinsale Town,2007,35 - 39 years,0,1,1
Kinsale Town,2007,40 - 44 years,0,0,0
Kinsale Town,2007,45 - 49 years,0,0,0
Kinsale Town,2007,5 - 9 years,0,0,0
Kinsale Town,2007,50 - 54 years,0,0,0
Kinsale Town,2007,55 - 59 years,1,0,1
Kinsale Town,2007,60 - 64 years,1,0,1
Kinsale Town,2007,65 - 69 years,0,2,2
Kinsale Town,2007,70 - 74 years,1,3,4
Kinsale Town,2007,75 - 79 years,3,3,6
Kinsale Town,2007,80 - 84 years,2,2,4
Kinsale Town,2007,85 years and over,9,3,12
Kinsale Town,2007,Under 1 year,0,0,0
Kinsale Town,2008,1 - 4 years,0,0,0
Kinsale Town,2008,10 - 14 years,0,0,0
Kinsale Town,2008,15 - 19 years,0,1,1
Kinsale Town,2008,20 - 24 years,0,0,0
Kinsale Town,2008,25 - 29 years,0,1,1
Kinsale Town,2008,30 - 34 years,0,0,0
Kinsale Town,2008,35 - 39 years,0,1,1
Kinsale Town,2008,40 - 44 years,0,0,0
Kinsale Town,2008,45 - 49 years,0,0,0
Kinsale Town,2008,5 - 9 years,0,0,0
Kinsale Town,2008,50 - 54 years,1,0,1
Kinsale Town,2008,55 - 59 years,1,1,2
Kinsale Town,2008,60 - 64 years,1,3,4
Kinsale Town,2008,65 - 69 years,4,3,7
Kinsale Town,2008,70 - 74 years,2,6,8
Kinsale Town,2008,75 - 79 years,1,1,2
Kinsale Town,2008,80 - 84 years,1,5,6
Kinsale Town,2008,85 years and over,9,4,13
Kinsale Town,2008,Under 1 year,0,0,0
Kinsale Town,2009,1 - 4 years,0,0,0
Kinsale Town,2009,10 - 14 years,0,0,0
Kinsale Town,2009,15 - 19 years,0,1,1
Kinsale Town,2009,20 - 24 years,0,0,0
Kinsale Town,2009,25 - 29 years,0,1,1
Kinsale Town,2009,30 - 34 years,0,0,0
Kinsale Town,2009,35 - 39 years,0,1,1
Kinsale Town,2009,40 - 44 years,1,0,1
Kinsale Town,2009,45 - 49 years,1,0,1
Kinsale Town,2009,5 - 9 years,0,0,0
Kinsale Town,2009,50 - 54 years,1,0,1
Kinsale Town,2009,55 - 59 years,1,1,2
Kinsale Town,2009,60 - 64 years,1,3,4
Kinsale Town,2009,65 - 69 years,4,1,5
Kinsale Town,2009,70 - 74 years,2,6,8
Kinsale Town,2009,75 - 79 years,1,3,4
Kinsale Town,2009,80 - 84 years,4,2,6
Kinsale Town,2009,85 years and over,4,2,6
Kinsale Town,2009,Under 1 year,0,0,0
Kinsale Town,2010,1 - 4 years,0,0,0
Kinsale Town,2010,10 - 14 years,0,0,0
Kinsale Town,2010,15 - 19 years,0,1,1
Kinsale Town,2010,20 - 24 years,0,0,0
Kinsale Town,2010,25 - 29 years,1,1,2
Kinsale Town,2010,30 - 34 years,0,0,0
Kinsale Town,2010,35 - 39 years,0,1,1
Kinsale Town,2010,40 - 44 years,1,0,1
Kinsale Town,2010,45 - 49 years,1,0,1
Kinsale Town,2010,5 - 9 years,0,0,0
Kinsale Town,2010,50 - 54 years,1,0,1
Kinsale Town,2010,55 - 59 years,1,2,3
Kinsale Town,2010,60 - 64 years,1,1,2
Kinsale Town,2010,65 - 69 years,4,1,5
Kinsale Town,2010,70 - 74 years,2,6,8
Kinsale Town,2010,75 - 79 years,1,2,3
Kinsale Town,2010,80 - 84 years,2,1,3
Kinsale Town,2010,85 years and over,4,1,5
Kinsale Town,2010,Under 1 year,0,0,0
Kinsale Town,2011,1 - 4 years,0,0,0
Kinsale Town,2011,10 - 14 years,0,0,0
Kinsale Town,2011,15 - 19 years,0,0,0
Kinsale Town,2011,20 - 24 years,0,1,1
Kinsale Town,2011,25 - 29 years,0,0,0
Kinsale Town,2011,30 - 34 years,1,0,1
Kinsale Town,2011,35 - 39 years,0,0,0
Kinsale Town,2011,40 - 44 years,0,0,0
Kinsale Town,2011,45 - 49 years,1,1,2
Kinsale Town,2011,5 - 9 years,0,0,0
Kinsale Town,2011,50 - 54 years,0,0,0
Kinsale Town,2011,55 - 59 years,1,0,1
Kinsale Town,2011,60 - 64 years,0,1,1
Kinsale Town,2011,65 - 69 years,1,1,2
Kinsale Town,2011,70 - 74 years,0,4,4
Kinsale Town,2011,75 - 79 years,3,2,5
Kinsale Town,2011,80 - 84 years,2,1,3
Kinsale Town,2011,85 years and over,5,2,7
Kinsale Town,2011,Under 1 year,0,0,0
Kinsale Town,2012,1 - 4 years,0,0,0
Kinsale Town,2012,10 - 14 years,0,0,0
Kinsale Town,2012,15 - 19 years,0,0,0
Kinsale Town,2012,20 - 24 years,0,1,1
Kinsale Town,2012,25 - 29 years,0,0,0
Kinsale Town,2012,30 - 34 years,1,0,1
Kinsale Town,2012,35 - 39 years,0,0,0
Kinsale Town,2012,40 - 44 years,0,0,0
Kinsale Town,2012,45 - 49 years,1,1,2
Kinsale Town,2012,5 - 9 years,0,0,0
Kinsale Town,2012,50 - 54 years,0,0,0
Kinsale Town,2012,55 - 59 years,1,2,3
Kinsale Town,2012,60 - 64 years,0,1,1
Kinsale Town,2012,65 - 69 years,1,3,4
Kinsale Town,2012,70 - 74 years,1,2,3
Kinsale Town,2012,75 - 79 years,3,2,5
Kinsale Town,2012,80 - 84 years,8,4,12
Kinsale Town,2012,85 years and over,9,4,13
Kinsale Town,2012,Under 1 year,0,1,1
Kinsale Town,2013,1 - 4 years,0,0,0
Kinsale Town,2013,10 - 14 years,0,0,0
Kinsale Town,2013,15 - 19 years,0,0,0
Kinsale Town,2013,20 - 24 years,0,0,0
Kinsale Town,2013,25 - 29 years,0,0,0
Kinsale Town,2013,30 - 34 years,0,0,0
Kinsale Town,2013,35 - 39 years,0,0,0
Kinsale Town,2013,40 - 44 years,0,1,1
Kinsale Town,2013,45 - 49 years,0,0,0
Kinsale Town,2013,5 - 9 years,0,0,0
Kinsale Town,2013,50 - 54 years,0,0,0
Kinsale Town,2013,55 - 59 years,0,1,1
Kinsale Town,2013,60 - 64 years,0,1,1
Kinsale Town,2013,65 - 69 years,2,4,6
Kinsale Town,2013,70 - 74 years,1,4,5
Kinsale Town,2013,75 - 79 years,1,1,2
Kinsale Town,2013,80 - 84 years,1,4,5
Kinsale Town,2013,85 years and over,9,1,10
Kinsale Town,2013,Under 1 year,0,0,0
Kinsale Town,2014,1 - 4 years,0,0,0
Kinsale Town,2014,10 - 14 years,0,0,0
Kinsale Town,2014,15 - 19 years,0,0,0
Kinsale Town,2014,20 - 24 years,0,0,0
Kinsale Town,2014,25 - 29 years,0,0,0
Kinsale Town,2014,30 - 34 years,0,0,0
Kinsale Town,2014,35 - 39 years,0,0,0
Kinsale Town,2014,40 - 44 years,0,1,1
Kinsale Town,2014,45 - 49 years,0,0,0
Kinsale Town,2014,5 - 9 years,0,0,0
Kinsale Town,2014,50 - 54 years,0,0,0
Kinsale Town,2014,55 - 59 years,0,1,1
Kinsale Town,2014,60 - 64 years,2,1,3
Kinsale Town,2014,65 - 69 years,3,4,7
Kinsale Town,2014,70 - 74 years,1,3,4
Kinsale Town,2014,75 - 79 years,1,3,4
Kinsale Town,2014,80 - 84 years,2,3,5
Kinsale Town,2014,85 years and over,5,1,6
Kinsale Town,2014,Under 1 year,0,0,0
Kinsale Town,2015,1 - 4 years,0,0,0
Kinsale Town,2015,10 - 14 years,0,0,0
Kinsale Town,2015,15 - 19 years,0,0,0
Kinsale Town,2015,20 - 24 years,0,0,0
Kinsale Town,2015,25 - 29 years,0,0,0
Kinsale Town,2015,30 - 34 years,0,0,0
Kinsale Town,2015,35 - 39 years,0,0,0
Kinsale Town,2015,40 - 44 years,0,1,1
Kinsale Town,2015,45 - 49 years,0,0,0
Kinsale Town,2015,5 - 9 years,0,0,0
Kinsale Town,2015,50 - 54 years,0,0,0
Kinsale Town,2015,55 - 59 years,0,1,1
Kinsale Town,2015,60 - 64 years,2,1,3
Kinsale Town,2015,65 - 69 years,3,4,7
Kinsale Town,2015,70 - 74 years,1,3,4
Kinsale Town,2015,75 - 79 years,1,3,4
Kinsale Town,2015,80 - 84 years,2,3,5
Kinsale Town,2015,85 years and over,5,1,6
Kinsale Town,2015,Under 1 year,0,0,0
Kinsale Town,2016,1 - 4 years,0,0,0
Kinsale Town,2016,10 - 14 years,0,0,0
Kinsale Town,2016,15 - 19 years,0,0,0
Kinsale Town,2016,20 - 24 years,0,0,0
Kinsale Town,2016,25 - 29 years,0,0,0
Kinsale Town,2016,30 - 34 years,0,0,0
Kinsale Town,2016,35 - 39 years,0,0,0
Kinsale Town,2016,40 - 44 years,0,1,1
Kinsale Town,2016,45 - 49 years,0,0,0
Kinsale Town,2016,5 - 9 years,0,0,0
Kinsale Town,2016,50 - 54 years,0,0,0
Kinsale Town,2016,55 - 59 years,0,1,1
Kinsale Town,2016,60 - 64 years,2,1,3
Kinsale Town,2016,65 - 69 years,3,4,7
Kinsale Town,2016,70 - 74 years,1,3,4
Kinsale Town,2016,75 - 79 years,1,3,4
Kinsale Town,2016,80 - 84 years,2,3,5
Kinsale Town,2016,85 years and over,5,1,6
Kinsale Town,2016,Under 1 year,0,0,0
Kinsale Town,2017,1 - 4 years,0,0,0
Kinsale Town,2017,10 - 14 years,0,0,0
Kinsale Town,2017,15 - 19 years,0,0,0
Kinsale Town,2017,20 - 24 years,0,0,0
Kinsale Town,2017,25 - 29 years,0,0,0
Kinsale Town,2017,30 - 34 years,0,1,1
Kinsale Town,2017,35 - 39 years,0,0,0
Kinsale Town,2017,40 - 44 years,2,1,3
Kinsale Town,2017,45 - 49 years,0,0,0
Kinsale Town,2017,5 - 9 years,0,0,0
Kinsale Town,2017,50 - 54 years,0,0,0
Kinsale Town,2017,55 - 59 years,1,1,2
Kinsale Town,2017,60 - 64 years,2,1,3
Kinsale Town,2017,65 - 69 years,1,1,2
Kinsale Town,2017,70 - 74 years,1,3,4
Kinsale Town,2017,75 - 79 years,1,2,3
Kinsale Town,2017,80 - 84 years,4,2,6
Kinsale Town,2017,85 years and over,5,8,13
Kinsale Town,2017,Under 1 year,0,0,0
Kinsale Town,2018,1 - 4 years,0,0,0
Kinsale Town,2018,10 - 14 years,0,0,0
Kinsale Town,2018,15 - 19 years,0,0,0
Kinsale Town,2018,20 - 24 years,0,0,0
Kinsale Town,2018,25 - 29 years,0,0,0
Kinsale Town,2018,30 - 34 years,0,0,0
Kinsale Town,2018,35 - 39 years,1,0,1
Kinsale Town,2018,40 - 44 years,1,1,2
Kinsale Town,2018,45 - 49 years,0,1,1
Kinsale Town,2018,5 - 9 years,0,0,0
Kinsale Town,2018,50 - 54 years,0,1,1
Kinsale Town,2018,55 - 59 years,0,0,0
Kinsale Town,2018,60 - 64 years,0,2,2
Kinsale Town,2018,65 - 69 years,2,2,4
Kinsale Town,2018,70 - 74 years,0,1,1
Kinsale Town,2018,75 - 79 years,0,1,1
Kinsale Town,2018,80 - 84 years,1,3,4
Kinsale Town,2018,85 years and over,8,6,14
Kinsale Town,2018,Under 1 year,0,0,0
Kinsale Town,2019,1 - 4 years,0,0,0
Kinsale Town,2019,10 - 14 years,0,0,0
Kinsale Town,2019,15 - 19 years,0,0,0
Kinsale Town,2019,20 - 24 years,0,0,0
Kinsale Town,2019,25 - 29 years,0,0,0
Kinsale Town,2019,30 - 34 years,0,0,0
Kinsale Town,2019,35 - 39 years,1,0,1
Kinsale Town,2019,40 - 44 years,1,1,2
Kinsale Town,2019,45 - 49 years,0,1,1
Kinsale Town,2019,5 - 9 years,0,0,0
Kinsale Town,2019,50 - 54 years,0,1,1
Kinsale Town,2019,55 - 59 years,0,0,0
Kinsale Town,2019,60 - 64 years,0,2,2
Kinsale Town,2019,65 - 69 years,2,2,4
Kinsale Town,2019,70 - 74 years,0,1,1
Kinsale Town,2019,75 - 79 years,0,1,1
Kinsale Town,2019,80 - 84 years,1,3,4
Kinsale Town,2019,85 years and over,8,6,14
Kinsale Town,2019,Under 1 year,0,0,0
Kinsale Town,2020,1 - 4 years,0,0,0
Kinsale Town,2020,10 - 14 years,0,0,0
Kinsale Town,2020,15 - 19 years,0,0,0
Kinsale Town,2020,20 - 24 years,0,0,0
Kinsale Town,2020,25 - 29 years,0,0,0
Kinsale Town,2020,30 - 34 years,0,0,0
Kinsale Town,2020,35 - 39 years,1,0,1
Kinsale Town,2020,40 - 44 years,1,1,2
Kinsale Town,2020,45 - 49 years,0,1,1
Kinsale Town,2020,5 - 9 years,0,0,0
Kinsale Town,2020,50 - 54 years,0,1,1
Kinsale Town,2020,55 - 59 years,0,0,0
Kinsale Town,2020,60 - 64 years,0,2,2
Kinsale Town,2020,65 - 69 years,2,2,4
Kinsale Town,2020,70 - 74 years,0,1,1
Kinsale Town,2020,75 - 79 years,0,1,1
Kinsale Town,2020,80 - 84 years,1,3,4
Kinsale Town,2020,85 years and over,8,6,14
Kinsale Town,2020,Under 1 year,0,0,0
Laois,2007,1 - 4 years,0,0,0
Laois,2007,10 - 14 years,1,1,2
Laois,2007,15 - 19 years,0,1,1
Laois,2007,20 - 24 years,0,1,1
Laois,2007,25 - 29 years,0,2,2
Laois,2007,30 - 34 years,2,2,4
Laois,2007,35 - 39 years,4,1,5
Laois,2007,40 - 44 years,2,6,8
Laois,2007,45 - 49 years,6,2,8
Laois,2007,5 - 9 years,0,0,0
Laois,2007,50 - 54 years,6,6,12
Laois,2007,55 - 59 years,5,15,20
Laois,2007,60 - 64 years,6,13,19
Laois,2007,65 - 69 years,7,22,29
Laois,2007,70 - 74 years,10,18,28
Laois,2007,75 - 79 years,27,33,60
Laois,2007,80 - 84 years,31,39,70
Laois,2007,85 years and over,77,57,134
Laois,2007,Under 1 year,0,4,4
Laois,2008,1 - 4 years,1,0,1
Laois,2008,10 - 14 years,1,1,2
Laois,2008,15 - 19 years,0,1,1
Laois,2008,20 - 24 years,1,2,3
Laois,2008,25 - 29 years,1,2,3
Laois,2008,30 - 34 years,1,1,2
Laois,2008,35 - 39 years,4,3,7
Laois,2008,40 - 44 years,1,2,3
Laois,2008,45 - 49 years,7,1,8
Laois,2008,5 - 9 years,0,0,0
Laois,2008,50 - 54 years,3,5,8
Laois,2008,55 - 59 years,4,9,13
Laois,2008,60 - 64 years,9,10,19
Laois,2008,65 - 69 years,8,14,22
Laois,2008,70 - 74 years,19,27,46
Laois,2008,75 - 79 years,28,28,56
Laois,2008,80 - 84 years,38,33,71
Laois,2008,85 years and over,70,41,111
Laois,2008,Under 1 year,3,5,8
Laois,2009,1 - 4 years,1,1,2
Laois,2009,10 - 14 years,1,1,2
Laois,2009,15 - 19 years,0,1,1
Laois,2009,20 - 24 years,1,1,2
Laois,2009,25 - 29 years,1,1,2
Laois,2009,30 - 34 years,1,1,2
Laois,2009,35 - 39 years,4,7,11
Laois,2009,40 - 44 years,1,3,4
Laois,2009,45 - 49 years,7,3,10
Laois,2009,5 - 9 years,0,0,0
Laois,2009,50 - 54 years,9,11,20
Laois,2009,55 - 59 years,8,8,16
Laois,2009,60 - 64 years,9,14,23
Laois,2009,65 - 69 years,11,22,33
Laois,2009,70 - 74 years,13,18,31
Laois,2009,75 - 79 years,27,32,59
Laois,2009,80 - 84 years,34,40,74
Laois,2009,85 years and over,83,45,128
Laois,2009,Under 1 year,1,4,5
Laois,2010,1 - 4 years,1,1,2
Laois,2010,10 - 14 years,1,1,2
Laois,2010,15 - 19 years,0,2,2
Laois,2010,20 - 24 years,1,4,5
Laois,2010,25 - 29 years,1,8,9
Laois,2010,30 - 34 years,1,8,9
Laois,2010,35 - 39 years,4,7,11
Laois,2010,40 - 44 years,1,2,3
Laois,2010,45 - 49 years,3,5,8
Laois,2010,5 - 9 years,0,1,1
Laois,2010,50 - 54 years,3,11,14
Laois,2010,55 - 59 years,7,10,17
Laois,2010,60 - 64 years,9,14,23
Laois,2010,65 - 69 years,7,18,25
Laois,2010,70 - 74 years,14,20,34
Laois,2010,75 - 79 years,28,20,48
Laois,2010,80 - 84 years,39,48,87
Laois,2010,85 years and over,90,52,142
Laois,2010,Under 1 year,1,1,2
Laois,2011,1 - 4 years,1,0,1
Laois,2011,10 - 14 years,0,0,0
Laois,2011,15 - 19 years,0,0,0
Laois,2011,20 - 24 years,0,3,3
Laois,2011,25 - 29 years,1,3,4
Laois,2011,30 - 34 years,1,1,2
Laois,2011,35 - 39 years,3,1,4
Laois,2011,40 - 44 years,6,3,9
Laois,2011,45 - 49 years,2,8,10
Laois,2011,5 - 9 years,0,0,0
Laois,2011,50 - 54 years,4,9,13
Laois,2011,55 - 59 years,7,11,18
Laois,2011,60 - 64 years,11,12,23
Laois,2011,65 - 69 years,7,17,24
Laois,2011,70 - 74 years,23,23,46
Laois,2011,75 - 79 years,20,40,60
Laois,2011,80 - 84 years,46,32,78
Laois,2011,85 years and over,72,55,127
Laois,2011,Under 1 year,1,3,4
Laois,2012,1 - 4 years,1,1,2
Laois,2012,10 - 14 years,0,1,1
Laois,2012,15 - 19 years,0,3,3
Laois,2012,20 - 24 years,1,1,2
Laois,2012,25 - 29 years,1,2,3
Laois,2012,30 - 34 years,1,3,4
Laois,2012,35 - 39 years,1,5,6
Laois,2012,40 - 44 years,2,2,4
Laois,2012,45 - 49 years,1,3,4
Laois,2012,5 - 9 years,0,1,1
Laois,2012,50 - 54 years,5,12,17
Laois,2012,55 - 59 years,8,15,23
Laois,2012,60 - 64 years,9,22,31
Laois,2012,65 - 69 years,9,22,31
Laois,2012,70 - 74 years,20,22,42
Laois,2012,75 - 79 years,33,37,70
Laois,2012,80 - 84 years,33,39,72
Laois,2012,85 years and over,80,66,146
Laois,2012,Under 1 year,2,3,5
Laois,2013,1 - 4 years,2,0,2
Laois,2013,10 - 14 years,0,0,0
Laois,2013,15 - 19 years,0,0,0
Laois,2013,20 - 24 years,1,2,3
Laois,2013,25 - 29 years,0,3,3
Laois,2013,30 - 34 years,1,2,3
Laois,2013,35 - 39 years,1,2,3
Laois,2013,40 - 44 years,2,4,6
Laois,2013,45 - 49 years,0,2,2
Laois,2013,5 - 9 years,1,0,1
Laois,2013,50 - 54 years,11,8,19
Laois,2013,55 - 59 years,7,6,13
Laois,2013,60 - 64 years,14,13,27
Laois,2013,65 - 69 years,11,15,26
Laois,2013,70 - 74 years,15,23,38
Laois,2013,75 - 79 years,28,28,56
Laois,2013,80 - 84 years,29,49,78
Laois,2013,85 years and over,88,70,158
Laois,2013,Under 1 year,1,4,5
Laois,2014,1 - 4 years,2,0,2
Laois,2014,10 - 14 years,0,0,0
Laois,2014,15 - 19 years,0,1,1
Laois,2014,20 - 24 years,1,1,2
Laois,2014,25 - 29 years,2,2,4
Laois,2014,30 - 34 years,1,4,5
Laois,2014,35 - 39 years,1,2,3
Laois,2014,40 - 44 years,1,1,2
Laois,2014,45 - 49 years,1,6,7
Laois,2014,5 - 9 years,1,0,1
Laois,2014,50 - 54 years,4,9,13
Laois,2014,55 - 59 years,7,3,10
Laois,2014,60 - 64 years,13,11,24
Laois,2014,65 - 69 years,17,21,38
Laois,2014,70 - 74 years,12,29,41
Laois,2014,75 - 79 years,27,35,62
Laois,2014,80 - 84 years,29,33,62
Laois,2014,85 years and over,87,58,145
Laois,2014,Under 1 year,4,2,6
Laois,2015,1 - 4 years,2,0,2
Laois,2015,10 - 14 years,0,1,1
Laois,2015,15 - 19 years,0,5,5
Laois,2015,20 - 24 years,2,2,4
Laois,2015,25 - 29 years,2,2,4
Laois,2015,30 - 34 years,1,3,4
Laois,2015,35 - 39 years,3,3,6
Laois,2015,40 - 44 years,4,2,6
Laois,2015,45 - 49 years,5,5,10
Laois,2015,5 - 9 years,1,0,1
Laois,2015,50 - 54 years,6,6,12
Laois,2015,55 - 59 years,9,15,24
Laois,2015,60 - 64 years,8,13,21
Laois,2015,65 - 69 years,12,16,28
Laois,2015,70 - 74 years,18,24,42
Laois,2015,75 - 79 years,28,35,63
Laois,2015,80 - 84 years,43,32,75
Laois,2015,85 years and over,99,60,159
Laois,2015,Under 1 year,1,3,4
Laois,2016,1 - 4 years,1,1,2
Laois,2016,10 - 14 years,0,1,1
Laois,2016,15 - 19 years,0,1,1
Laois,2016,20 - 24 years,1,1,2
Laois,2016,25 - 29 years,2,3,5
Laois,2016,30 - 34 years,2,1,3
Laois,2016,35 - 39 years,3,1,4
Laois,2016,40 - 44 years,2,5,7
Laois,2016,45 - 49 years,3,6,9
Laois,2016,5 - 9 years,1,0,1
Laois,2016,50 - 54 years,5,7,12
Laois,2016,55 - 59 years,8,11,19
Laois,2016,60 - 64 years,6,15,21
Laois,2016,65 - 69 years,15,28,43
Laois,2016,70 - 74 years,14,25,39
Laois,2016,75 - 79 years,31,43,74
Laois,2016,80 - 84 years,32,36,68
Laois,2016,85 years and over,100,71,171
Laois,2016,Under 1 year,1,2,3
Laois,2017,1 - 4 years,1,1,2
Laois,2017,10 - 14 years,0,1,1
Laois,2017,15 - 19 years,0,1,1
Laois,2017,20 - 24 years,1,3,4
Laois,2017,25 - 29 years,1,3,4
Laois,2017,30 - 34 years,1,5,6
Laois,2017,35 - 39 years,2,1,3
Laois,2017,40 - 44 years,2,5,7
Laois,2017,45 - 49 years,2,7,9
Laois,2017,5 - 9 years,1,0,1
Laois,2017,50 - 54 years,2,7,9
Laois,2017,55 - 59 years,13,5,18
Laois,2017,60 - 64 years,13,11,24
Laois,2017,65 - 69 years,16,19,35
Laois,2017,70 - 74 years,15,23,38
Laois,2017,75 - 79 years,26,34,60
Laois,2017,80 - 84 years,36,56,92
Laois,2017,85 years and over,87,73,160
Laois,2017,Under 1 year,1,2,3
Laois,2018,1 - 4 years,0,0,0
Laois,2018,10 - 14 years,0,0,0
Laois,2018,15 - 19 years,1,1,2
Laois,2018,20 - 24 years,1,2,3
Laois,2018,25 - 29 years,0,2,2
Laois,2018,30 - 34 years,0,2,2
Laois,2018,35 - 39 years,2,2,4
Laois,2018,40 - 44 years,2,2,4
Laois,2018,45 - 49 years,6,5,11
Laois,2018,5 - 9 years,0,0,0
Laois,2018,50 - 54 years,3,11,14
Laois,2018,55 - 59 years,8,12,20
Laois,2018,60 - 64 years,10,13,23
Laois,2018,65 - 69 years,7,21,28
Laois,2018,70 - 74 years,22,27,49
Laois,2018,75 - 79 years,12,30,42
Laois,2018,80 - 84 years,38,36,74
Laois,2018,85 years and over,94,71,165
Laois,2018,Under 1 year,0,1,1
Laois,2019,1 - 4 years,0,0,0
Laois,2019,10 - 14 years,0,0,0
Laois,2019,15 - 19 years,0,1,1
Laois,2019,20 - 24 years,0,2,2
Laois,2019,25 - 29 years,0,3,3
Laois,2019,30 - 34 years,2,3,5
Laois,2019,35 - 39 years,1,3,4
Laois,2019,40 - 44 years,0,4,4
Laois,2019,45 - 49 years,5,2,7
Laois,2019,5 - 9 years,0,1,1
Laois,2019,50 - 54 years,3,9,12
Laois,2019,55 - 59 years,8,10,18
Laois,2019,60 - 64 years,9,11,20
Laois,2019,65 - 69 years,14,28,42
Laois,2019,70 - 74 years,15,34,49
Laois,2019,75 - 79 years,29,37,66
Laois,2019,80 - 84 years,30,42,72
Laois,2019,85 years and over,86,77,163
Laois,2019,Under 1 year,1,1,2
Laois,2020,1 - 4 years,0,1,1
Laois,2020,10 - 14 years,0,1,1
Laois,2020,15 - 19 years,0,2,2
Laois,2020,20 - 24 years,0,2,2
Laois,2020,25 - 29 years,0,3,3
Laois,2020,30 - 34 years,2,1,3
Laois,2020,35 - 39 years,2,2,4
Laois,2020,40 - 44 years,0,1,1
Laois,2020,45 - 49 years,5,2,7
Laois,2020,5 - 9 years,0,1,1
Laois,2020,50 - 54 years,4,9,13
Laois,2020,55 - 59 years,7,9,16
Laois,2020,60 - 64 years,15,19,34
Laois,2020,65 - 69 years,10,25,35
Laois,2020,70 - 74 years,19,30,49
Laois,2020,75 - 79 years,19,38,57
Laois,2020,80 - 84 years,38,34,72
Laois,2020,85 years and over,83,84,167
Laois,2020,Under 1 year,1,1,2
Leinster,2007,1 - 4 years,13,13,26
Leinster,2007,10 - 14 years,9,17,26
Leinster,2007,15 - 19 years,21,49,70
Leinster,2007,20 - 24 years,21,54,75
Leinster,2007,25 - 29 years,20,74,94
Leinster,2007,30 - 34 years,35,59,94
Leinster,2007,35 - 39 years,40,71,111
Leinster,2007,40 - 44 years,58,95,153
Leinster,2007,45 - 49 years,89,139,228
Leinster,2007,5 - 9 years,3,1,4
Leinster,2007,50 - 54 years,130,172,302
Leinster,2007,55 - 59 years,157,292,449
Leinster,2007,60 - 64 years,215,402,617
Leinster,2007,65 - 69 years,264,451,715
Leinster,2007,70 - 74 years,403,524,927
Leinster,2007,75 - 79 years,599,690,1289
Leinster,2007,80 - 84 years,839,726,1565
Leinster,2007,85 years and over,1642,909,2551
Leinster,2007,Under 1 year,43,67,110
Leinster,2008,1 - 4 years,16,13,29
Leinster,2008,10 - 14 years,4,13,17
Leinster,2008,15 - 19 years,21,48,69
Leinster,2008,20 - 24 years,22,76,98
Leinster,2008,25 - 29 years,35,105,140
Leinster,2008,30 - 34 years,34,102,136
Leinster,2008,35 - 39 years,62,114,176
Leinster,2008,40 - 44 years,87,153,240
Leinster,2008,45 - 49 years,156,193,349
Leinster,2008,5 - 9 years,5,11,16
Leinster,2008,50 - 54 years,196,252,448
Leinster,2008,55 - 59 years,261,400,661
Leinster,2008,60 - 64 years,333,528,861
Leinster,2008,65 - 69 years,391,651,1042
Leinster,2008,70 - 74 years,568,843,1411
Leinster,2008,75 - 79 years,867,1038,1905
Leinster,2008,80 - 84 years,1286,1108,2394
Leinster,2008,85 years and over,2552,1247,3799
Leinster,2008,Under 1 year,72,80,152
Leinster,2009,1 - 4 years,13,16,29
Leinster,2009,10 - 14 years,9,8,17
Leinster,2009,15 - 19 years,11,44,55
Leinster,2009,20 - 24 years,22,74,96
Leinster,2009,25 - 29 years,32,104,136
Leinster,2009,30 - 34 years,55,103,158
Leinster,2009,35 - 39 years,60,132,192
Leinster,2009,40 - 44 years,77,161,238
Leinster,2009,45 - 49 years,142,196,338
Leinster,2009,5 - 9 years,9,4,13
Leinster,2009,50 - 54 years,191,278,469
Leinster,2009,55 - 59 years,256,381,637
Leinster,2009,60 - 64 years,361,533,894
Leinster,2009,65 - 69 years,393,685,1078
Leinster,2009,70 - 74 years,589,792,1381
Leinster,2009,75 - 79 years,907,994,1901
Leinster,2009,80 - 84 years,1230,1179,2409
Leinster,2009,85 years and over,2596,1390,3986
Leinster,2009,Under 1 year,53,77,130
Leinster,2010,1 - 4 years,8,15,23
Leinster,2010,10 - 14 years,6,11,17
Leinster,2010,15 - 19 years,9,32,41
Leinster,2010,20 - 24 years,17,78,95
Leinster,2010,25 - 29 years,29,78,107
Leinster,2010,30 - 34 years,42,104,146
Leinster,2010,35 - 39 years,53,113,166
Leinster,2010,40 - 44 years,85,146,231
Leinster,2010,45 - 49 years,123,202,325
Leinster,2010,5 - 9 years,5,9,14
Leinster,2010,50 - 54 years,182,258,440
Leinster,2010,55 - 59 years,227,349,576
Leinster,2010,60 - 64 years,334,521,855
Leinster,2010,65 - 69 years,438,681,1119
Leinster,2010,70 - 74 years,568,774,1342
Leinster,2010,75 - 79 years,835,980,1815
Leinster,2010,80 - 84 years,1156,1150,2306
Leinster,2010,85 years and over,2726,1397,4123
Leinster,2010,Under 1 year,59,79,138
Leinster,2011,1 - 4 years,9,8,17
Leinster,2011,10 - 14 years,7,7,14
Leinster,2011,15 - 19 years,16,35,51
Leinster,2011,20 - 24 years,12,78,90
Leinster,2011,25 - 29 years,33,79,112
Leinster,2011,30 - 34 years,48,108,156
Leinster,2011,35 - 39 years,67,125,192
Leinster,2011,40 - 44 years,95,170,265
Leinster,2011,45 - 49 years,133,211,344
Leinster,2011,5 - 9 years,3,6,9
Leinster,2011,50 - 54 years,159,253,412
Leinster,2011,55 - 59 years,253,358,611
Leinster,2011,60 - 64 years,365,514,879
Leinster,2011,65 - 69 years,452,702,1154
Leinster,2011,70 - 74 years,573,807,1380
Leinster,2011,75 - 79 years,859,1032,1891
Leinster,2011,80 - 84 years,1173,1094,2267
Leinster,2011,85 years and over,2824,1429,4253
Leinster,2011,Under 1 year,53,81,134
Leinster,2012,1 - 4 years,9,17,26
Leinster,2012,10 - 14 years,6,8,14
Leinster,2012,15 - 19 years,11,27,38
Leinster,2012,20 - 24 years,18,45,63
Leinster,2012,25 - 29 years,27,74,101
Leinster,2012,30 - 34 years,50,103,153
Leinster,2012,35 - 39 years,63,125,188
Leinster,2012,40 - 44 years,91,149,240
Leinster,2012,45 - 49 years,116,200,316
Leinster,2012,5 - 9 years,6,7,13
Leinster,2012,50 - 54 years,192,293,485
Leinster,2012,55 - 59 years,275,379,654
Leinster,2012,60 - 64 years,363,567,930
Leinster,2012,65 - 69 years,472,689,1161
Leinster,2012,70 - 74 years,571,821,1392
Leinster,2012,75 - 79 years,851,1051,1902
Leinster,2012,80 - 84 years,1194,1156,2350
Leinster,2012,85 years and over,2928,1610,4538
Leinster,2012,Under 1 year,56,67,123
Leinster,2013,1 - 4 years,12,14,26
Leinster,2013,10 - 14 years,2,6,8
Leinster,2013,15 - 19 years,11,17,28
Leinster,2013,20 - 24 years,23,46,69
Leinster,2013,25 - 29 years,27,61,88
Leinster,2013,30 - 34 years,45,104,149
Leinster,2013,35 - 39 years,49,99,148
Leinster,2013,40 - 44 years,74,151,225
Leinster,2013,45 - 49 years,101,199,300
Leinster,2013,5 - 9 years,12,7,19
Leinster,2013,50 - 54 years,205,278,483
Leinster,2013,55 - 59 years,272,377,649
Leinster,2013,60 - 64 years,330,537,867
Leinster,2013,65 - 69 years,480,656,1136
Leinster,2013,70 - 74 years,576,847,1423
Leinster,2013,75 - 79 years,853,1005,1858
Leinster,2013,80 - 84 years,1245,1184,2429
Leinster,2013,85 years and over,3043,1622,4665
Leinster,2013,Under 1 year,55,74,129
Leinster,2014,1 - 4 years,9,8,17
Leinster,2014,10 - 14 years,3,9,12
Leinster,2014,15 - 19 years,10,15,25
Leinster,2014,20 - 24 years,14,62,76
Leinster,2014,25 - 29 years,28,65,93
Leinster,2014,30 - 34 years,41,83,124
Leinster,2014,35 - 39 years,45,96,141
Leinster,2014,40 - 44 years,82,141,223
Leinster,2014,45 - 49 years,98,183,281
Leinster,2014,5 - 9 years,8,5,13
Leinster,2014,50 - 54 years,168,264,432
Leinster,2014,55 - 59 years,260,340,600
Leinster,2014,60 - 64 years,336,510,846
Leinster,2014,65 - 69 years,503,665,1168
Leinster,2014,70 - 74 years,608,827,1435
Leinster,2014,75 - 79 years,846,1020,1866
Leinster,2014,80 - 84 years,1171,1175,2346
Leinster,2014,85 years and over,3064,1696,4760
Leinster,2014,Under 1 year,45,67,112
Leinster,2015,1 - 4 years,10,6,16
Leinster,2015,10 - 14 years,3,9,12
Leinster,2015,15 - 19 years,8,34,42
Leinster,2015,20 - 24 years,16,36,52
Leinster,2015,25 - 29 years,20,59,79
Leinster,2015,30 - 34 years,39,63,102
Leinster,2015,35 - 39 years,56,99,155
Leinster,2015,40 - 44 years,75,120,195
Leinster,2015,45 - 49 years,111,186,297
Leinster,2015,5 - 9 years,5,6,11
Leinster,2015,50 - 54 years,187,248,435
Leinster,2015,55 - 59 years,263,347,610
Leinster,2015,60 - 64 years,334,495,829
Leinster,2015,65 - 69 years,476,666,1142
Leinster,2015,70 - 74 years,666,872,1538
Leinster,2015,75 - 79 years,879,1133,2012
Leinster,2015,80 - 84 years,1220,1185,2405
Leinster,2015,85 years and over,3272,1872,5144
Leinster,2015,Under 1 year,57,63,120
Leinster,2016,1 - 4 years,5,8,13
Leinster,2016,10 - 14 years,7,11,18
Leinster,2016,15 - 19 years,10,23,33
Leinster,2016,20 - 24 years,9,44,53
Leinster,2016,25 - 29 years,17,46,63
Leinster,2016,30 - 34 years,34,64,98
Leinster,2016,35 - 39 years,52,96,148
Leinster,2016,40 - 44 years,69,120,189
Leinster,2016,45 - 49 years,120,192,312
Leinster,2016,5 - 9 years,6,6,12
Leinster,2016,50 - 54 years,170,247,417
Leinster,2016,55 - 59 years,271,327,598
Leinster,2016,60 - 64 years,331,518,849
Leinster,2016,65 - 69 years,513,652,1165
Leinster,2016,70 - 74 years,675,884,1559
Leinster,2016,75 - 79 years,860,1114,1974
Leinster,2016,80 - 84 years,1126,1295,2421
Leinster,2016,85 years and over,3199,1900,5099
Leinster,2016,Under 1 year,48,62,110
Leinster,2017,1 - 4 years,9,9,18
Leinster,2017,10 - 14 years,4,6,10
Leinster,2017,15 - 19 years,6,16,22
Leinster,2017,20 - 24 years,8,35,43
Leinster,2017,25 - 29 years,23,38,61
Leinster,2017,30 - 34 years,26,63,89
Leinster,2017,35 - 39 years,47,87,134
Leinster,2017,40 - 44 years,70,132,202
Leinster,2017,45 - 49 years,103,163,266
Leinster,2017,5 - 9 years,6,5,11
Leinster,2017,50 - 54 years,166,251,417
Leinster,2017,55 - 59 years,227,386,613
Leinster,2017,60 - 64 years,355,467,822
Leinster,2017,65 - 69 years,479,734,1213
Leinster,2017,70 - 74 years,667,951,1618
Leinster,2017,75 - 79 years,899,1138,2037
Leinster,2017,80 - 84 years,1249,1315,2564
Leinster,2017,85 years and over,3261,1957,5218
Leinster,2017,Under 1 year,60,53,113
Leinster,2018,1 - 4 years,11,3,14
Leinster,2018,10 - 14 years,8,12,20
Leinster,2018,15 - 19 years,10,20,30
Leinster,2018,20 - 24 years,20,31,51
Leinster,2018,25 - 29 years,21,41,62
Leinster,2018,30 - 34 years,51,56,107
Leinster,2018,35 - 39 years,63,74,137
Leinster,2018,40 - 44 years,90,134,224
Leinster,2018,45 - 49 years,127,187,314
Leinster,2018,5 - 9 years,3,4,7
Leinster,2018,50 - 54 years,179,245,424
Leinster,2018,55 - 59 years,242,380,622
Leinster,2018,60 - 64 years,335,492,827
Leinster,2018,65 - 69 years,504,716,1220
Leinster,2018,70 - 74 years,711,962,1673
Leinster,2018,75 - 79 years,887,1133,2020
Leinster,2018,80 - 84 years,1252,1286,2538
Leinster,2018,85 years and over,3284,2086,5370
Leinster,2018,Under 1 year,42,59,101
Leinster,2019,1 - 4 years,10,8,18
Leinster,2019,10 - 14 years,1,11,12
Leinster,2019,15 - 19 years,11,22,33
Leinster,2019,20 - 24 years,10,35,45
Leinster,2019,25 - 29 years,22,47,69
Leinster,2019,30 - 34 years,40,58,98
Leinster,2019,35 - 39 years,57,88,145
Leinster,2019,40 - 44 years,85,130,215
Leinster,2019,45 - 49 years,110,182,292
Leinster,2019,5 - 9 years,5,13,18
Leinster,2019,50 - 54 years,165,256,421
Leinster,2019,55 - 59 years,243,418,661
Leinster,2019,60 - 64 years,352,544,896
Leinster,2019,65 - 69 years,471,698,1169
Leinster,2019,70 - 74 years,643,975,1618
Leinster,2019,75 - 79 years,871,1143,2014
Leinster,2019,80 - 84 years,1174,1314,2488
Leinster,2019,85 years and over,3213,2209,5422
Leinster,2019,Under 1 year,52,72,124
Leinster,2020,1 - 4 years,4,9,13
Leinster,2020,10 - 14 years,3,10,13
Leinster,2020,15 - 19 years,10,16,26
Leinster,2020,20 - 24 years,12,26,38
Leinster,2020,25 - 29 years,15,43,58
Leinster,2020,30 - 34 years,31,57,88
Leinster,2020,35 - 39 years,68,96,164
Leinster,2020,40 - 44 years,84,132,216
Leinster,2020,45 - 49 years,112,145,257
Leinster,2020,5 - 9 years,2,11,13
Leinster,2020,50 - 54 years,157,258,415
Leinster,2020,55 - 59 years,236,360,596
Leinster,2020,60 - 64 years,353,513,866
Leinster,2020,65 - 69 years,510,697,1207
Leinster,2020,70 - 74 years,735,1040,1775
Leinster,2020,75 - 79 years,880,1150,2030
Leinster,2020,80 - 84 years,1275,1438,2713
Leinster,2020,85 years and over,3471,2231,5702
Leinster,2020,Under 1 year,43,45,88
Leitrim,2007,1 - 4 years,0,0,0
Leitrim,2007,10 - 14 years,0,0,0
Leitrim,2007,15 - 19 years,0,1,1
Leitrim,2007,20 - 24 years,0,0,0
Leitrim,2007,25 - 29 years,0,1,1
Leitrim,2007,30 - 34 years,1,2,3
Leitrim,2007,35 - 39 years,1,0,1
Leitrim,2007,40 - 44 years,1,1,2
Leitrim,2007,45 - 49 years,2,2,4
Leitrim,2007,5 - 9 years,0,0,0
Leitrim,2007,50 - 54 years,0,7,7
Leitrim,2007,55 - 59 years,4,9,13
Leitrim,2007,60 - 64 years,7,7,14
Leitrim,2007,65 - 69 years,15,11,26
Leitrim,2007,70 - 74 years,5,19,24
Leitrim,2007,75 - 79 years,12,19,31
Leitrim,2007,80 - 84 years,23,25,48
Leitrim,2007,85 years and over,55,30,85
Leitrim,2007,Under 1 year,1,1,2
Leitrim,2008,1 - 4 years,0,0,0
Leitrim,2008,10 - 14 years,0,0,0
Leitrim,2008,15 - 19 years,0,1,1
Leitrim,2008,20 - 24 years,0,0,0
Leitrim,2008,25 - 29 years,1,1,2
Leitrim,2008,30 - 34 years,1,4,5
Leitrim,2008,35 - 39 years,1,1,2
Leitrim,2008,40 - 44 years,4,3,7
Leitrim,2008,45 - 49 years,1,1,2
Leitrim,2008,5 - 9 years,0,0,0
Leitrim,2008,50 - 54 years,1,2,3
Leitrim,2008,55 - 59 years,1,9,10
Leitrim,2008,60 - 64 years,10,11,21
Leitrim,2008,65 - 69 years,6,10,16
Leitrim,2008,70 - 74 years,7,8,15
Leitrim,2008,75 - 79 years,13,21,34
Leitrim,2008,80 - 84 years,21,28,49
Leitrim,2008,85 years and over,46,34,80
Leitrim,2008,Under 1 year,1,1,2
Leitrim,2009,1 - 4 years,0,1,1
Leitrim,2009,10 - 14 years,0,0,0
Leitrim,2009,15 - 19 years,0,1,1
Leitrim,2009,20 - 24 years,0,0,0
Leitrim,2009,25 - 29 years,2,2,4
Leitrim,2009,30 - 34 years,1,2,3
Leitrim,2009,35 - 39 years,1,1,2
Leitrim,2009,40 - 44 years,1,4,5
Leitrim,2009,45 - 49 years,1,2,3
Leitrim,2009,5 - 9 years,0,1,1
Leitrim,2009,50 - 54 years,5,5,10
Leitrim,2009,55 - 59 years,1,5,6
Leitrim,2009,60 - 64 years,3,9,12
Leitrim,2009,65 - 69 years,6,11,17
Leitrim,2009,70 - 74 years,11,16,27
Leitrim,2009,75 - 79 years,18,28,46
Leitrim,2009,80 - 84 years,22,26,48
Leitrim,2009,85 years and over,60,36,96
Leitrim,2009,Under 1 year,1,1,2
Leitrim,2010,1 - 4 years,0,1,1
Leitrim,2010,10 - 14 years,0,0,0
Leitrim,2010,15 - 19 years,0,1,1
Leitrim,2010,20 - 24 years,0,1,1
Leitrim,2010,25 - 29 years,1,2,3
Leitrim,2010,30 - 34 years,1,1,2
Leitrim,2010,35 - 39 years,1,4,5
Leitrim,2010,40 - 44 years,1,1,2
Leitrim,2010,45 - 49 years,2,5,7
Leitrim,2010,5 - 9 years,0,1,1
Leitrim,2010,50 - 54 years,2,3,5
Leitrim,2010,55 - 59 years,7,7,14
Leitrim,2010,60 - 64 years,7,8,15
Leitrim,2010,65 - 69 years,4,12,16
Leitrim,2010,70 - 74 years,9,21,30
Leitrim,2010,75 - 79 years,13,26,39
Leitrim,2010,80 - 84 years,15,24,39
Leitrim,2010,85 years and over,56,43,99
Leitrim,2010,Under 1 year,2,1,3
Leitrim,2011,1 - 4 years,0,0,0
Leitrim,2011,10 - 14 years,0,0,0
Leitrim,2011,15 - 19 years,0,1,1
Leitrim,2011,20 - 24 years,0,0,0
Leitrim,2011,25 - 29 years,0,1,1
Leitrim,2011,30 - 34 years,1,1,2
Leitrim,2011,35 - 39 years,1,0,1
Leitrim,2011,40 - 44 years,1,2,3
Leitrim,2011,45 - 49 years,2,5,7
Leitrim,2011,5 - 9 years,0,1,1
Leitrim,2011,50 - 54 years,3,4,7
Leitrim,2011,55 - 59 years,6,8,14
Leitrim,2011,60 - 64 years,6,14,20
Leitrim,2011,65 - 69 years,8,11,19
Leitrim,2011,70 - 74 years,9,22,31
Leitrim,2011,75 - 79 years,10,26,36
Leitrim,2011,80 - 84 years,21,24,45
Leitrim,2011,85 years and over,62,44,106
Leitrim,2011,Under 1 year,1,2,3
Leitrim,2012,1 - 4 years,0,0,0
Leitrim,2012,10 - 14 years,0,0,0
Leitrim,2012,15 - 19 years,1,1,2
Leitrim,2012,20 - 24 years,0,3,3
Leitrim,2012,25 - 29 years,1,1,2
Leitrim,2012,30 - 34 years,2,1,3
Leitrim,2012,35 - 39 years,1,1,2
Leitrim,2012,40 - 44 years,1,2,3
Leitrim,2012,45 - 49 years,2,3,5
Leitrim,2012,5 - 9 years,0,1,1
Leitrim,2012,50 - 54 years,3,7,10
Leitrim,2012,55 - 59 years,6,2,8
Leitrim,2012,60 - 64 years,4,6,10
Leitrim,2012,65 - 69 years,6,2,8
Leitrim,2012,70 - 74 years,5,14,19
Leitrim,2012,75 - 79 years,15,27,42
Leitrim,2012,80 - 84 years,14,28,42
Leitrim,2012,85 years and over,50,47,97
Leitrim,2012,Under 1 year,1,1,2
Leitrim,2013,1 - 4 years,0,0,0
Leitrim,2013,10 - 14 years,0,0,0
Leitrim,2013,15 - 19 years,0,0,0
Leitrim,2013,20 - 24 years,0,1,1
Leitrim,2013,25 - 29 years,0,3,3
Leitrim,2013,30 - 34 years,0,0,0
Leitrim,2013,35 - 39 years,0,1,1
Leitrim,2013,40 - 44 years,2,1,3
Leitrim,2013,45 - 49 years,5,4,9
Leitrim,2013,5 - 9 years,0,0,0
Leitrim,2013,50 - 54 years,3,4,7
Leitrim,2013,55 - 59 years,0,5,5
Leitrim,2013,60 - 64 years,3,9,12
Leitrim,2013,65 - 69 years,3,15,18
Leitrim,2013,70 - 74 years,8,18,26
Leitrim,2013,75 - 79 years,15,27,42
Leitrim,2013,80 - 84 years,15,25,40
Leitrim,2013,85 years and over,62,31,93
Leitrim,2013,Under 1 year,0,0,0
Leitrim,2014,1 - 4 years,0,0,0
Leitrim,2014,10 - 14 years,0,0,0
Leitrim,2014,15 - 19 years,1,0,1
Leitrim,2014,20 - 24 years,0,1,1
Leitrim,2014,25 - 29 years,0,3,3
Leitrim,2014,30 - 34 years,0,1,1
Leitrim,2014,35 - 39 years,1,1,2
Leitrim,2014,40 - 44 years,2,1,3
Leitrim,2014,45 - 49 years,5,2,7
Leitrim,2014,5 - 9 years,0,0,0
Leitrim,2014,50 - 54 years,2,5,7
Leitrim,2014,55 - 59 years,3,1,4
Leitrim,2014,60 - 64 years,2,11,13
Leitrim,2014,65 - 69 years,3,11,14
Leitrim,2014,70 - 74 years,8,18,26
Leitrim,2014,75 - 79 years,18,15,33
Leitrim,2014,80 - 84 years,19,32,51
Leitrim,2014,85 years and over,56,38,94
Leitrim,2014,Under 1 year,0,1,1
Leitrim,2015,1 - 4 years,0,0,0
Leitrim,2015,10 - 14 years,0,1,1
Leitrim,2015,15 - 19 years,1,0,1
Leitrim,2015,20 - 24 years,0,1,1
Leitrim,2015,25 - 29 years,0,1,1
Leitrim,2015,30 - 34 years,1,1,2
Leitrim,2015,35 - 39 years,1,1,2
Leitrim,2015,40 - 44 years,2,1,3
Leitrim,2015,45 - 49 years,1,3,4
Leitrim,2015,5 - 9 years,0,0,0
Leitrim,2015,50 - 54 years,3,1,4
Leitrim,2015,55 - 59 years,4,9,13
Leitrim,2015,60 - 64 years,8,9,17
Leitrim,2015,65 - 69 years,9,20,29
Leitrim,2015,70 - 74 years,6,22,28
Leitrim,2015,75 - 79 years,18,24,42
Leitrim,2015,80 - 84 years,26,25,51
Leitrim,2015,85 years and over,46,41,87
Leitrim,2015,Under 1 year,0,2,2
Leitrim,2016,1 - 4 years,0,0,0
Leitrim,2016,10 - 14 years,0,1,1
Leitrim,2016,15 - 19 years,4,1,5
Leitrim,2016,20 - 24 years,1,1,2
Leitrim,2016,25 - 29 years,0,1,1
Leitrim,2016,30 - 34 years,2,1,3
Leitrim,2016,35 - 39 years,1,1,2
Leitrim,2016,40 - 44 years,2,3,5
Leitrim,2016,45 - 49 years,1,2,3
Leitrim,2016,5 - 9 years,0,1,1
Leitrim,2016,50 - 54 years,3,6,9
Leitrim,2016,55 - 59 years,2,8,10
Leitrim,2016,60 - 64 years,5,14,19
Leitrim,2016,65 - 69 years,7,17,24
Leitrim,2016,70 - 74 years,8,18,26
Leitrim,2016,75 - 79 years,18,25,43
Leitrim,2016,80 - 84 years,18,31,49
Leitrim,2016,85 years and over,54,43,97
Leitrim,2016,Under 1 year,1,2,3
Leitrim,2017,1 - 4 years,0,0,0
Leitrim,2017,10 - 14 years,0,1,1
Leitrim,2017,15 - 19 years,4,1,5
Leitrim,2017,20 - 24 years,1,1,2
Leitrim,2017,25 - 29 years,0,1,1
Leitrim,2017,30 - 34 years,2,2,4
Leitrim,2017,35 - 39 years,1,3,4
Leitrim,2017,40 - 44 years,1,3,4
Leitrim,2017,45 - 49 years,1,2,3
Leitrim,2017,5 - 9 years,0,1,1
Leitrim,2017,50 - 54 years,3,7,10
Leitrim,2017,55 - 59 years,3,5,8
Leitrim,2017,60 - 64 years,7,7,14
Leitrim,2017,65 - 69 years,7,7,14
Leitrim,2017,70 - 74 years,5,17,22
Leitrim,2017,75 - 79 years,12,21,33
Leitrim,2017,80 - 84 years,12,27,39
Leitrim,2017,85 years and over,61,43,104
Leitrim,2017,Under 1 year,1,2,3
Leitrim,2018,1 - 4 years,0,0,0
Leitrim,2018,10 - 14 years,0,0,0
Leitrim,2018,15 - 19 years,0,0,0
Leitrim,2018,20 - 24 years,0,1,1
Leitrim,2018,25 - 29 years,0,1,1
Leitrim,2018,30 - 34 years,1,1,2
Leitrim,2018,35 - 39 years,1,3,4
Leitrim,2018,40 - 44 years,0,3,3
Leitrim,2018,45 - 49 years,1,6,7
Leitrim,2018,5 - 9 years,0,0,0
Leitrim,2018,50 - 54 years,2,2,4
Leitrim,2018,55 - 59 years,5,5,10
Leitrim,2018,60 - 64 years,5,9,14
Leitrim,2018,65 - 69 years,9,8,17
Leitrim,2018,70 - 74 years,9,16,25
Leitrim,2018,75 - 79 years,10,19,29
Leitrim,2018,80 - 84 years,15,22,37
Leitrim,2018,85 years and over,75,51,126
Leitrim,2018,Under 1 year,1,0,1
Leitrim,2019,1 - 4 years,0,0,0
Leitrim,2019,10 - 14 years,0,0,0
Leitrim,2019,15 - 19 years,0,0,0
Leitrim,2019,20 - 24 years,0,1,1
Leitrim,2019,25 - 29 years,0,0,0
Leitrim,2019,30 - 34 years,0,0,0
Leitrim,2019,35 - 39 years,0,4,4
Leitrim,2019,40 - 44 years,3,2,5
Leitrim,2019,45 - 49 years,1,2,3
Leitrim,2019,5 - 9 years,0,0,0
Leitrim,2019,50 - 54 years,4,4,8
Leitrim,2019,55 - 59 years,4,10,14
Leitrim,2019,60 - 64 years,5,11,16
Leitrim,2019,65 - 69 years,4,10,14
Leitrim,2019,70 - 74 years,10,23,33
Leitrim,2019,75 - 79 years,13,28,41
Leitrim,2019,80 - 84 years,24,23,47
Leitrim,2019,85 years and over,66,49,115
Leitrim,2019,Under 1 year,4,0,4
Leitrim,2020,1 - 4 years,0,0,0
Leitrim,2020,10 - 14 years,0,1,1
Leitrim,2020,15 - 19 years,0,0,0
Leitrim,2020,20 - 24 years,0,1,1
Leitrim,2020,25 - 29 years,0,0,0
Leitrim,2020,30 - 34 years,1,0,1
Leitrim,2020,35 - 39 years,1,2,3
Leitrim,2020,40 - 44 years,1,2,3
Leitrim,2020,45 - 49 years,1,1,2
Leitrim,2020,5 - 9 years,0,0,0
Leitrim,2020,50 - 54 years,3,5,8
Leitrim,2020,55 - 59 years,4,9,13
Leitrim,2020,60 - 64 years,4,12,16
Leitrim,2020,65 - 69 years,4,20,24
Leitrim,2020,70 - 74 years,19,16,35
Leitrim,2020,75 - 79 years,14,22,36
Leitrim,2020,80 - 84 years,21,28,49
Leitrim,2020,85 years and over,58,43,101
Leitrim,2020,Under 1 year,1,0,1
Letterkenny Town,2007,1 - 4 years,2,0,2
Letterkenny Town,2007,10 - 14 years,0,0,0
Letterkenny Town,2007,15 - 19 years,0,0,0
Letterkenny Town,2007,20 - 24 years,0,0,0
Letterkenny Town,2007,25 - 29 years,1,1,2
Letterkenny Town,2007,30 - 34 years,0,1,1
Letterkenny Town,2007,35 - 39 years,1,1,2
Letterkenny Town,2007,40 - 44 years,0,1,1
Letterkenny Town,2007,45 - 49 years,1,0,1
Letterkenny Town,2007,5 - 9 years,1,0,1
Letterkenny Town,2007,50 - 54 years,5,2,7
Letterkenny Town,2007,55 - 59 years,4,3,7
Letterkenny Town,2007,60 - 64 years,3,1,4
Letterkenny Town,2007,65 - 69 years,2,9,11
Letterkenny Town,2007,70 - 74 years,1,10,11
Letterkenny Town,2007,75 - 79 years,6,18,24
Letterkenny Town,2007,80 - 84 years,14,10,24
Letterkenny Town,2007,85 years and over,21,14,35
Letterkenny Town,2007,Under 1 year,0,2,2
Letterkenny Town,2008,1 - 4 years,2,0,2
Letterkenny Town,2008,10 - 14 years,0,0,0
Letterkenny Town,2008,15 - 19 years,0,0,0
Letterkenny Town,2008,20 - 24 years,0,1,1
Letterkenny Town,2008,25 - 29 years,1,2,3
Letterkenny Town,2008,30 - 34 years,2,2,4
Letterkenny Town,2008,35 - 39 years,1,1,2
Letterkenny Town,2008,40 - 44 years,2,3,5
Letterkenny Town,2008,45 - 49 years,1,1,2
Letterkenny Town,2008,5 - 9 years,1,0,1
Letterkenny Town,2008,50 - 54 years,1,2,3
Letterkenny Town,2008,55 - 59 years,4,6,10
Letterkenny Town,2008,60 - 64 years,3,4,7
Letterkenny Town,2008,65 - 69 years,3,9,12
Letterkenny Town,2008,70 - 74 years,3,7,10
Letterkenny Town,2008,75 - 79 years,7,14,21
Letterkenny Town,2008,80 - 84 years,12,21,33
Letterkenny Town,2008,85 years and over,29,16,45
Letterkenny Town,2008,Under 1 year,2,2,4
Letterkenny Town,2009,1 - 4 years,2,0,2
Letterkenny Town,2009,10 - 14 years,0,1,1
Letterkenny Town,2009,15 - 19 years,2,0,2
Letterkenny Town,2009,20 - 24 years,0,1,1
Letterkenny Town,2009,25 - 29 years,1,1,2
Letterkenny Town,2009,30 - 34 years,2,1,3
Letterkenny Town,2009,35 - 39 years,1,1,2
Letterkenny Town,2009,40 - 44 years,2,4,6
Letterkenny Town,2009,45 - 49 years,1,1,2
Letterkenny Town,2009,5 - 9 years,1,0,1
Letterkenny Town,2009,50 - 54 years,1,1,2
Letterkenny Town,2009,55 - 59 years,4,6,10
Letterkenny Town,2009,60 - 64 years,2,5,7
Letterkenny Town,2009,65 - 69 years,3,2,5
Letterkenny Town,2009,70 - 74 years,5,5,10
Letterkenny Town,2009,75 - 79 years,2,2,4
Letterkenny Town,2009,80 - 84 years,4,4,8
Letterkenny Town,2009,85 years and over,7,6,13
Letterkenny Town,2009,Under 1 year,2,1,3
Letterkenny Town,2010,1 - 4 years,2,0,2
Letterkenny Town,2010,10 - 14 years,0,1,1
Letterkenny Town,2010,15 - 19 years,2,0,2
Letterkenny Town,2010,20 - 24 years,0,1,1
Letterkenny Town,2010,25 - 29 years,1,1,2
Letterkenny Town,2010,30 - 34 years,2,1,3
Letterkenny Town,2010,35 - 39 years,1,4,5
Letterkenny Town,2010,40 - 44 years,2,4,6
Letterkenny Town,2010,45 - 49 years,1,1,2
Letterkenny Town,2010,5 - 9 years,1,0,1
Letterkenny Town,2010,50 - 54 years,3,1,4
Letterkenny Town,2010,55 - 59 years,5,4,9
Letterkenny Town,2010,60 - 64 years,2,2,4
Letterkenny Town,2010,65 - 69 years,5,6,11
Letterkenny Town,2010,70 - 74 years,7,5,12
Letterkenny Town,2010,75 - 79 years,2,7,9
Letterkenny Town,2010,80 - 84 years,8,9,17
Letterkenny Town,2010,85 years and over,18,10,28
Letterkenny Town,2010,Under 1 year,2,1,3
Letterkenny Town,2011,1 - 4 years,0,0,0
Letterkenny Town,2011,10 - 14 years,0,0,0
Letterkenny Town,2011,15 - 19 years,0,0,0
Letterkenny Town,2011,20 - 24 years,0,0,0
Letterkenny Town,2011,25 - 29 years,0,0,0
Letterkenny Town,2011,30 - 34 years,0,2,2
Letterkenny Town,2011,35 - 39 years,0,1,1
Letterkenny Town,2011,40 - 44 years,1,2,3
Letterkenny Town,2011,45 - 49 years,0,1,1
Letterkenny Town,2011,5 - 9 years,0,0,0
Letterkenny Town,2011,50 - 54 years,1,2,3
Letterkenny Town,2011,55 - 59 years,0,2,2
Letterkenny Town,2011,60 - 64 years,3,1,4
Letterkenny Town,2011,65 - 69 years,1,2,3
Letterkenny Town,2011,70 - 74 years,3,4,7
Letterkenny Town,2011,75 - 79 years,3,2,5
Letterkenny Town,2011,80 - 84 years,1,8,9
Letterkenny Town,2011,85 years and over,6,5,11
Letterkenny Town,2011,Under 1 year,0,0,0
Letterkenny Town,2012,1 - 4 years,0,0,0
Letterkenny Town,2012,10 - 14 years,0,0,0
Letterkenny Town,2012,15 - 19 years,1,0,1
Letterkenny Town,2012,20 - 24 years,1,0,1
Letterkenny Town,2012,25 - 29 years,0,1,1
Letterkenny Town,2012,30 - 34 years,2,1,3
Letterkenny Town,2012,35 - 39 years,0,1,1
Letterkenny Town,2012,40 - 44 years,1,2,3
Letterkenny Town,2012,45 - 49 years,1,1,2
Letterkenny Town,2012,5 - 9 years,0,0,0
Letterkenny Town,2012,50 - 54 years,2,2,4
Letterkenny Town,2012,55 - 59 years,0,5,5
Letterkenny Town,2012,60 - 64 years,4,7,11
Letterkenny Town,2012,65 - 69 years,4,3,7
Letterkenny Town,2012,70 - 74 years,5,6,11
Letterkenny Town,2012,75 - 79 years,7,4,11
Letterkenny Town,2012,80 - 84 years,4,9,13
Letterkenny Town,2012,85 years and over,15,10,25
Letterkenny Town,2012,Under 1 year,2,1,3
Letterkenny Town,2013,1 - 4 years,0,0,0
Letterkenny Town,2013,10 - 14 years,0,0,0
Letterkenny Town,2013,15 - 19 years,0,0,0
Letterkenny Town,2013,20 - 24 years,0,0,0
Letterkenny Town,2013,25 - 29 years,0,1,1
Letterkenny Town,2013,30 - 34 years,0,2,2
Letterkenny Town,2013,35 - 39 years,1,0,1
Letterkenny Town,2013,40 - 44 years,1,0,1
Letterkenny Town,2013,45 - 49 years,0,2,2
Letterkenny Town,2013,5 - 9 years,0,0,0
Letterkenny Town,2013,50 - 54 years,2,0,2
Letterkenny Town,2013,55 - 59 years,4,4,8
Letterkenny Town,2013,60 - 64 years,2,3,5
Letterkenny Town,2013,65 - 69 years,3,5,8
Letterkenny Town,2013,70 - 74 years,2,3,5
Letterkenny Town,2013,75 - 79 years,4,5,9
Letterkenny Town,2013,80 - 84 years,3,6,9
Letterkenny Town,2013,85 years and over,13,6,19
Letterkenny Town,2013,Under 1 year,1,0,1
Letterkenny Town,2014,1 - 4 years,0,0,0
Letterkenny Town,2014,10 - 14 years,0,0,0
Letterkenny Town,2014,15 - 19 years,0,0,0
Letterkenny Town,2014,20 - 24 years,0,0,0
Letterkenny Town,2014,25 - 29 years,3,1,4
Letterkenny Town,2014,30 - 34 years,0,2,2
Letterkenny Town,2014,35 - 39 years,1,1,2
Letterkenny Town,2014,40 - 44 years,1,1,2
Letterkenny Town,2014,45 - 49 years,1,1,2
Letterkenny Town,2014,5 - 9 years,0,0,0
Letterkenny Town,2014,50 - 54 years,3,2,5
Letterkenny Town,2014,55 - 59 years,1,3,4
Letterkenny Town,2014,60 - 64 years,1,2,3
Letterkenny Town,2014,65 - 69 years,3,2,5
Letterkenny Town,2014,70 - 74 years,7,7,14
Letterkenny Town,2014,75 - 79 years,7,7,14
Letterkenny Town,2014,80 - 84 years,5,10,15
Letterkenny Town,2014,85 years and over,15,13,28
Letterkenny Town,2014,Under 1 year,1,0,1
Letterkenny Town,2015,1 - 4 years,0,0,0
Letterkenny Town,2015,10 - 14 years,0,0,0
Letterkenny Town,2015,15 - 19 years,0,0,0
Letterkenny Town,2015,20 - 24 years,0,0,0
Letterkenny Town,2015,25 - 29 years,3,1,4
Letterkenny Town,2015,30 - 34 years,0,2,2
Letterkenny Town,2015,35 - 39 years,1,1,2
Letterkenny Town,2015,40 - 44 years,1,1,2
Letterkenny Town,2015,45 - 49 years,1,1,2
Letterkenny Town,2015,5 - 9 years,0,0,0
Letterkenny Town,2015,50 - 54 years,3,2,5
Letterkenny Town,2015,55 - 59 years,1,3,4
Letterkenny Town,2015,60 - 64 years,1,2,3
Letterkenny Town,2015,65 - 69 years,3,2,5
Letterkenny Town,2015,70 - 74 years,7,7,14
Letterkenny Town,2015,75 - 79 years,7,7,14
Letterkenny Town,2015,80 - 84 years,5,10,15
Letterkenny Town,2015,85 years and over,15,13,28
Letterkenny Town,2015,Under 1 year,1,0,1
Letterkenny Town,2016,1 - 4 years,0,0,0
Letterkenny Town,2016,10 - 14 years,0,0,0
Letterkenny Town,2016,15 - 19 years,0,0,0
Letterkenny Town,2016,20 - 24 years,0,0,0
Letterkenny Town,2016,25 - 29 years,3,1,4
Letterkenny Town,2016,30 - 34 years,0,2,2
Letterkenny Town,2016,35 - 39 years,1,1,2
Letterkenny Town,2016,40 - 44 years,1,1,2
Letterkenny Town,2016,45 - 49 years,1,1,2
Letterkenny Town,2016,5 - 9 years,0,0,0
Letterkenny Town,2016,50 - 54 years,3,2,5
Letterkenny Town,2016,55 - 59 years,1,3,4
Letterkenny Town,2016,60 - 64 years,1,2,3
Letterkenny Town,2016,65 - 69 years,3,2,5
Letterkenny Town,2016,70 - 74 years,7,7,14
Letterkenny Town,2016,75 - 79 years,7,7,14
Letterkenny Town,2016,80 - 84 years,5,10,15
Letterkenny Town,2016,85 years and over,15,13,28
Letterkenny Town,2016,Under 1 year,1,0,1
Letterkenny Town,2017,1 - 4 years,0,0,0
Letterkenny Town,2017,10 - 14 years,0,0,0
Letterkenny Town,2017,15 - 19 years,0,0,0
Letterkenny Town,2017,20 - 24 years,1,0,1
Letterkenny Town,2017,25 - 29 years,3,1,4
Letterkenny Town,2017,30 - 34 years,0,2,2
Letterkenny Town,2017,35 - 39 years,1,1,2
Letterkenny Town,2017,40 - 44 years,1,1,2
Letterkenny Town,2017,45 - 49 years,1,6,7
Letterkenny Town,2017,5 - 9 years,0,0,0
Letterkenny Town,2017,50 - 54 years,3,3,6
Letterkenny Town,2017,55 - 59 years,1,2,3
Letterkenny Town,2017,60 - 64 years,2,6,8
Letterkenny Town,2017,65 - 69 years,8,6,14
Letterkenny Town,2017,70 - 74 years,6,8,14
Letterkenny Town,2017,75 - 79 years,10,7,17
Letterkenny Town,2017,80 - 84 years,10,10,20
Letterkenny Town,2017,85 years and over,31,17,48
Letterkenny Town,2017,Under 1 year,1,1,2
Letterkenny Town,2018,1 - 4 years,0,0,0
Letterkenny Town,2018,10 - 14 years,0,0,0
Letterkenny Town,2018,15 - 19 years,0,0,0
Letterkenny Town,2018,20 - 24 years,1,0,1
Letterkenny Town,2018,25 - 29 years,0,0,0
Letterkenny Town,2018,30 - 34 years,0,1,1
Letterkenny Town,2018,35 - 39 years,0,1,1
Letterkenny Town,2018,40 - 44 years,2,1,3
Letterkenny Town,2018,45 - 49 years,1,1,2
Letterkenny Town,2018,5 - 9 years,0,0,0
Letterkenny Town,2018,50 - 54 years,2,1,3
Letterkenny Town,2018,55 - 59 years,4,2,6
Letterkenny Town,2018,60 - 64 years,3,4,7
Letterkenny Town,2018,65 - 69 years,5,6,11
Letterkenny Town,2018,70 - 74 years,10,9,19
Letterkenny Town,2018,75 - 79 years,5,11,16
Letterkenny Town,2018,80 - 84 years,19,18,37
Letterkenny Town,2018,85 years and over,21,10,31
Letterkenny Town,2018,Under 1 year,0,0,0
Letterkenny Town,2019,1 - 4 years,0,0,0
Letterkenny Town,2019,10 - 14 years,0,0,0
Letterkenny Town,2019,15 - 19 years,0,0,0
Letterkenny Town,2019,20 - 24 years,1,0,1
Letterkenny Town,2019,25 - 29 years,0,0,0
Letterkenny Town,2019,30 - 34 years,0,1,1
Letterkenny Town,2019,35 - 39 years,0,1,1
Letterkenny Town,2019,40 - 44 years,2,1,3
Letterkenny Town,2019,45 - 49 years,1,1,2
Letterkenny Town,2019,5 - 9 years,0,0,0
Letterkenny Town,2019,50 - 54 years,2,1,3
Letterkenny Town,2019,55 - 59 years,4,2,6
Letterkenny Town,2019,60 - 64 years,3,4,7
Letterkenny Town,2019,65 - 69 years,5,6,11
Letterkenny Town,2019,70 - 74 years,10,9,19
Letterkenny Town,2019,75 - 79 years,5,11,16
Letterkenny Town,2019,80 - 84 years,19,18,37
Letterkenny Town,2019,85 years and over,21,10,31
Letterkenny Town,2019,Under 1 year,0,0,0
Letterkenny Town,2020,1 - 4 years,0,0,0
Letterkenny Town,2020,10 - 14 years,0,0,0
Letterkenny Town,2020,15 - 19 years,0,0,0
Letterkenny Town,2020,20 - 24 years,1,0,1
Letterkenny Town,2020,25 - 29 years,0,0,0
Letterkenny Town,2020,30 - 34 years,0,1,1
Letterkenny Town,2020,35 - 39 years,0,1,1
Letterkenny Town,2020,40 - 44 years,2,1,3
Letterkenny Town,2020,45 - 49 years,1,1,2
Letterkenny Town,2020,5 - 9 years,0,0,0
Letterkenny Town,2020,50 - 54 years,2,1,3
Letterkenny Town,2020,55 - 59 years,4,2,6
Letterkenny Town,2020,60 - 64 years,3,4,7
Letterkenny Town,2020,65 - 69 years,5,6,11
Letterkenny Town,2020,70 - 74 years,10,9,19
Letterkenny Town,2020,75 - 79 years,5,11,16
Letterkenny Town,2020,80 - 84 years,19,18,37
Letterkenny Town,2020,85 years and over,21,10,31
Letterkenny Town,2020,Under 1 year,0,0,0
Limerick City,2007,1 - 4 years,0,0,0
Limerick City,2007,10 - 14 years,0,3,3
Limerick City,2007,15 - 19 years,0,3,3
Limerick City,2007,20 - 24 years,2,4,6
Limerick City,2007,25 - 29 years,2,3,5
Limerick City,2007,30 - 34 years,1,4,5
Limerick City,2007,35 - 39 years,3,2,5
Limerick City,2007,40 - 44 years,2,4,6
Limerick City,2007,45 - 49 years,4,5,9
Limerick City,2007,5 - 9 years,0,0,0
Limerick City,2007,50 - 54 years,4,11,15
Limerick City,2007,55 - 59 years,9,17,26
Limerick City,2007,60 - 64 years,11,16,27
Limerick City,2007,65 - 69 years,22,22,44
Limerick City,2007,70 - 74 years,21,35,56
Limerick City,2007,75 - 79 years,25,41,66
Limerick City,2007,80 - 84 years,34,27,61
Limerick City,2007,85 years and over,72,31,103
Limerick City,2007,Under 1 year,0,3,3
Limerick City,2008,1 - 4 years,0,0,0
Limerick City,2008,10 - 14 years,0,2,2
Limerick City,2008,15 - 19 years,2,1,3
Limerick City,2008,20 - 24 years,2,2,4
Limerick City,2008,25 - 29 years,1,3,4
Limerick City,2008,30 - 34 years,1,4,5
Limerick City,2008,35 - 39 years,1,5,6
Limerick City,2008,40 - 44 years,1,6,7
Limerick City,2008,45 - 49 years,3,5,8
Limerick City,2008,5 - 9 years,1,1,2
Limerick City,2008,50 - 54 years,10,12,22
Limerick City,2008,55 - 59 years,10,18,28
Limerick City,2008,60 - 64 years,15,29,44
Limerick City,2008,65 - 69 years,15,18,33
Limerick City,2008,70 - 74 years,22,27,49
Limerick City,2008,75 - 79 years,31,34,65
Limerick City,2008,80 - 84 years,37,35,72
Limerick City,2008,85 years and over,76,46,122
Limerick City,2008,Under 1 year,0,3,3
Limerick City,2009,1 - 4 years,0,0,0
Limerick City,2009,10 - 14 years,0,2,2
Limerick City,2009,15 - 19 years,1,3,4
Limerick City,2009,20 - 24 years,2,2,4
Limerick City,2009,25 - 29 years,2,4,6
Limerick City,2009,30 - 34 years,1,7,8
Limerick City,2009,35 - 39 years,3,5,8
Limerick City,2009,40 - 44 years,4,6,10
Limerick City,2009,45 - 49 years,4,9,13
Limerick City,2009,5 - 9 years,1,1,2
Limerick City,2009,50 - 54 years,6,10,16
Limerick City,2009,55 - 59 years,9,18,27
Limerick City,2009,60 - 64 years,8,21,29
Limerick City,2009,65 - 69 years,11,25,36
Limerick City,2009,70 - 74 years,22,30,52
Limerick City,2009,75 - 79 years,23,33,56
Limerick City,2009,80 - 84 years,35,33,68
Limerick City,2009,85 years and over,72,34,106
Limerick City,2009,Under 1 year,1,3,4
Limerick City,2010,1 - 4 years,0,1,1
Limerick City,2010,10 - 14 years,0,1,1
Limerick City,2010,15 - 19 years,2,1,3
Limerick City,2010,20 - 24 years,1,2,3
Limerick City,2010,25 - 29 years,2,1,3
Limerick City,2010,30 - 34 years,2,6,8
Limerick City,2010,35 - 39 years,3,5,8
Limerick City,2010,40 - 44 years,4,8,12
Limerick City,2010,45 - 49 years,5,7,12
Limerick City,2010,5 - 9 years,1,1,2
Limerick City,2010,50 - 54 years,7,8,15
Limerick City,2010,55 - 59 years,7,7,14
Limerick City,2010,60 - 64 years,8,19,27
Limerick City,2010,65 - 69 years,22,25,47
Limerick City,2010,70 - 74 years,21,34,55
Limerick City,2010,75 - 79 years,29,28,57
Limerick City,2010,80 - 84 years,33,45,78
Limerick City,2010,85 years and over,70,33,103
Limerick City,2010,Under 1 year,2,7,9
Limerick City,2011,1 - 4 years,0,0,0
Limerick City,2011,10 - 14 years,0,0,0
Limerick City,2011,15 - 19 years,0,1,1
Limerick City,2011,20 - 24 years,3,3,6
Limerick City,2011,25 - 29 years,2,4,6
Limerick City,2011,30 - 34 years,2,2,4
Limerick City,2011,35 - 39 years,3,4,7
Limerick City,2011,40 - 44 years,2,4,6
Limerick City,2011,45 - 49 years,5,10,15
Limerick City,2011,5 - 9 years,0,0,0
Limerick City,2011,50 - 54 years,5,13,18
Limerick City,2011,55 - 59 years,10,8,18
Limerick City,2011,60 - 64 years,12,25,37
Limerick City,2011,65 - 69 years,16,21,37
Limerick City,2011,70 - 74 years,30,28,58
Limerick City,2011,75 - 79 years,36,36,72
Limerick City,2011,80 - 84 years,34,34,68
Limerick City,2011,85 years and over,94,43,137
Limerick City,2011,Under 1 year,2,4,6
Limerick City,2012,1 - 4 years,1,0,1
Limerick City,2012,10 - 14 years,1,0,1
Limerick City,2012,15 - 19 years,0,1,1
Limerick City,2012,20 - 24 years,1,4,5
Limerick City,2012,25 - 29 years,3,4,7
Limerick City,2012,30 - 34 years,2,2,4
Limerick City,2012,35 - 39 years,3,6,9
Limerick City,2012,40 - 44 years,3,5,8
Limerick City,2012,45 - 49 years,2,5,7
Limerick City,2012,5 - 9 years,1,0,1
Limerick City,2012,50 - 54 years,12,14,26
Limerick City,2012,55 - 59 years,7,13,20
Limerick City,2012,60 - 64 years,15,12,27
Limerick City,2012,65 - 69 years,18,31,49
Limerick City,2012,70 - 74 years,23,28,51
Limerick City,2012,75 - 79 years,32,32,64
Limerick City,2012,80 - 84 years,51,41,92
Limerick City,2012,85 years and over,112,47,159
Limerick City,2012,Under 1 year,2,1,3
Limerick City,2013,1 - 4 years,0,0,0
Limerick City,2013,10 - 14 years,0,0,0
Limerick City,2013,15 - 19 years,3,1,4
Limerick City,2013,20 - 24 years,1,2,3
Limerick City,2013,25 - 29 years,0,3,3
Limerick City,2013,30 - 34 years,3,5,8
Limerick City,2013,35 - 39 years,2,5,7
Limerick City,2013,40 - 44 years,1,6,7
Limerick City,2013,45 - 49 years,5,6,11
Limerick City,2013,5 - 9 years,0,0,0
Limerick City,2013,50 - 54 years,8,8,16
Limerick City,2013,55 - 59 years,11,23,34
Limerick City,2013,60 - 64 years,12,14,26
Limerick City,2013,65 - 69 years,17,24,41
Limerick City,2013,70 - 74 years,26,31,57
Limerick City,2013,75 - 79 years,26,34,60
Limerick City,2013,80 - 84 years,40,28,68
Limerick City,2013,85 years and over,98,59,157
Limerick City,2013,Under 1 year,3,2,5
Limerick City,2014,1 - 4 years,1,0,1
Limerick City,2014,10 - 14 years,0,0,0
Limerick City,2014,15 - 19 years,1,1,2
Limerick City,2014,20 - 24 years,1,4,5
Limerick City,2014,25 - 29 years,2,4,6
Limerick City,2014,30 - 34 years,3,1,4
Limerick City,2014,35 - 39 years,4,3,7
Limerick City,2014,40 - 44 years,3,4,7
Limerick City,2014,45 - 49 years,7,6,13
Limerick City,2014,5 - 9 years,1,1,2
Limerick City,2014,50 - 54 years,10,7,17
Limerick City,2014,55 - 59 years,7,18,25
Limerick City,2014,60 - 64 years,8,17,25
Limerick City,2014,65 - 69 years,16,30,46
Limerick City,2014,70 - 74 years,22,32,54
Limerick City,2014,75 - 79 years,30,47,77
Limerick City,2014,80 - 84 years,53,35,88
Limerick City,2014,85 years and over,75,51,126
Limerick City,2014,Under 1 year,3,5,8
Limerick City,2015,1 - 4 years,1,1,2
Limerick City,2015,10 - 14 years,0,0,0
Limerick City,2015,15 - 19 years,1,1,2
Limerick City,2015,20 - 24 years,1,4,5
Limerick City,2015,25 - 29 years,3,2,5
Limerick City,2015,30 - 34 years,1,6,7
Limerick City,2015,35 - 39 years,1,2,3
Limerick City,2015,40 - 44 years,5,4,9
Limerick City,2015,45 - 49 years,8,6,14
Limerick City,2015,5 - 9 years,1,1,2
Limerick City,2015,50 - 54 years,10,10,20
Limerick City,2015,55 - 59 years,7,15,22
Limerick City,2015,60 - 64 years,10,20,30
Limerick City,2015,65 - 69 years,18,29,47
Limerick City,2015,70 - 74 years,30,23,53
Limerick City,2015,75 - 79 years,20,41,61
Limerick City,2015,80 - 84 years,51,44,95
Limerick City,2015,85 years and over,95,52,147
Limerick City,2015,Under 1 year,3,3,6
Limerick City,2016,1 - 4 years,1,1,2
Limerick City,2016,10 - 14 years,0,0,0
Limerick City,2016,15 - 19 years,1,2,3
Limerick City,2016,20 - 24 years,1,2,3
Limerick City,2016,25 - 29 years,1,2,3
Limerick City,2016,30 - 34 years,2,6,8
Limerick City,2016,35 - 39 years,1,8,9
Limerick City,2016,40 - 44 years,3,3,6
Limerick City,2016,45 - 49 years,8,5,13
Limerick City,2016,5 - 9 years,1,1,2
Limerick City,2016,50 - 54 years,4,12,16
Limerick City,2016,55 - 59 years,11,21,32
Limerick City,2016,60 - 64 years,9,22,31
Limerick City,2016,65 - 69 years,19,22,41
Limerick City,2016,70 - 74 years,22,32,54
Limerick City,2016,75 - 79 years,39,52,91
Limerick City,2016,80 - 84 years,39,45,84
Limerick City,2016,85 years and over,106,47,153
Limerick City,2016,Under 1 year,1,1,2
Limerick City,2017,1 - 4 years,1,1,2
Limerick City,2017,10 - 14 years,0,0,0
Limerick City,2017,15 - 19 years,1,2,3
Limerick City,2017,20 - 24 years,3,2,5
Limerick City,2017,25 - 29 years,1,1,2
Limerick City,2017,30 - 34 years,2,3,5
Limerick City,2017,35 - 39 years,1,5,6
Limerick City,2017,40 - 44 years,3,4,7
Limerick City,2017,45 - 49 years,8,4,12
Limerick City,2017,5 - 9 years,1,1,2
Limerick City,2017,50 - 54 years,8,9,17
Limerick City,2017,55 - 59 years,9,21,30
Limerick City,2017,60 - 64 years,21,23,44
Limerick City,2017,65 - 69 years,16,23,39
Limerick City,2017,70 - 74 years,20,26,46
Limerick City,2017,75 - 79 years,40,38,78
Limerick City,2017,80 - 84 years,47,45,92
Limerick City,2017,85 years and over,118,50,168
Limerick City,2017,Under 1 year,1,2,3
Limerick City,2018,1 - 4 years,0,0,0
Limerick City,2018,10 - 14 years,0,1,1
Limerick City,2018,15 - 19 years,0,3,3
Limerick City,2018,20 - 24 years,0,3,3
Limerick City,2018,25 - 29 years,3,1,4
Limerick City,2018,30 - 34 years,3,5,8
Limerick City,2018,35 - 39 years,2,4,6
Limerick City,2018,40 - 44 years,5,6,11
Limerick City,2018,45 - 49 years,5,5,10
Limerick City,2018,5 - 9 years,0,0,0
Limerick City,2018,50 - 54 years,2,4,6
Limerick City,2018,55 - 59 years,7,14,21
Limerick City,2018,60 - 64 years,8,17,25
Limerick City,2018,65 - 69 years,25,29,54
Limerick City,2018,70 - 74 years,19,32,51
Limerick City,2018,75 - 79 years,26,39,65
Limerick City,2018,80 - 84 years,41,50,91
Limerick City,2018,85 years and over,88,53,141
Limerick City,2018,Under 1 year,2,3,5
Limerick City,2019,1 - 4 years,0,1,1
Limerick City,2019,10 - 14 years,0,0,0
Limerick City,2019,15 - 19 years,0,3,3
Limerick City,2019,20 - 24 years,0,4,4
Limerick City,2019,25 - 29 years,2,3,5
Limerick City,2019,30 - 34 years,0,4,4
Limerick City,2019,35 - 39 years,4,1,5
Limerick City,2019,40 - 44 years,1,4,5
Limerick City,2019,45 - 49 years,3,7,10
Limerick City,2019,5 - 9 years,0,0,0
Limerick City,2019,50 - 54 years,4,7,11
Limerick City,2019,55 - 59 years,4,18,22
Limerick City,2019,60 - 64 years,17,22,39
Limerick City,2019,65 - 69 years,11,16,27
Limerick City,2019,70 - 74 years,26,33,59
Limerick City,2019,75 - 79 years,26,36,62
Limerick City,2019,80 - 84 years,28,41,69
Limerick City,2019,85 years and over,99,77,176
Limerick City,2019,Under 1 year,1,0,1
Limerick City,2020,1 - 4 years,0,1,1
Limerick City,2020,10 - 14 years,1,0,1
Limerick City,2020,15 - 19 years,1,3,4
Limerick City,2020,20 - 24 years,2,1,3
Limerick City,2020,25 - 29 years,2,3,5
Limerick City,2020,30 - 34 years,1,4,5
Limerick City,2020,35 - 39 years,5,5,10
Limerick City,2020,40 - 44 years,2,3,5
Limerick City,2020,45 - 49 years,3,11,14
Limerick City,2020,5 - 9 years,0,0,0
Limerick City,2020,50 - 54 years,3,12,15
Limerick City,2020,55 - 59 years,6,17,23
Limerick City,2020,60 - 64 years,14,15,29
Limerick City,2020,65 - 69 years,18,17,35
Limerick City,2020,70 - 74 years,31,43,74
Limerick City,2020,75 - 79 years,34,46,80
Limerick City,2020,80 - 84 years,55,40,95
Limerick City,2020,85 years and over,102,46,148
Limerick City,2020,Under 1 year,1,0,1
Limerick County,2007,1 - 4 years,1,0,1
Limerick County,2007,10 - 14 years,1,0,1
Limerick County,2007,15 - 19 years,2,2,4
Limerick County,2007,20 - 24 years,0,6,6
Limerick County,2007,25 - 29 years,6,5,11
Limerick County,2007,30 - 34 years,0,2,2
Limerick County,2007,35 - 39 years,0,6,6
Limerick County,2007,40 - 44 years,4,6,10
Limerick County,2007,45 - 49 years,5,9,14
Limerick County,2007,5 - 9 years,0,1,1
Limerick County,2007,50 - 54 years,10,20,30
Limerick County,2007,55 - 59 years,18,27,45
Limerick County,2007,60 - 64 years,22,34,56
Limerick County,2007,65 - 69 years,28,42,70
Limerick County,2007,70 - 74 years,47,52,99
Limerick County,2007,75 - 79 years,54,63,117
Limerick County,2007,80 - 84 years,90,95,185
Limerick County,2007,85 years and over,140,101,241
Limerick County,2007,Under 1 year,5,2,7
Limerick County,2008,1 - 4 years,1,0,1
Limerick County,2008,10 - 14 years,1,2,3
Limerick County,2008,15 - 19 years,2,1,3
Limerick County,2008,20 - 24 years,0,3,3
Limerick County,2008,25 - 29 years,2,3,5
Limerick County,2008,30 - 34 years,0,2,2
Limerick County,2008,35 - 39 years,2,4,6
Limerick County,2008,40 - 44 years,5,7,12
Limerick County,2008,45 - 49 years,10,6,16
Limerick County,2008,5 - 9 years,0,1,1
Limerick County,2008,50 - 54 years,10,16,26
Limerick County,2008,55 - 59 years,10,22,32
Limerick County,2008,60 - 64 years,18,30,48
Limerick County,2008,65 - 69 years,23,41,64
Limerick County,2008,70 - 74 years,28,59,87
Limerick County,2008,75 - 79 years,60,57,117
Limerick County,2008,80 - 84 years,79,84,163
Limerick County,2008,85 years and over,156,89,245
Limerick County,2008,Under 1 year,3,6,9
Limerick County,2009,1 - 4 years,1,1,2
Limerick County,2009,10 - 14 years,1,2,3
Limerick County,2009,15 - 19 years,2,4,6
Limerick County,2009,20 - 24 years,1,4,5
Limerick County,2009,25 - 29 years,3,5,8
Limerick County,2009,30 - 34 years,4,8,12
Limerick County,2009,35 - 39 years,3,13,16
Limerick County,2009,40 - 44 years,6,5,11
Limerick County,2009,45 - 49 years,8,12,20
Limerick County,2009,5 - 9 years,1,1,2
Limerick County,2009,50 - 54 years,9,21,30
Limerick County,2009,55 - 59 years,18,20,38
Limerick County,2009,60 - 64 years,28,36,64
Limerick County,2009,65 - 69 years,23,39,62
Limerick County,2009,70 - 74 years,30,55,85
Limerick County,2009,75 - 79 years,56,72,128
Limerick County,2009,80 - 84 years,75,60,135
Limerick County,2009,85 years and over,172,110,282
Limerick County,2009,Under 1 year,5,7,12
Limerick County,2010,1 - 4 years,1,1,2
Limerick County,2010,10 - 14 years,1,2,3
Limerick County,2010,15 - 19 years,2,1,3
Limerick County,2010,20 - 24 years,1,7,8
Limerick County,2010,25 - 29 years,2,9,11
Limerick County,2010,30 - 34 years,3,5,8
Limerick County,2010,35 - 39 years,3,7,10
Limerick County,2010,40 - 44 years,5,7,12
Limerick County,2010,45 - 49 years,9,10,19
Limerick County,2010,5 - 9 years,1,1,2
Limerick County,2010,50 - 54 years,6,17,23
Limerick County,2010,55 - 59 years,12,24,36
Limerick County,2010,60 - 64 years,20,33,53
Limerick County,2010,65 - 69 years,22,43,65
Limerick County,2010,70 - 74 years,31,50,81
Limerick County,2010,75 - 79 years,45,52,97
Limerick County,2010,80 - 84 years,73,98,171
Limerick County,2010,85 years and over,172,86,258
Limerick County,2010,Under 1 year,5,3,8
Limerick County,2011,1 - 4 years,1,1,2
Limerick County,2011,10 - 14 years,0,1,1
Limerick County,2011,15 - 19 years,0,2,2
Limerick County,2011,20 - 24 years,3,5,8
Limerick County,2011,25 - 29 years,2,6,8
Limerick County,2011,30 - 34 years,1,5,6
Limerick County,2011,35 - 39 years,3,4,7
Limerick County,2011,40 - 44 years,8,4,12
Limerick County,2011,45 - 49 years,6,8,14
Limerick County,2011,5 - 9 years,0,1,1
Limerick County,2011,50 - 54 years,10,15,25
Limerick County,2011,55 - 59 years,13,33,46
Limerick County,2011,60 - 64 years,14,31,45
Limerick County,2011,65 - 69 years,25,34,59
Limerick County,2011,70 - 74 years,29,69,98
Limerick County,2011,75 - 79 years,56,66,122
Limerick County,2011,80 - 84 years,67,77,144
Limerick County,2011,85 years and over,162,91,253
Limerick County,2011,Under 1 year,4,9,13
Limerick County,2012,1 - 4 years,1,1,2
Limerick County,2012,10 - 14 years,0,1,1
Limerick County,2012,15 - 19 years,1,1,2
Limerick County,2012,20 - 24 years,2,5,7
Limerick County,2012,25 - 29 years,2,3,5
Limerick County,2012,30 - 34 years,2,3,5
Limerick County,2012,35 - 39 years,4,6,10
Limerick County,2012,40 - 44 years,7,3,10
Limerick County,2012,45 - 49 years,9,6,15
Limerick County,2012,5 - 9 years,0,2,2
Limerick County,2012,50 - 54 years,11,15,26
Limerick County,2012,55 - 59 years,12,16,28
Limerick County,2012,60 - 64 years,23,42,65
Limerick County,2012,65 - 69 years,30,41,71
Limerick County,2012,70 - 74 years,31,54,85
Limerick County,2012,75 - 79 years,38,67,105
Limerick County,2012,80 - 84 years,58,68,126
Limerick County,2012,85 years and over,189,102,291
Limerick County,2012,Under 1 year,9,1,10
Limerick County,2013,1 - 4 years,0,1,1
Limerick County,2013,10 - 14 years,1,1,2
Limerick County,2013,15 - 19 years,0,0,0
Limerick County,2013,20 - 24 years,2,3,5
Limerick County,2013,25 - 29 years,1,0,1
Limerick County,2013,30 - 34 years,6,2,8
Limerick County,2013,35 - 39 years,2,4,6
Limerick County,2013,40 - 44 years,2,3,5
Limerick County,2013,45 - 49 years,4,7,11
Limerick County,2013,5 - 9 years,2,0,2
Limerick County,2013,50 - 54 years,8,11,19
Limerick County,2013,55 - 59 years,12,14,26
Limerick County,2013,60 - 64 years,18,30,48
Limerick County,2013,65 - 69 years,17,43,60
Limerick County,2013,70 - 74 years,26,49,75
Limerick County,2013,75 - 79 years,55,81,136
Limerick County,2013,80 - 84 years,66,77,143
Limerick County,2013,85 years and over,179,106,285
Limerick County,2013,Under 1 year,4,9,13
Limerick County,2014,1 - 4 years,1,2,3
Limerick County,2014,10 - 14 years,2,1,3
Limerick County,2014,15 - 19 years,0,3,3
Limerick County,2014,20 - 24 years,2,4,6
Limerick County,2014,25 - 29 years,1,1,2
Limerick County,2014,30 - 34 years,6,6,12
Limerick County,2014,35 - 39 years,2,1,3
Limerick County,2014,40 - 44 years,3,5,8
Limerick County,2014,45 - 49 years,6,12,18
Limerick County,2014,5 - 9 years,2,0,2
Limerick County,2014,50 - 54 years,5,13,18
Limerick County,2014,55 - 59 years,15,26,41
Limerick County,2014,60 - 64 years,16,32,48
Limerick County,2014,65 - 69 years,31,44,75
Limerick County,2014,70 - 74 years,38,57,95
Limerick County,2014,75 - 79 years,47,71,118
Limerick County,2014,80 - 84 years,65,74,139
Limerick County,2014,85 years and over,188,114,302
Limerick County,2014,Under 1 year,4,6,10
Limerick County,2015,1 - 4 years,1,2,3
Limerick County,2015,10 - 14 years,2,1,3
Limerick County,2015,15 - 19 years,0,1,1
Limerick County,2015,20 - 24 years,1,2,3
Limerick County,2015,25 - 29 years,1,5,6
Limerick County,2015,30 - 34 years,3,4,7
Limerick County,2015,35 - 39 years,2,7,9
Limerick County,2015,40 - 44 years,3,7,10
Limerick County,2015,45 - 49 years,4,4,8
Limerick County,2015,5 - 9 years,2,1,3
Limerick County,2015,50 - 54 years,8,19,27
Limerick County,2015,55 - 59 years,20,17,37
Limerick County,2015,60 - 64 years,23,22,45
Limerick County,2015,65 - 69 years,25,43,68
Limerick County,2015,70 - 74 years,19,55,74
Limerick County,2015,75 - 79 years,44,77,121
Limerick County,2015,80 - 84 years,68,77,145
Limerick County,2015,85 years and over,167,117,284
Limerick County,2015,Under 1 year,1,7,8
Limerick County,2016,1 - 4 years,1,2,3
Limerick County,2016,10 - 14 years,1,1,2
Limerick County,2016,15 - 19 years,2,1,3
Limerick County,2016,20 - 24 years,1,2,3
Limerick County,2016,25 - 29 years,1,3,4
Limerick County,2016,30 - 34 years,3,8,11
Limerick County,2016,35 - 39 years,3,9,12
Limerick County,2016,40 - 44 years,5,6,11
Limerick County,2016,45 - 49 years,8,11,19
Limerick County,2016,5 - 9 years,2,1,3
Limerick County,2016,50 - 54 years,11,8,19
Limerick County,2016,55 - 59 years,12,16,28
Limerick County,2016,60 - 64 years,16,32,48
Limerick County,2016,65 - 69 years,29,32,61
Limerick County,2016,70 - 74 years,46,59,105
Limerick County,2016,75 - 79 years,61,68,129
Limerick County,2016,80 - 84 years,87,74,161
Limerick County,2016,85 years and over,200,101,301
Limerick County,2016,Under 1 year,2,2,4
Limerick County,2017,1 - 4 years,1,2,3
Limerick County,2017,10 - 14 years,1,1,2
Limerick County,2017,15 - 19 years,2,3,5
Limerick County,2017,20 - 24 years,1,2,3
Limerick County,2017,25 - 29 years,1,3,4
Limerick County,2017,30 - 34 years,6,6,12
Limerick County,2017,35 - 39 years,2,6,8
Limerick County,2017,40 - 44 years,4,4,8
Limerick County,2017,45 - 49 years,5,9,14
Limerick County,2017,5 - 9 years,1,1,2
Limerick County,2017,50 - 54 years,9,12,21
Limerick County,2017,55 - 59 years,9,14,23
Limerick County,2017,60 - 64 years,23,23,46
Limerick County,2017,65 - 69 years,21,45,66
Limerick County,2017,70 - 74 years,47,53,100
Limerick County,2017,75 - 79 years,45,58,103
Limerick County,2017,80 - 84 years,62,76,138
Limerick County,2017,85 years and over,172,91,263
Limerick County,2017,Under 1 year,3,1,4
Limerick County,2018,1 - 4 years,0,1,1
Limerick County,2018,10 - 14 years,0,1,1
Limerick County,2018,15 - 19 years,1,1,2
Limerick County,2018,20 - 24 years,1,2,3
Limerick County,2018,25 - 29 years,4,1,5
Limerick County,2018,30 - 34 years,0,4,4
Limerick County,2018,35 - 39 years,3,4,7
Limerick County,2018,40 - 44 years,5,10,15
Limerick County,2018,45 - 49 years,7,4,11
Limerick County,2018,5 - 9 years,0,1,1
Limerick County,2018,50 - 54 years,9,19,28
Limerick County,2018,55 - 59 years,18,23,41
Limerick County,2018,60 - 64 years,19,29,48
Limerick County,2018,65 - 69 years,26,42,68
Limerick County,2018,70 - 74 years,44,67,111
Limerick County,2018,75 - 79 years,54,75,129
Limerick County,2018,80 - 84 years,81,90,171
Limerick County,2018,85 years and over,180,122,302
Limerick County,2018,Under 1 year,4,2,6
Limerick County,2019,1 - 4 years,0,1,1
Limerick County,2019,10 - 14 years,0,0,0
Limerick County,2019,15 - 19 years,2,0,2
Limerick County,2019,20 - 24 years,1,1,2
Limerick County,2019,25 - 29 years,2,3,5
Limerick County,2019,30 - 34 years,2,4,6
Limerick County,2019,35 - 39 years,5,3,8
Limerick County,2019,40 - 44 years,8,11,19
Limerick County,2019,45 - 49 years,3,9,12
Limerick County,2019,5 - 9 years,0,0,0
Limerick County,2019,50 - 54 years,10,16,26
Limerick County,2019,55 - 59 years,8,22,30
Limerick County,2019,60 - 64 years,18,38,56
Limerick County,2019,65 - 69 years,23,34,57
Limerick County,2019,70 - 74 years,50,64,114
Limerick County,2019,75 - 79 years,48,70,118
Limerick County,2019,80 - 84 years,72,66,138
Limerick County,2019,85 years and over,183,120,303
Limerick County,2019,Under 1 year,4,0,4
Limerick County,2020,1 - 4 years,1,1,2
Limerick County,2020,10 - 14 years,0,0,0
Limerick County,2020,15 - 19 years,2,1,3
Limerick County,2020,20 - 24 years,1,3,4
Limerick County,2020,25 - 29 years,2,1,3
Limerick County,2020,30 - 34 years,1,3,4
Limerick County,2020,35 - 39 years,1,2,3
Limerick County,2020,40 - 44 years,3,4,7
Limerick County,2020,45 - 49 years,5,14,19
Limerick County,2020,5 - 9 years,1,0,1
Limerick County,2020,50 - 54 years,11,11,22
Limerick County,2020,55 - 59 years,8,13,21
Limerick County,2020,60 - 64 years,19,27,46
Limerick County,2020,65 - 69 years,29,47,76
Limerick County,2020,70 - 74 years,41,60,101
Limerick County,2020,75 - 79 years,56,80,136
Limerick County,2020,80 - 84 years,60,84,144
Limerick County,2020,85 years and over,198,122,320
Limerick County,2020,Under 1 year,1,2,3
Listowel Town,2007,1 - 4 years,0,0,0
Listowel Town,2007,10 - 14 years,0,0,0
Listowel Town,2007,15 - 19 years,0,0,0
Listowel Town,2007,20 - 24 years,0,0,0
Listowel Town,2007,25 - 29 years,0,1,1
Listowel Town,2007,30 - 34 years,0,0,0
Listowel Town,2007,35 - 39 years,0,0,0
Listowel Town,2007,40 - 44 years,1,0,1
Listowel Town,2007,45 - 49 years,0,0,0
Listowel Town,2007,5 - 9 years,0,0,0
Listowel Town,2007,50 - 54 years,0,3,3
Listowel Town,2007,55 - 59 years,0,0,0
Listowel Town,2007,60 - 64 years,1,4,5
Listowel Town,2007,65 - 69 years,0,2,2
Listowel Town,2007,70 - 74 years,5,3,8
Listowel Town,2007,75 - 79 years,7,7,14
Listowel Town,2007,80 - 84 years,5,12,17
Listowel Town,2007,85 years and over,8,9,17
Listowel Town,2007,Under 1 year,0,1,1
Listowel Town,2008,1 - 4 years,0,0,0
Listowel Town,2008,10 - 14 years,0,0,0
Listowel Town,2008,15 - 19 years,0,0,0
Listowel Town,2008,20 - 24 years,0,0,0
Listowel Town,2008,25 - 29 years,0,1,1
Listowel Town,2008,30 - 34 years,0,0,0
Listowel Town,2008,35 - 39 years,0,0,0
Listowel Town,2008,40 - 44 years,1,1,2
Listowel Town,2008,45 - 49 years,1,0,1
Listowel Town,2008,5 - 9 years,0,0,0
Listowel Town,2008,50 - 54 years,2,3,5
Listowel Town,2008,55 - 59 years,1,1,2
Listowel Town,2008,60 - 64 years,1,3,4
Listowel Town,2008,65 - 69 years,3,3,6
Listowel Town,2008,70 - 74 years,4,9,13
Listowel Town,2008,75 - 79 years,4,3,7
Listowel Town,2008,80 - 84 years,7,6,13
Listowel Town,2008,85 years and over,7,9,16
Listowel Town,2008,Under 1 year,0,1,1
Listowel Town,2009,1 - 4 years,0,0,0
Listowel Town,2009,10 - 14 years,0,0,0
Listowel Town,2009,15 - 19 years,0,0,0
Listowel Town,2009,20 - 24 years,0,0,0
Listowel Town,2009,25 - 29 years,0,1,1
Listowel Town,2009,30 - 34 years,0,0,0
Listowel Town,2009,35 - 39 years,0,0,0
Listowel Town,2009,40 - 44 years,1,1,2
Listowel Town,2009,45 - 49 years,1,0,1
Listowel Town,2009,5 - 9 years,0,0,0
Listowel Town,2009,50 - 54 years,2,2,4
Listowel Town,2009,55 - 59 years,1,2,3
Listowel Town,2009,60 - 64 years,1,2,3
Listowel Town,2009,65 - 69 years,1,1,2
Listowel Town,2009,70 - 74 years,4,3,7
Listowel Town,2009,75 - 79 years,4,3,7
Listowel Town,2009,80 - 84 years,1,3,4
Listowel Town,2009,85 years and over,11,1,12
Listowel Town,2009,Under 1 year,0,1,1
Listowel Town,2010,1 - 4 years,0,0,0
Listowel Town,2010,10 - 14 years,0,0,0
Listowel Town,2010,15 - 19 years,0,0,0
Listowel Town,2010,20 - 24 years,0,1,1
Listowel Town,2010,25 - 29 years,0,1,1
Listowel Town,2010,30 - 34 years,0,0,0
Listowel Town,2010,35 - 39 years,0,0,0
Listowel Town,2010,40 - 44 years,1,1,2
Listowel Town,2010,45 - 49 years,1,0,1
Listowel Town,2010,5 - 9 years,0,0,0
Listowel Town,2010,50 - 54 years,1,2,3
Listowel Town,2010,55 - 59 years,1,2,3
Listowel Town,2010,60 - 64 years,1,3,4
Listowel Town,2010,65 - 69 years,1,3,4
Listowel Town,2010,70 - 74 years,1,1,2
Listowel Town,2010,75 - 79 years,1,2,3
Listowel Town,2010,80 - 84 years,2,2,4
Listowel Town,2010,85 years and over,3,3,6
Listowel Town,2010,Under 1 year,0,2,2
Listowel Town,2011,1 - 4 years,0,0,0
Listowel Town,2011,10 - 14 years,0,0,0
Listowel Town,2011,15 - 19 years,0,0,0
Listowel Town,2011,20 - 24 years,0,0,0
Listowel Town,2011,25 - 29 years,0,0,0
Listowel Town,2011,30 - 34 years,0,0,0
Listowel Town,2011,35 - 39 years,0,0,0
Listowel Town,2011,40 - 44 years,1,1,2
Listowel Town,2011,45 - 49 years,0,0,0
Listowel Town,2011,5 - 9 years,0,1,1
Listowel Town,2011,50 - 54 years,0,1,1
Listowel Town,2011,55 - 59 years,0,2,2
Listowel Town,2011,60 - 64 years,2,1,3
Listowel Town,2011,65 - 69 years,1,0,1
Listowel Town,2011,70 - 74 years,1,4,5
Listowel Town,2011,75 - 79 years,3,3,6
Listowel Town,2011,80 - 84 years,3,1,4
Listowel Town,2011,85 years and over,10,4,14
Listowel Town,2011,Under 1 year,1,0,1
Listowel Town,2012,1 - 4 years,0,0,0
Listowel Town,2012,10 - 14 years,0,0,0
Listowel Town,2012,15 - 19 years,0,0,0
Listowel Town,2012,20 - 24 years,0,0,0
Listowel Town,2012,25 - 29 years,0,0,0
Listowel Town,2012,30 - 34 years,0,0,0
Listowel Town,2012,35 - 39 years,0,0,0
Listowel Town,2012,40 - 44 years,1,1,2
Listowel Town,2012,45 - 49 years,0,1,1
Listowel Town,2012,5 - 9 years,0,1,1
Listowel Town,2012,50 - 54 years,1,1,2
Listowel Town,2012,55 - 59 years,0,1,1
Listowel Town,2012,60 - 64 years,1,2,3
Listowel Town,2012,65 - 69 years,1,1,2
Listowel Town,2012,70 - 74 years,1,1,2
Listowel Town,2012,75 - 79 years,3,6,9
Listowel Town,2012,80 - 84 years,3,7,10
Listowel Town,2012,85 years and over,17,6,23
Listowel Town,2012,Under 1 year,1,0,1
Listowel Town,2013,1 - 4 years,0,0,0
Listowel Town,2013,10 - 14 years,0,0,0
Listowel Town,2013,15 - 19 years,0,0,0
Listowel Town,2013,20 - 24 years,0,0,0
Listowel Town,2013,25 - 29 years,0,0,0
Listowel Town,2013,30 - 34 years,0,0,0
Listowel Town,2013,35 - 39 years,0,0,0
Listowel Town,2013,40 - 44 years,0,0,0
Listowel Town,2013,45 - 49 years,0,2,2
Listowel Town,2013,5 - 9 years,0,0,0
Listowel Town,2013,50 - 54 years,0,1,1
Listowel Town,2013,55 - 59 years,0,1,1
Listowel Town,2013,60 - 64 years,2,0,2
Listowel Town,2013,65 - 69 years,0,2,2
Listowel Town,2013,70 - 74 years,0,3,3
Listowel Town,2013,75 - 79 years,6,6,12
Listowel Town,2013,80 - 84 years,2,2,4
Listowel Town,2013,85 years and over,16,7,23
Listowel Town,2013,Under 1 year,0,1,1
Listowel Town,2014,1 - 4 years,0,0,0
Listowel Town,2014,10 - 14 years,0,0,0
Listowel Town,2014,15 - 19 years,0,0,0
Listowel Town,2014,20 - 24 years,0,1,1
Listowel Town,2014,25 - 29 years,0,0,0
Listowel Town,2014,30 - 34 years,0,0,0
Listowel Town,2014,35 - 39 years,0,0,0
Listowel Town,2014,40 - 44 years,0,0,0
Listowel Town,2014,45 - 49 years,0,2,2
Listowel Town,2014,5 - 9 years,0,0,0
Listowel Town,2014,50 - 54 years,0,1,1
Listowel Town,2014,55 - 59 years,0,1,1
Listowel Town,2014,60 - 64 years,1,1,2
Listowel Town,2014,65 - 69 years,2,2,4
Listowel Town,2014,70 - 74 years,0,1,1
Listowel Town,2014,75 - 79 years,2,3,5
Listowel Town,2014,80 - 84 years,7,5,12
Listowel Town,2014,85 years and over,3,3,6
Listowel Town,2014,Under 1 year,0,1,1
Listowel Town,2015,1 - 4 years,0,0,0
Listowel Town,2015,10 - 14 years,0,0,0
Listowel Town,2015,15 - 19 years,0,0,0
Listowel Town,2015,20 - 24 years,0,1,1
Listowel Town,2015,25 - 29 years,0,0,0
Listowel Town,2015,30 - 34 years,0,0,0
Listowel Town,2015,35 - 39 years,0,0,0
Listowel Town,2015,40 - 44 years,0,0,0
Listowel Town,2015,45 - 49 years,0,2,2
Listowel Town,2015,5 - 9 years,0,0,0
Listowel Town,2015,50 - 54 years,0,1,1
Listowel Town,2015,55 - 59 years,0,1,1
Listowel Town,2015,60 - 64 years,1,1,2
Listowel Town,2015,65 - 69 years,2,2,4
Listowel Town,2015,70 - 74 years,0,1,1
Listowel Town,2015,75 - 79 years,2,3,5
Listowel Town,2015,80 - 84 years,7,5,12
Listowel Town,2015,85 years and over,3,3,6
Listowel Town,2015,Under 1 year,0,1,1
Listowel Town,2016,1 - 4 years,0,0,0
Listowel Town,2016,10 - 14 years,0,0,0
Listowel Town,2016,15 - 19 years,0,0,0
Listowel Town,2016,20 - 24 years,0,1,1
Listowel Town,2016,25 - 29 years,0,0,0
Listowel Town,2016,30 - 34 years,0,0,0
Listowel Town,2016,35 - 39 years,0,0,0
Listowel Town,2016,40 - 44 years,0,0,0
Listowel Town,2016,45 - 49 years,0,2,2
Listowel Town,2016,5 - 9 years,0,0,0
Listowel Town,2016,50 - 54 years,0,1,1
Listowel Town,2016,55 - 59 years,0,1,1
Listowel Town,2016,60 - 64 years,1,1,2
Listowel Town,2016,65 - 69 years,2,2,4
Listowel Town,2016,70 - 74 years,0,1,1
Listowel Town,2016,75 - 79 years,2,3,5
Listowel Town,2016,80 - 84 years,7,5,12
Listowel Town,2016,85 years and over,3,3,6
Listowel Town,2016,Under 1 year,0,1,1
Listowel Town,2017,1 - 4 years,0,0,0
Listowel Town,2017,10 - 14 years,0,0,0
Listowel Town,2017,15 - 19 years,0,0,0
Listowel Town,2017,20 - 24 years,0,1,1
Listowel Town,2017,25 - 29 years,1,0,1
Listowel Town,2017,30 - 34 years,0,1,1
Listowel Town,2017,35 - 39 years,0,0,0
Listowel Town,2017,40 - 44 years,0,0,0
Listowel Town,2017,45 - 49 years,0,1,1
Listowel Town,2017,5 - 9 years,0,0,0
Listowel Town,2017,50 - 54 years,0,1,1
Listowel Town,2017,55 - 59 years,0,1,1
Listowel Town,2017,60 - 64 years,1,1,2
Listowel Town,2017,65 - 69 years,4,1,5
Listowel Town,2017,70 - 74 years,1,1,2
Listowel Town,2017,75 - 79 years,1,8,9
Listowel Town,2017,80 - 84 years,7,2,9
Listowel Town,2017,85 years and over,9,2,11
Listowel Town,2017,Under 1 year,0,1,1
Listowel Town,2018,1 - 4 years,0,0,0
Listowel Town,2018,10 - 14 years,0,0,0
Listowel Town,2018,15 - 19 years,0,0,0
Listowel Town,2018,20 - 24 years,0,0,0
Listowel Town,2018,25 - 29 years,0,0,0
Listowel Town,2018,30 - 34 years,0,1,1
Listowel Town,2018,35 - 39 years,2,0,2
Listowel Town,2018,40 - 44 years,0,1,1
Listowel Town,2018,45 - 49 years,0,0,0
Listowel Town,2018,5 - 9 years,0,0,0
Listowel Town,2018,50 - 54 years,0,1,1
Listowel Town,2018,55 - 59 years,0,1,1
Listowel Town,2018,60 - 64 years,2,2,4
Listowel Town,2018,65 - 69 years,0,2,2
Listowel Town,2018,70 - 74 years,3,3,6
Listowel Town,2018,75 - 79 years,1,7,8
Listowel Town,2018,80 - 84 years,3,5,8
Listowel Town,2018,85 years and over,8,4,12
Listowel Town,2018,Under 1 year,0,0,0
Listowel Town,2019,1 - 4 years,0,0,0
Listowel Town,2019,10 - 14 years,0,0,0
Listowel Town,2019,15 - 19 years,0,0,0
Listowel Town,2019,20 - 24 years,0,0,0
Listowel Town,2019,25 - 29 years,0,0,0
Listowel Town,2019,30 - 34 years,0,1,1
Listowel Town,2019,35 - 39 years,2,0,2
Listowel Town,2019,40 - 44 years,0,1,1
Listowel Town,2019,45 - 49 years,0,0,0
Listowel Town,2019,5 - 9 years,0,0,0
Listowel Town,2019,50 - 54 years,0,1,1
Listowel Town,2019,55 - 59 years,0,1,1
Listowel Town,2019,60 - 64 years,2,2,4
Listowel Town,2019,65 - 69 years,0,2,2
Listowel Town,2019,70 - 74 years,3,3,6
Listowel Town,2019,75 - 79 years,1,7,8
Listowel Town,2019,80 - 84 years,3,5,8
Listowel Town,2019,85 years and over,8,4,12
Listowel Town,2019,Under 1 year,0,0,0
Listowel Town,2020,1 - 4 years,0,0,0
Listowel Town,2020,10 - 14 years,0,0,0
Listowel Town,2020,15 - 19 years,0,0,0
Listowel Town,2020,20 - 24 years,0,0,0
Listowel Town,2020,25 - 29 years,0,0,0
Listowel Town,2020,30 - 34 years,0,1,1
Listowel Town,2020,35 - 39 years,2,0,2
Listowel Town,2020,40 - 44 years,0,1,1
Listowel Town,2020,45 - 49 years,0,0,0
Listowel Town,2020,5 - 9 years,0,0,0
Listowel Town,2020,50 - 54 years,0,1,1
Listowel Town,2020,55 - 59 years,0,1,1
Listowel Town,2020,60 - 64 years,2,2,4
Listowel Town,2020,65 - 69 years,0,2,2
Listowel Town,2020,70 - 74 years,3,3,6
Listowel Town,2020,75 - 79 years,1,7,8
Listowel Town,2020,80 - 84 years,3,5,8
Listowel Town,2020,85 years and over,8,4,12
Listowel Town,2020,Under 1 year,0,0,0
Longford,2007,1 - 4 years,0,0,0
Longford,2007,10 - 14 years,0,1,1
Longford,2007,15 - 19 years,1,0,1
Longford,2007,20 - 24 years,1,1,2
Longford,2007,25 - 29 years,0,1,1
Longford,2007,30 - 34 years,0,3,3
Longford,2007,35 - 39 years,3,1,4
Longford,2007,40 - 44 years,0,3,3
Longford,2007,45 - 49 years,0,3,3
Longford,2007,5 - 9 years,0,0,0
Longford,2007,50 - 54 years,2,9,11
Longford,2007,55 - 59 years,3,6,9
Longford,2007,60 - 64 years,9,12,21
Longford,2007,65 - 69 years,7,14,21
Longford,2007,70 - 74 years,20,24,44
Longford,2007,75 - 79 years,18,20,38
Longford,2007,80 - 84 years,31,30,61
Longford,2007,85 years and over,63,37,100
Longford,2007,Under 1 year,1,2,3
Longford,2008,1 - 4 years,0,1,1
Longford,2008,10 - 14 years,0,1,1
Longford,2008,15 - 19 years,1,0,1
Longford,2008,20 - 24 years,1,3,4
Longford,2008,25 - 29 years,2,1,3
Longford,2008,30 - 34 years,2,2,4
Longford,2008,35 - 39 years,1,1,2
Longford,2008,40 - 44 years,2,3,5
Longford,2008,45 - 49 years,1,1,2
Longford,2008,5 - 9 years,0,0,0
Longford,2008,50 - 54 years,7,3,10
Longford,2008,55 - 59 years,6,7,13
Longford,2008,60 - 64 years,6,7,13
Longford,2008,65 - 69 years,5,20,25
Longford,2008,70 - 74 years,5,20,25
Longford,2008,75 - 79 years,12,22,34
Longford,2008,80 - 84 years,42,20,62
Longford,2008,85 years and over,51,26,77
Longford,2008,Under 1 year,1,3,4
Longford,2009,1 - 4 years,1,1,2
Longford,2009,10 - 14 years,0,1,1
Longford,2009,15 - 19 years,1,0,1
Longford,2009,20 - 24 years,1,1,2
Longford,2009,25 - 29 years,2,1,3
Longford,2009,30 - 34 years,2,2,4
Longford,2009,35 - 39 years,1,1,2
Longford,2009,40 - 44 years,5,1,6
Longford,2009,45 - 49 years,4,1,5
Longford,2009,5 - 9 years,1,0,1
Longford,2009,50 - 54 years,7,8,15
Longford,2009,55 - 59 years,4,6,10
Longford,2009,60 - 64 years,6,9,15
Longford,2009,65 - 69 years,6,14,20
Longford,2009,70 - 74 years,4,15,19
Longford,2009,75 - 79 years,18,22,40
Longford,2009,80 - 84 years,37,28,65
Longford,2009,85 years and over,73,32,105
Longford,2009,Under 1 year,1,3,4
Longford,2010,1 - 4 years,1,1,2
Longford,2010,10 - 14 years,0,1,1
Longford,2010,15 - 19 years,1,1,2
Longford,2010,20 - 24 years,1,3,4
Longford,2010,25 - 29 years,2,1,3
Longford,2010,30 - 34 years,1,2,3
Longford,2010,35 - 39 years,1,1,2
Longford,2010,40 - 44 years,1,3,4
Longford,2010,45 - 49 years,4,2,6
Longford,2010,5 - 9 years,1,0,1
Longford,2010,50 - 54 years,3,1,4
Longford,2010,55 - 59 years,6,5,11
Longford,2010,60 - 64 years,8,6,14
Longford,2010,65 - 69 years,7,12,19
Longford,2010,70 - 74 years,9,15,24
Longford,2010,75 - 79 years,12,27,39
Longford,2010,80 - 84 years,26,22,48
Longford,2010,85 years and over,66,33,99
Longford,2010,Under 1 year,2,1,3
Longford,2011,1 - 4 years,0,0,0
Longford,2011,10 - 14 years,1,1,2
Longford,2011,15 - 19 years,0,0,0
Longford,2011,20 - 24 years,0,1,1
Longford,2011,25 - 29 years,1,1,2
Longford,2011,30 - 34 years,0,2,2
Longford,2011,35 - 39 years,2,2,4
Longford,2011,40 - 44 years,2,3,5
Longford,2011,45 - 49 years,2,7,9
Longford,2011,5 - 9 years,0,0,0
Longford,2011,50 - 54 years,0,5,5
Longford,2011,55 - 59 years,10,6,16
Longford,2011,60 - 64 years,7,6,13
Longford,2011,65 - 69 years,10,13,23
Longford,2011,70 - 74 years,8,9,17
Longford,2011,75 - 79 years,16,25,41
Longford,2011,80 - 84 years,26,16,42
Longford,2011,85 years and over,51,31,82
Longford,2011,Under 1 year,1,0,1
Longford,2012,1 - 4 years,0,0,0
Longford,2012,10 - 14 years,1,1,2
Longford,2012,15 - 19 years,0,0,0
Longford,2012,20 - 24 years,0,1,1
Longford,2012,25 - 29 years,2,1,3
Longford,2012,30 - 34 years,0,2,2
Longford,2012,35 - 39 years,2,4,6
Longford,2012,40 - 44 years,1,2,3
Longford,2012,45 - 49 years,2,4,6
Longford,2012,5 - 9 years,0,0,0
Longford,2012,50 - 54 years,1,4,5
Longford,2012,55 - 59 years,4,9,13
Longford,2012,60 - 64 years,8,13,21
Longford,2012,65 - 69 years,9,11,20
Longford,2012,70 - 74 years,9,23,32
Longford,2012,75 - 79 years,16,27,43
Longford,2012,80 - 84 years,19,28,47
Longford,2012,85 years and over,54,44,98
Longford,2012,Under 1 year,1,0,1
Longford,2013,1 - 4 years,1,0,1
Longford,2013,10 - 14 years,0,0,0
Longford,2013,15 - 19 years,0,0,0
Longford,2013,20 - 24 years,0,0,0
Longford,2013,25 - 29 years,0,1,1
Longford,2013,30 - 34 years,0,0,0
Longford,2013,35 - 39 years,0,5,5
Longford,2013,40 - 44 years,2,2,4
Longford,2013,45 - 49 years,1,5,6
Longford,2013,5 - 9 years,0,0,0
Longford,2013,50 - 54 years,3,4,7
Longford,2013,55 - 59 years,4,9,13
Longford,2013,60 - 64 years,5,11,16
Longford,2013,65 - 69 years,8,13,21
Longford,2013,70 - 74 years,9,8,17
Longford,2013,75 - 79 years,26,25,51
Longford,2013,80 - 84 years,22,31,53
Longford,2013,85 years and over,56,37,93
Longford,2013,Under 1 year,1,1,2
Longford,2014,1 - 4 years,1,0,1
Longford,2014,10 - 14 years,1,0,1
Longford,2014,15 - 19 years,0,1,1
Longford,2014,20 - 24 years,0,3,3
Longford,2014,25 - 29 years,0,1,1
Longford,2014,30 - 34 years,1,0,1
Longford,2014,35 - 39 years,1,1,2
Longford,2014,40 - 44 years,3,2,5
Longford,2014,45 - 49 years,3,5,8
Longford,2014,5 - 9 years,0,0,0
Longford,2014,50 - 54 years,4,3,7
Longford,2014,55 - 59 years,3,9,12
Longford,2014,60 - 64 years,6,7,13
Longford,2014,65 - 69 years,10,15,25
Longford,2014,70 - 74 years,6,18,24
Longford,2014,75 - 79 years,15,16,31
Longford,2014,80 - 84 years,15,25,40
Longford,2014,85 years and over,53,34,87
Longford,2014,Under 1 year,3,1,4
Longford,2015,1 - 4 years,1,0,1
Longford,2015,10 - 14 years,1,0,1
Longford,2015,15 - 19 years,0,1,1
Longford,2015,20 - 24 years,0,3,3
Longford,2015,25 - 29 years,0,3,3
Longford,2015,30 - 34 years,2,0,2
Longford,2015,35 - 39 years,1,3,4
Longford,2015,40 - 44 years,1,2,3
Longford,2015,45 - 49 years,1,2,3
Longford,2015,5 - 9 years,0,0,0
Longford,2015,50 - 54 years,3,6,9
Longford,2015,55 - 59 years,10,6,16
Longford,2015,60 - 64 years,5,10,15
Longford,2015,65 - 69 years,8,14,22
Longford,2015,70 - 74 years,10,27,37
Longford,2015,75 - 79 years,9,26,35
Longford,2015,80 - 84 years,18,28,46
Longford,2015,85 years and over,63,34,97
Longford,2015,Under 1 year,1,1,2
Longford,2016,1 - 4 years,1,0,1
Longford,2016,10 - 14 years,1,0,1
Longford,2016,15 - 19 years,0,1,1
Longford,2016,20 - 24 years,0,1,1
Longford,2016,25 - 29 years,0,1,1
Longford,2016,30 - 34 years,2,0,2
Longford,2016,35 - 39 years,1,1,2
Longford,2016,40 - 44 years,3,2,5
Longford,2016,45 - 49 years,1,3,4
Longford,2016,5 - 9 years,0,0,0
Longford,2016,50 - 54 years,2,2,4
Longford,2016,55 - 59 years,3,6,9
Longford,2016,60 - 64 years,8,16,24
Longford,2016,65 - 69 years,9,9,18
Longford,2016,70 - 74 years,10,17,27
Longford,2016,75 - 79 years,8,13,21
Longford,2016,80 - 84 years,22,27,49
Longford,2016,85 years and over,66,47,113
Longford,2016,Under 1 year,1,2,3
Longford,2017,1 - 4 years,1,0,1
Longford,2017,10 - 14 years,1,0,1
Longford,2017,15 - 19 years,1,1,2
Longford,2017,20 - 24 years,0,1,1
Longford,2017,25 - 29 years,2,1,3
Longford,2017,30 - 34 years,2,1,3
Longford,2017,35 - 39 years,1,1,2
Longford,2017,40 - 44 years,3,5,8
Longford,2017,45 - 49 years,1,1,2
Longford,2017,5 - 9 years,0,0,0
Longford,2017,50 - 54 years,3,2,5
Longford,2017,55 - 59 years,4,4,8
Longford,2017,60 - 64 years,8,12,20
Longford,2017,65 - 69 years,10,16,26
Longford,2017,70 - 74 years,13,20,33
Longford,2017,75 - 79 years,24,10,34
Longford,2017,80 - 84 years,25,22,47
Longford,2017,85 years and over,61,40,101
Longford,2017,Under 1 year,2,2,4
Longford,2018,1 - 4 years,1,0,1
Longford,2018,10 - 14 years,0,1,1
Longford,2018,15 - 19 years,0,1,1
Longford,2018,20 - 24 years,0,0,0
Longford,2018,25 - 29 years,2,1,3
Longford,2018,30 - 34 years,2,0,2
Longford,2018,35 - 39 years,1,1,2
Longford,2018,40 - 44 years,1,0,1
Longford,2018,45 - 49 years,4,1,5
Longford,2018,5 - 9 years,0,1,1
Longford,2018,50 - 54 years,3,4,7
Longford,2018,55 - 59 years,3,7,10
Longford,2018,60 - 64 years,6,12,18
Longford,2018,65 - 69 years,10,15,25
Longford,2018,70 - 74 years,11,17,28
Longford,2018,75 - 79 years,10,26,36
Longford,2018,80 - 84 years,23,21,44
Longford,2018,85 years and over,49,40,89
Longford,2018,Under 1 year,0,0,0
Longford,2019,1 - 4 years,1,0,1
Longford,2019,10 - 14 years,0,0,0
Longford,2019,15 - 19 years,0,1,1
Longford,2019,20 - 24 years,0,0,0
Longford,2019,25 - 29 years,1,1,2
Longford,2019,30 - 34 years,2,0,2
Longford,2019,35 - 39 years,0,2,2
Longford,2019,40 - 44 years,1,4,5
Longford,2019,45 - 49 years,2,0,2
Longford,2019,5 - 9 years,0,0,0
Longford,2019,50 - 54 years,2,6,8
Longford,2019,55 - 59 years,5,10,15
Longford,2019,60 - 64 years,6,9,15
Longford,2019,65 - 69 years,9,18,27
Longford,2019,70 - 74 years,11,24,35
Longford,2019,75 - 79 years,16,16,32
Longford,2019,80 - 84 years,12,29,41
Longford,2019,85 years and over,51,39,90
Longford,2019,Under 1 year,3,0,3
Longford,2020,1 - 4 years,1,0,1
Longford,2020,10 - 14 years,0,0,0
Longford,2020,15 - 19 years,0,1,1
Longford,2020,20 - 24 years,0,1,1
Longford,2020,25 - 29 years,1,1,2
Longford,2020,30 - 34 years,1,0,1
Longford,2020,35 - 39 years,1,2,3
Longford,2020,40 - 44 years,2,3,5
Longford,2020,45 - 49 years,1,2,3
Longford,2020,5 - 9 years,0,0,0
Longford,2020,50 - 54 years,2,5,7
Longford,2020,55 - 59 years,4,10,14
Longford,2020,60 - 64 years,8,5,13
Longford,2020,65 - 69 years,7,19,26
Longford,2020,70 - 74 years,9,19,28
Longford,2020,75 - 79 years,14,22,36
Longford,2020,80 - 84 years,13,27,40
Longford,2020,85 years and over,52,41,93
Longford,2020,Under 1 year,2,2,4
Longford town,2007,1 - 4 years,0,0,0
Longford town,2007,10 - 14 years,0,0,0
Longford town,2007,15 - 19 years,0,0,0
Longford town,2007,20 - 24 years,1,0,1
Longford town,2007,25 - 29 years,0,0,0
Longford town,2007,30 - 34 years,0,0,0
Longford town,2007,35 - 39 years,2,0,2
Longford town,2007,40 - 44 years,0,1,1
Longford town,2007,45 - 49 years,0,0,0
Longford town,2007,5 - 9 years,0,0,0
Longford town,2007,50 - 54 years,0,2,2
Longford town,2007,55 - 59 years,0,1,1
Longford town,2007,60 - 64 years,2,4,6
Longford town,2007,65 - 69 years,1,2,3
Longford town,2007,70 - 74 years,5,3,8
Longford town,2007,75 - 79 years,6,5,11
Longford town,2007,80 - 84 years,7,6,13
Longford town,2007,85 years and over,10,6,16
Longford town,2007,Under 1 year,0,0,0
Longford town,2008,1 - 4 years,0,1,1
Longford town,2008,10 - 14 years,0,0,0
Longford town,2008,15 - 19 years,0,0,0
Longford town,2008,20 - 24 years,1,0,1
Longford town,2008,25 - 29 years,2,0,2
Longford town,2008,30 - 34 years,0,0,0
Longford town,2008,35 - 39 years,2,0,2
Longford town,2008,40 - 44 years,0,1,1
Longford town,2008,45 - 49 years,0,0,0
Longford town,2008,5 - 9 years,0,0,0
Longford town,2008,50 - 54 years,1,2,3
Longford town,2008,55 - 59 years,1,2,3
Longford town,2008,60 - 64 years,2,1,3
Longford town,2008,65 - 69 years,1,4,5
Longford town,2008,70 - 74 years,1,5,6
Longford town,2008,75 - 79 years,3,3,6
Longford town,2008,80 - 84 years,10,3,13
Longford town,2008,85 years and over,8,3,11
Longford town,2008,Under 1 year,1,0,1
Longford town,2009,1 - 4 years,1,1,2
Longford town,2009,10 - 14 years,0,0,0
Longford town,2009,15 - 19 years,0,0,0
Longford town,2009,20 - 24 years,1,0,1
Longford town,2009,25 - 29 years,2,0,2
Longford town,2009,30 - 34 years,0,1,1
Longford town,2009,35 - 39 years,2,0,2
Longford town,2009,40 - 44 years,0,1,1
Longford town,2009,45 - 49 years,1,0,1
Longford town,2009,5 - 9 years,1,0,1
Longford town,2009,50 - 54 years,1,1,2
Longford town,2009,55 - 59 years,1,1,2
Longford town,2009,60 - 64 years,2,1,3
Longford town,2009,65 - 69 years,2,3,5
Longford town,2009,70 - 74 years,2,4,6
Longford town,2009,75 - 79 years,3,3,6
Longford town,2009,80 - 84 years,8,2,10
Longford town,2009,85 years and over,12,5,17
Longford town,2009,Under 1 year,1,0,1
Longford town,2010,1 - 4 years,1,1,2
Longford town,2010,10 - 14 years,0,0,0
Longford town,2010,15 - 19 years,0,0,0
Longford town,2010,20 - 24 years,1,1,2
Longford town,2010,25 - 29 years,2,0,2
Longford town,2010,30 - 34 years,0,1,1
Longford town,2010,35 - 39 years,2,1,3
Longford town,2010,40 - 44 years,0,2,2
Longford town,2010,45 - 49 years,1,0,1
Longford town,2010,5 - 9 years,1,0,1
Longford town,2010,50 - 54 years,1,1,2
Longford town,2010,55 - 59 years,1,1,2
Longford town,2010,60 - 64 years,3,1,4
Longford town,2010,65 - 69 years,2,5,7
Longford town,2010,70 - 74 years,2,2,4
Longford town,2010,75 - 79 years,2,7,9
Longford town,2010,80 - 84 years,4,4,8
Longford town,2010,85 years and over,11,5,16
Longford town,2010,Under 1 year,1,0,1
Longford town,2011,1 - 4 years,0,0,0
Longford town,2011,10 - 14 years,1,0,1
Longford town,2011,15 - 19 years,0,0,0
Longford town,2011,20 - 24 years,0,1,1
Longford town,2011,25 - 29 years,0,1,1
Longford town,2011,30 - 34 years,0,1,1
Longford town,2011,35 - 39 years,1,2,3
Longford town,2011,40 - 44 years,0,1,1
Longford town,2011,45 - 49 years,0,3,3
Longford town,2011,5 - 9 years,0,0,0
Longford town,2011,50 - 54 years,0,0,0
Longford town,2011,55 - 59 years,2,0,2
Longford town,2011,60 - 64 years,4,1,5
Longford town,2011,65 - 69 years,2,1,3
Longford town,2011,70 - 74 years,3,4,7
Longford town,2011,75 - 79 years,3,8,11
Longford town,2011,80 - 84 years,2,3,5
Longford town,2011,85 years and over,11,3,14
Longford town,2011,Under 1 year,0,0,0
Longford town,2012,1 - 4 years,0,0,0
Longford town,2012,10 - 14 years,1,0,1
Longford town,2012,15 - 19 years,0,0,0
Longford town,2012,20 - 24 years,0,1,1
Longford town,2012,25 - 29 years,0,1,1
Longford town,2012,30 - 34 years,0,1,1
Longford town,2012,35 - 39 years,1,1,2
Longford town,2012,40 - 44 years,0,1,1
Longford town,2012,45 - 49 years,1,1,2
Longford town,2012,5 - 9 years,0,0,0
Longford town,2012,50 - 54 years,0,0,0
Longford town,2012,55 - 59 years,1,0,1
Longford town,2012,60 - 64 years,1,5,6
Longford town,2012,65 - 69 years,2,1,3
Longford town,2012,70 - 74 years,4,5,9
Longford town,2012,75 - 79 years,4,5,9
Longford town,2012,80 - 84 years,5,7,12
Longford town,2012,85 years and over,11,9,20
Longford town,2012,Under 1 year,1,0,1
Longford town,2013,1 - 4 years,1,0,1
Longford town,2013,10 - 14 years,0,0,0
Longford town,2013,15 - 19 years,0,0,0
Longford town,2013,20 - 24 years,0,0,0
Longford town,2013,25 - 29 years,0,0,0
Longford town,2013,30 - 34 years,0,0,0
Longford town,2013,35 - 39 years,0,1,1
Longford town,2013,40 - 44 years,1,0,1
Longford town,2013,45 - 49 years,0,2,2
Longford town,2013,5 - 9 years,0,0,0
Longford town,2013,50 - 54 years,1,1,2
Longford town,2013,55 - 59 years,1,3,4
Longford town,2013,60 - 64 years,1,1,2
Longford town,2013,65 - 69 years,1,2,3
Longford town,2013,70 - 74 years,4,4,8
Longford town,2013,75 - 79 years,5,2,7
Longford town,2013,80 - 84 years,7,2,9
Longford town,2013,85 years and over,20,5,25
Longford town,2013,Under 1 year,1,0,1
Longford town,2014,1 - 4 years,1,0,1
Longford town,2014,10 - 14 years,0,0,0
Longford town,2014,15 - 19 years,0,1,1
Longford town,2014,20 - 24 years,0,1,1
Longford town,2014,25 - 29 years,0,0,0
Longford town,2014,30 - 34 years,0,0,0
Longford town,2014,35 - 39 years,0,1,1
Longford town,2014,40 - 44 years,3,0,3
Longford town,2014,45 - 49 years,0,4,4
Longford town,2014,5 - 9 years,0,0,0
Longford town,2014,50 - 54 years,1,1,2
Longford town,2014,55 - 59 years,1,5,6
Longford town,2014,60 - 64 years,1,1,2
Longford town,2014,65 - 69 years,3,5,8
Longford town,2014,70 - 74 years,3,7,10
Longford town,2014,75 - 79 years,5,1,6
Longford town,2014,80 - 84 years,2,6,8
Longford town,2014,85 years and over,9,8,17
Longford town,2014,Under 1 year,1,0,1
Longford town,2015,1 - 4 years,1,0,1
Longford town,2015,10 - 14 years,0,0,0
Longford town,2015,15 - 19 years,0,1,1
Longford town,2015,20 - 24 years,0,1,1
Longford town,2015,25 - 29 years,0,0,0
Longford town,2015,30 - 34 years,0,0,0
Longford town,2015,35 - 39 years,0,1,1
Longford town,2015,40 - 44 years,3,0,3
Longford town,2015,45 - 49 years,0,4,4
Longford town,2015,5 - 9 years,0,0,0
Longford town,2015,50 - 54 years,1,1,2
Longford town,2015,55 - 59 years,1,5,6
Longford town,2015,60 - 64 years,1,1,2
Longford town,2015,65 - 69 years,3,5,8
Longford town,2015,70 - 74 years,3,7,10
Longford town,2015,75 - 79 years,5,1,6
Longford town,2015,80 - 84 years,2,6,8
Longford town,2015,85 years and over,9,8,17
Longford town,2015,Under 1 year,1,0,1
Longford town,2016,1 - 4 years,1,0,1
Longford town,2016,10 - 14 years,0,0,0
Longford town,2016,15 - 19 years,0,1,1
Longford town,2016,20 - 24 years,0,1,1
Longford town,2016,25 - 29 years,0,0,0
Longford town,2016,30 - 34 years,0,0,0
Longford town,2016,35 - 39 years,0,1,1
Longford town,2016,40 - 44 years,3,0,3
Longford town,2016,45 - 49 years,0,4,4
Longford town,2016,5 - 9 years,0,0,0
Longford town,2016,50 - 54 years,1,1,2
Longford town,2016,55 - 59 years,1,5,6
Longford town,2016,60 - 64 years,1,1,2
Longford town,2016,65 - 69 years,3,5,8
Longford town,2016,70 - 74 years,3,7,10
Longford town,2016,75 - 79 years,5,1,6
Longford town,2016,80 - 84 years,2,6,8
Longford town,2016,85 years and over,9,8,17
Longford town,2016,Under 1 year,1,0,1
Longford town,2017,1 - 4 years,1,0,1
Longford town,2017,10 - 14 years,0,0,0
Longford town,2017,15 - 19 years,1,1,2
Longford town,2017,20 - 24 years,0,1,1
Longford town,2017,25 - 29 years,0,1,1
Longford town,2017,30 - 34 years,0,0,0
Longford town,2017,35 - 39 years,1,1,2
Longford town,2017,40 - 44 years,3,2,5
Longford town,2017,45 - 49 years,1,4,5
Longford town,2017,5 - 9 years,0,0,0
Longford town,2017,50 - 54 years,1,1,2
Longford town,2017,55 - 59 years,1,1,2
Longford town,2017,60 - 64 years,2,1,3
Longford town,2017,65 - 69 years,3,4,7
Longford town,2017,70 - 74 years,4,5,9
Longford town,2017,75 - 79 years,6,6,12
Longford town,2017,80 - 84 years,6,5,11
Longford town,2017,85 years and over,11,7,18
Longford town,2017,Under 1 year,1,0,1
Longford town,2018,1 - 4 years,1,0,1
Longford town,2018,10 - 14 years,0,0,0
Longford town,2018,15 - 19 years,0,0,0
Longford town,2018,20 - 24 years,0,0,0
Longford town,2018,25 - 29 years,0,0,0
Longford town,2018,30 - 34 years,0,0,0
Longford town,2018,35 - 39 years,1,1,2
Longford town,2018,40 - 44 years,0,0,0
Longford town,2018,45 - 49 years,1,1,2
Longford town,2018,5 - 9 years,0,1,1
Longford town,2018,50 - 54 years,0,0,0
Longford town,2018,55 - 59 years,2,3,5
Longford town,2018,60 - 64 years,1,4,5
Longford town,2018,65 - 69 years,7,2,9
Longford town,2018,70 - 74 years,3,9,12
Longford town,2018,75 - 79 years,1,10,11
Longford town,2018,80 - 84 years,5,0,5
Longford town,2018,85 years and over,12,4,16
Longford town,2018,Under 1 year,0,0,0
Longford town,2019,1 - 4 years,1,0,1
Longford town,2019,10 - 14 years,0,0,0
Longford town,2019,15 - 19 years,0,0,0
Longford town,2019,20 - 24 years,0,0,0
Longford town,2019,25 - 29 years,0,0,0
Longford town,2019,30 - 34 years,0,0,0
Longford town,2019,35 - 39 years,1,1,2
Longford town,2019,40 - 44 years,0,0,0
Longford town,2019,45 - 49 years,1,1,2
Longford town,2019,5 - 9 years,0,1,1
Longford town,2019,50 - 54 years,0,0,0
Longford town,2019,55 - 59 years,2,3,5
Longford town,2019,60 - 64 years,1,4,5
Longford town,2019,65 - 69 years,7,2,9
Longford town,2019,70 - 74 years,3,9,12
Longford town,2019,75 - 79 years,1,10,11
Longford town,2019,80 - 84 years,5,0,5
Longford town,2019,85 years and over,12,4,16
Longford town,2019,Under 1 year,0,0,0
Longford town,2020,1 - 4 years,1,0,1
Longford town,2020,10 - 14 years,0,0,0
Longford town,2020,15 - 19 years,0,0,0
Longford town,2020,20 - 24 years,0,0,0
Longford town,2020,25 - 29 years,0,0,0
Longford town,2020,30 - 34 years,0,0,0
Longford town,2020,35 - 39 years,1,1,2
Longford town,2020,40 - 44 years,0,0,0
Longford town,2020,45 - 49 years,1,1,2
Longford town,2020,5 - 9 years,0,1,1
Longford town,2020,50 - 54 years,0,0,0
Longford town,2020,55 - 59 years,2,3,5
Longford town,2020,60 - 64 years,1,4,5
Longford town,2020,65 - 69 years,7,2,9
Longford town,2020,70 - 74 years,3,9,12
Longford town,2020,75 - 79 years,1,10,11
Longford town,2020,80 - 84 years,5,0,5
Longford town,2020,85 years and over,12,4,16
Longford town,2020,Under 1 year,0,0,0
Louth,2007,1 - 4 years,0,0,0
Louth,2007,10 - 14 years,2,0,2
Louth,2007,15 - 19 years,1,2,3
Louth,2007,20 - 24 years,4,7,11
Louth,2007,25 - 29 years,0,10,10
Louth,2007,30 - 34 years,4,4,8
Louth,2007,35 - 39 years,3,10,13
Louth,2007,40 - 44 years,6,13,19
Louth,2007,45 - 49 years,4,13,17
Louth,2007,5 - 9 years,0,0,0
Louth,2007,50 - 54 years,13,14,27
Louth,2007,55 - 59 years,14,21,35
Louth,2007,60 - 64 years,21,27,48
Louth,2007,65 - 69 years,25,29,54
Louth,2007,70 - 74 years,36,43,79
Louth,2007,75 - 79 years,43,49,92
Louth,2007,80 - 84 years,85,57,142
Louth,2007,85 years and over,122,67,189
Louth,2007,Under 1 year,2,3,5
Louth,2008,1 - 4 years,0,0,0
Louth,2008,10 - 14 years,1,0,1
Louth,2008,15 - 19 years,1,2,3
Louth,2008,20 - 24 years,4,7,11
Louth,2008,25 - 29 years,1,9,10
Louth,2008,30 - 34 years,1,2,3
Louth,2008,35 - 39 years,5,5,10
Louth,2008,40 - 44 years,5,4,9
Louth,2008,45 - 49 years,7,13,20
Louth,2008,5 - 9 years,0,0,0
Louth,2008,50 - 54 years,7,16,23
Louth,2008,55 - 59 years,13,27,40
Louth,2008,60 - 64 years,10,31,41
Louth,2008,65 - 69 years,13,32,45
Louth,2008,70 - 74 years,26,39,65
Louth,2008,75 - 79 years,46,56,102
Louth,2008,80 - 84 years,74,61,135
Louth,2008,85 years and over,155,80,235
Louth,2008,Under 1 year,2,2,4
Louth,2009,1 - 4 years,2,3,5
Louth,2009,10 - 14 years,1,0,1
Louth,2009,15 - 19 years,1,2,3
Louth,2009,20 - 24 years,4,5,9
Louth,2009,25 - 29 years,1,5,6
Louth,2009,30 - 34 years,4,7,11
Louth,2009,35 - 39 years,3,8,11
Louth,2009,40 - 44 years,5,5,10
Louth,2009,45 - 49 years,9,7,16
Louth,2009,5 - 9 years,0,1,1
Louth,2009,50 - 54 years,10,18,28
Louth,2009,55 - 59 years,9,28,37
Louth,2009,60 - 64 years,19,34,53
Louth,2009,65 - 69 years,17,38,55
Louth,2009,70 - 74 years,24,46,70
Louth,2009,75 - 79 years,42,50,92
Louth,2009,80 - 84 years,75,53,128
Louth,2009,85 years and over,146,78,224
Louth,2009,Under 1 year,3,2,5
Louth,2010,1 - 4 years,2,3,5
Louth,2010,10 - 14 years,1,0,1
Louth,2010,15 - 19 years,2,3,5
Louth,2010,20 - 24 years,4,6,10
Louth,2010,25 - 29 years,2,3,5
Louth,2010,30 - 34 years,2,5,7
Louth,2010,35 - 39 years,2,9,11
Louth,2010,40 - 44 years,3,12,15
Louth,2010,45 - 49 years,5,8,13
Louth,2010,5 - 9 years,0,3,3
Louth,2010,50 - 54 years,9,7,16
Louth,2010,55 - 59 years,12,17,29
Louth,2010,60 - 64 years,17,23,40
Louth,2010,65 - 69 years,33,29,62
Louth,2010,70 - 74 years,32,38,70
Louth,2010,75 - 79 years,41,52,93
Louth,2010,80 - 84 years,55,60,115
Louth,2010,85 years and over,152,85,237
Louth,2010,Under 1 year,5,3,8
Louth,2011,1 - 4 years,2,1,3
Louth,2011,10 - 14 years,0,0,0
Louth,2011,15 - 19 years,1,1,2
Louth,2011,20 - 24 years,0,7,7
Louth,2011,25 - 29 years,2,5,7
Louth,2011,30 - 34 years,3,9,12
Louth,2011,35 - 39 years,6,12,18
Louth,2011,40 - 44 years,2,8,10
Louth,2011,45 - 49 years,5,10,15
Louth,2011,5 - 9 years,0,0,0
Louth,2011,50 - 54 years,12,6,18
Louth,2011,55 - 59 years,13,13,26
Louth,2011,60 - 64 years,24,27,51
Louth,2011,65 - 69 years,19,33,52
Louth,2011,70 - 74 years,29,40,69
Louth,2011,75 - 79 years,46,34,80
Louth,2011,80 - 84 years,58,55,113
Louth,2011,85 years and over,161,78,239
Louth,2011,Under 1 year,3,2,5
Louth,2012,1 - 4 years,1,1,2
Louth,2012,10 - 14 years,0,0,0
Louth,2012,15 - 19 years,1,1,2
Louth,2012,20 - 24 years,0,3,3
Louth,2012,25 - 29 years,1,1,2
Louth,2012,30 - 34 years,6,4,10
Louth,2012,35 - 39 years,4,6,10
Louth,2012,40 - 44 years,3,9,12
Louth,2012,45 - 49 years,8,14,22
Louth,2012,5 - 9 years,1,1,2
Louth,2012,50 - 54 years,12,16,28
Louth,2012,55 - 59 years,9,23,32
Louth,2012,60 - 64 years,12,23,35
Louth,2012,65 - 69 years,26,34,60
Louth,2012,70 - 74 years,16,39,55
Louth,2012,75 - 79 years,49,66,115
Louth,2012,80 - 84 years,64,54,118
Louth,2012,85 years and over,168,77,245
Louth,2012,Under 1 year,2,2,4
Louth,2013,1 - 4 years,0,0,0
Louth,2013,10 - 14 years,1,0,1
Louth,2013,15 - 19 years,0,1,1
Louth,2013,20 - 24 years,0,5,5
Louth,2013,25 - 29 years,2,2,4
Louth,2013,30 - 34 years,2,7,9
Louth,2013,35 - 39 years,1,10,11
Louth,2013,40 - 44 years,1,12,13
Louth,2013,45 - 49 years,4,10,14
Louth,2013,5 - 9 years,0,0,0
Louth,2013,50 - 54 years,17,13,30
Louth,2013,55 - 59 years,13,19,32
Louth,2013,60 - 64 years,10,27,37
Louth,2013,65 - 69 years,17,43,60
Louth,2013,70 - 74 years,26,61,87
Louth,2013,75 - 79 years,43,46,89
Louth,2013,80 - 84 years,61,56,117
Louth,2013,85 years and over,160,67,227
Louth,2013,Under 1 year,2,0,2
Louth,2014,1 - 4 years,0,0,0
Louth,2014,10 - 14 years,1,1,2
Louth,2014,15 - 19 years,0,1,1
Louth,2014,20 - 24 years,2,4,6
Louth,2014,25 - 29 years,1,1,2
Louth,2014,30 - 34 years,1,7,8
Louth,2014,35 - 39 years,2,8,10
Louth,2014,40 - 44 years,6,10,16
Louth,2014,45 - 49 years,6,6,12
Louth,2014,5 - 9 years,1,0,1
Louth,2014,50 - 54 years,9,13,22
Louth,2014,55 - 59 years,11,18,29
Louth,2014,60 - 64 years,14,30,44
Louth,2014,65 - 69 years,20,31,51
Louth,2014,70 - 74 years,28,43,71
Louth,2014,75 - 79 years,47,57,104
Louth,2014,80 - 84 years,46,59,105
Louth,2014,85 years and over,158,70,228
Louth,2014,Under 1 year,2,7,9
Louth,2015,1 - 4 years,0,0,0
Louth,2015,10 - 14 years,1,1,2
Louth,2015,15 - 19 years,0,2,2
Louth,2015,20 - 24 years,2,2,4
Louth,2015,25 - 29 years,2,3,5
Louth,2015,30 - 34 years,3,3,6
Louth,2015,35 - 39 years,3,8,11
Louth,2015,40 - 44 years,3,9,12
Louth,2015,45 - 49 years,7,8,15
Louth,2015,5 - 9 years,1,2,3
Louth,2015,50 - 54 years,12,13,25
Louth,2015,55 - 59 years,8,9,17
Louth,2015,60 - 64 years,17,27,44
Louth,2015,65 - 69 years,30,32,62
Louth,2015,70 - 74 years,27,48,75
Louth,2015,75 - 79 years,43,73,116
Louth,2015,80 - 84 years,66,58,124
Louth,2015,85 years and over,190,103,293
Louth,2015,Under 1 year,2,4,6
Louth,2016,1 - 4 years,0,0,0
Louth,2016,10 - 14 years,1,1,2
Louth,2016,15 - 19 years,0,2,2
Louth,2016,20 - 24 years,2,3,5
Louth,2016,25 - 29 years,2,2,4
Louth,2016,30 - 34 years,1,4,5
Louth,2016,35 - 39 years,1,5,6
Louth,2016,40 - 44 years,2,6,8
Louth,2016,45 - 49 years,8,10,18
Louth,2016,5 - 9 years,1,2,3
Louth,2016,50 - 54 years,7,13,20
Louth,2016,55 - 59 years,19,14,33
Louth,2016,60 - 64 years,25,20,45
Louth,2016,65 - 69 years,26,39,65
Louth,2016,70 - 74 years,35,45,80
Louth,2016,75 - 79 years,44,48,92
Louth,2016,80 - 84 years,50,64,114
Louth,2016,85 years and over,165,101,266
Louth,2016,Under 1 year,1,1,2
Louth,2017,1 - 4 years,1,0,1
Louth,2017,10 - 14 years,1,1,2
Louth,2017,15 - 19 years,1,1,2
Louth,2017,20 - 24 years,2,2,4
Louth,2017,25 - 29 years,1,2,3
Louth,2017,30 - 34 years,1,6,7
Louth,2017,35 - 39 years,1,7,8
Louth,2017,40 - 44 years,2,10,12
Louth,2017,45 - 49 years,7,9,16
Louth,2017,5 - 9 years,1,2,3
Louth,2017,50 - 54 years,9,15,24
Louth,2017,55 - 59 years,15,13,28
Louth,2017,60 - 64 years,13,19,32
Louth,2017,65 - 69 years,28,31,59
Louth,2017,70 - 74 years,42,54,96
Louth,2017,75 - 79 years,44,63,107
Louth,2017,80 - 84 years,70,75,145
Louth,2017,85 years and over,169,93,262
Louth,2017,Under 1 year,3,6,9
Louth,2018,1 - 4 years,2,0,2
Louth,2018,10 - 14 years,0,1,1
Louth,2018,15 - 19 years,0,1,1
Louth,2018,20 - 24 years,1,2,3
Louth,2018,25 - 29 years,0,2,2
Louth,2018,30 - 34 years,5,3,8
Louth,2018,35 - 39 years,3,7,10
Louth,2018,40 - 44 years,8,5,13
Louth,2018,45 - 49 years,8,9,17
Louth,2018,5 - 9 years,0,0,0
Louth,2018,50 - 54 years,9,15,24
Louth,2018,55 - 59 years,12,12,24
Louth,2018,60 - 64 years,18,31,49
Louth,2018,65 - 69 years,28,33,61
Louth,2018,70 - 74 years,36,57,93
Louth,2018,75 - 79 years,51,62,113
Louth,2018,80 - 84 years,65,58,123
Louth,2018,85 years and over,162,92,254
Louth,2018,Under 1 year,2,4,6
Louth,2019,1 - 4 years,2,0,2
Louth,2019,10 - 14 years,0,3,3
Louth,2019,15 - 19 years,0,3,3
Louth,2019,20 - 24 years,1,2,3
Louth,2019,25 - 29 years,2,4,6
Louth,2019,30 - 34 years,5,3,8
Louth,2019,35 - 39 years,2,6,8
Louth,2019,40 - 44 years,6,5,11
Louth,2019,45 - 49 years,6,8,14
Louth,2019,5 - 9 years,1,1,2
Louth,2019,50 - 54 years,16,10,26
Louth,2019,55 - 59 years,15,18,33
Louth,2019,60 - 64 years,14,42,56
Louth,2019,65 - 69 years,19,27,46
Louth,2019,70 - 74 years,37,44,81
Louth,2019,75 - 79 years,45,53,98
Louth,2019,80 - 84 years,68,72,140
Louth,2019,85 years and over,189,102,291
Louth,2019,Under 1 year,1,6,7
Louth,2020,1 - 4 years,2,0,2
Louth,2020,10 - 14 years,0,3,3
Louth,2020,15 - 19 years,2,1,3
Louth,2020,20 - 24 years,1,2,3
Louth,2020,25 - 29 years,2,4,6
Louth,2020,30 - 34 years,5,1,6
Louth,2020,35 - 39 years,3,2,5
Louth,2020,40 - 44 years,6,2,8
Louth,2020,45 - 49 years,9,5,14
Louth,2020,5 - 9 years,1,1,2
Louth,2020,50 - 54 years,11,12,23
Louth,2020,55 - 59 years,15,22,37
Louth,2020,60 - 64 years,17,22,39
Louth,2020,65 - 69 years,28,35,63
Louth,2020,70 - 74 years,47,54,101
Louth,2020,75 - 79 years,52,59,111
Louth,2020,80 - 84 years,69,69,138
Louth,2020,85 years and over,202,105,307
Louth,2020,Under 1 year,3,4,7
Macroom Town,2007,1 - 4 years,0,0,0
Macroom Town,2007,10 - 14 years,0,0,0
Macroom Town,2007,15 - 19 years,0,0,0
Macroom Town,2007,20 - 24 years,0,1,1
Macroom Town,2007,25 - 29 years,0,0,0
Macroom Town,2007,30 - 34 years,0,0,0
Macroom Town,2007,35 - 39 years,0,1,1
Macroom Town,2007,40 - 44 years,0,0,0
Macroom Town,2007,45 - 49 years,0,0,0
Macroom Town,2007,5 - 9 years,0,0,0
Macroom Town,2007,50 - 54 years,0,0,0
Macroom Town,2007,55 - 59 years,0,1,1
Macroom Town,2007,60 - 64 years,1,2,3
Macroom Town,2007,65 - 69 years,1,2,3
Macroom Town,2007,70 - 74 years,3,6,9
Macroom Town,2007,75 - 79 years,7,5,12
Macroom Town,2007,80 - 84 years,4,2,6
Macroom Town,2007,85 years and over,11,3,14
Macroom Town,2007,Under 1 year,0,0,0
Macroom Town,2008,1 - 4 years,0,0,0
Macroom Town,2008,10 - 14 years,0,0,0
Macroom Town,2008,15 - 19 years,0,0,0
Macroom Town,2008,20 - 24 years,1,1,2
Macroom Town,2008,25 - 29 years,0,0,0
Macroom Town,2008,30 - 34 years,0,0,0
Macroom Town,2008,35 - 39 years,1,1,2
Macroom Town,2008,40 - 44 years,1,0,1
Macroom Town,2008,45 - 49 years,0,1,1
Macroom Town,2008,5 - 9 years,0,0,0
Macroom Town,2008,50 - 54 years,0,2,2
Macroom Town,2008,55 - 59 years,0,1,1
Macroom Town,2008,60 - 64 years,1,1,2
Macroom Town,2008,65 - 69 years,1,4,5
Macroom Town,2008,70 - 74 years,3,5,8
Macroom Town,2008,75 - 79 years,7,3,10
Macroom Town,2008,80 - 84 years,4,3,7
Macroom Town,2008,85 years and over,9,7,16
Macroom Town,2008,Under 1 year,0,0,0
Macroom Town,2009,1 - 4 years,0,0,0
Macroom Town,2009,10 - 14 years,0,0,0
Macroom Town,2009,15 - 19 years,0,0,0
Macroom Town,2009,20 - 24 years,1,1,2
Macroom Town,2009,25 - 29 years,0,1,1
Macroom Town,2009,30 - 34 years,0,0,0
Macroom Town,2009,35 - 39 years,1,1,2
Macroom Town,2009,40 - 44 years,1,0,1
Macroom Town,2009,45 - 49 years,0,1,1
Macroom Town,2009,5 - 9 years,0,0,0
Macroom Town,2009,50 - 54 years,0,2,2
Macroom Town,2009,55 - 59 years,1,1,2
Macroom Town,2009,60 - 64 years,1,2,3
Macroom Town,2009,65 - 69 years,1,3,4
Macroom Town,2009,70 - 74 years,2,3,5
Macroom Town,2009,75 - 79 years,1,1,2
Macroom Town,2009,80 - 84 years,3,3,6
Macroom Town,2009,85 years and over,2,2,4
Macroom Town,2009,Under 1 year,0,0,0
Macroom Town,2010,1 - 4 years,0,0,0
Macroom Town,2010,10 - 14 years,0,0,0
Macroom Town,2010,15 - 19 years,0,0,0
Macroom Town,2010,20 - 24 years,1,1,2
Macroom Town,2010,25 - 29 years,0,1,1
Macroom Town,2010,30 - 34 years,0,0,0
Macroom Town,2010,35 - 39 years,1,1,2
Macroom Town,2010,40 - 44 years,1,0,1
Macroom Town,2010,45 - 49 years,0,1,1
Macroom Town,2010,5 - 9 years,0,0,0
Macroom Town,2010,50 - 54 years,1,2,3
Macroom Town,2010,55 - 59 years,2,1,3
Macroom Town,2010,60 - 64 years,1,3,4
Macroom Town,2010,65 - 69 years,1,3,4
Macroom Town,2010,70 - 74 years,1,3,4
Macroom Town,2010,75 - 79 years,1,1,2
Macroom Town,2010,80 - 84 years,3,2,5
Macroom Town,2010,85 years and over,8,2,10
Macroom Town,2010,Under 1 year,0,0,0
Macroom Town,2011,1 - 4 years,0,0,0
Macroom Town,2011,10 - 14 years,0,0,0
Macroom Town,2011,15 - 19 years,0,0,0
Macroom Town,2011,20 - 24 years,0,0,0
Macroom Town,2011,25 - 29 years,1,0,1
Macroom Town,2011,30 - 34 years,0,0,0
Macroom Town,2011,35 - 39 years,0,0,0
Macroom Town,2011,40 - 44 years,0,0,0
Macroom Town,2011,45 - 49 years,0,0,0
Macroom Town,2011,5 - 9 years,0,0,0
Macroom Town,2011,50 - 54 years,0,0,0
Macroom Town,2011,55 - 59 years,0,0,0
Macroom Town,2011,60 - 64 years,0,1,1
Macroom Town,2011,65 - 69 years,1,2,3
Macroom Town,2011,70 - 74 years,0,0,0
Macroom Town,2011,75 - 79 years,3,4,7
Macroom Town,2011,80 - 84 years,4,0,4
Macroom Town,2011,85 years and over,12,4,16
Macroom Town,2011,Under 1 year,0,0,0
Macroom Town,2012,1 - 4 years,0,0,0
Macroom Town,2012,10 - 14 years,0,0,0
Macroom Town,2012,15 - 19 years,0,0,0
Macroom Town,2012,20 - 24 years,0,0,0
Macroom Town,2012,25 - 29 years,1,0,1
Macroom Town,2012,30 - 34 years,0,0,0
Macroom Town,2012,35 - 39 years,1,1,2
Macroom Town,2012,40 - 44 years,0,1,1
Macroom Town,2012,45 - 49 years,0,2,2
Macroom Town,2012,5 - 9 years,0,0,0
Macroom Town,2012,50 - 54 years,0,0,0
Macroom Town,2012,55 - 59 years,0,0,0
Macroom Town,2012,60 - 64 years,0,1,1
Macroom Town,2012,65 - 69 years,1,2,3
Macroom Town,2012,70 - 74 years,1,3,4
Macroom Town,2012,75 - 79 years,3,5,8
Macroom Town,2012,80 - 84 years,1,4,5
Macroom Town,2012,85 years and over,10,2,12
Macroom Town,2012,Under 1 year,0,0,0
Macroom Town,2013,1 - 4 years,0,0,0
Macroom Town,2013,10 - 14 years,0,0,0
Macroom Town,2013,15 - 19 years,0,0,0
Macroom Town,2013,20 - 24 years,0,0,0
Macroom Town,2013,25 - 29 years,0,0,0
Macroom Town,2013,30 - 34 years,0,0,0
Macroom Town,2013,35 - 39 years,0,1,1
Macroom Town,2013,40 - 44 years,1,2,3
Macroom Town,2013,45 - 49 years,0,0,0
Macroom Town,2013,5 - 9 years,0,0,0
Macroom Town,2013,50 - 54 years,0,0,0
Macroom Town,2013,55 - 59 years,0,2,2
Macroom Town,2013,60 - 64 years,0,1,1
Macroom Town,2013,65 - 69 years,2,2,4
Macroom Town,2013,70 - 74 years,1,1,2
Macroom Town,2013,75 - 79 years,1,3,4
Macroom Town,2013,80 - 84 years,4,2,6
Macroom Town,2013,85 years and over,13,4,17
Macroom Town,2013,Under 1 year,0,0,0
Macroom Town,2014,1 - 4 years,0,0,0
Macroom Town,2014,10 - 14 years,0,0,0
Macroom Town,2014,15 - 19 years,0,0,0
Macroom Town,2014,20 - 24 years,0,0,0
Macroom Town,2014,25 - 29 years,0,1,1
Macroom Town,2014,30 - 34 years,1,0,1
Macroom Town,2014,35 - 39 years,0,1,1
Macroom Town,2014,40 - 44 years,1,2,3
Macroom Town,2014,45 - 49 years,0,3,3
Macroom Town,2014,5 - 9 years,0,0,0
Macroom Town,2014,50 - 54 years,1,0,1
Macroom Town,2014,55 - 59 years,1,2,3
Macroom Town,2014,60 - 64 years,0,1,1
Macroom Town,2014,65 - 69 years,2,2,4
Macroom Town,2014,70 - 74 years,3,3,6
Macroom Town,2014,75 - 79 years,3,4,7
Macroom Town,2014,80 - 84 years,6,7,13
Macroom Town,2014,85 years and over,9,6,15
Macroom Town,2014,Under 1 year,0,0,0
Macroom Town,2015,1 - 4 years,0,0,0
Macroom Town,2015,10 - 14 years,0,0,0
Macroom Town,2015,15 - 19 years,0,0,0
Macroom Town,2015,20 - 24 years,0,0,0
Macroom Town,2015,25 - 29 years,0,1,1
Macroom Town,2015,30 - 34 years,1,0,1
Macroom Town,2015,35 - 39 years,0,1,1
Macroom Town,2015,40 - 44 years,1,2,3
Macroom Town,2015,45 - 49 years,0,3,3
Macroom Town,2015,5 - 9 years,0,0,0
Macroom Town,2015,50 - 54 years,1,0,1
Macroom Town,2015,55 - 59 years,1,2,3
Macroom Town,2015,60 - 64 years,0,1,1
Macroom Town,2015,65 - 69 years,2,2,4
Macroom Town,2015,70 - 74 years,3,3,6
Macroom Town,2015,75 - 79 years,3,4,7
Macroom Town,2015,80 - 84 years,6,7,13
Macroom Town,2015,85 years and over,9,6,15
Macroom Town,2015,Under 1 year,0,0,0
Macroom Town,2016,1 - 4 years,0,0,0
Macroom Town,2016,10 - 14 years,0,0,0
Macroom Town,2016,15 - 19 years,0,0,0
Macroom Town,2016,20 - 24 years,0,0,0
Macroom Town,2016,25 - 29 years,0,1,1
Macroom Town,2016,30 - 34 years,1,0,1
Macroom Town,2016,35 - 39 years,0,1,1
Macroom Town,2016,40 - 44 years,1,2,3
Macroom Town,2016,45 - 49 years,0,3,3
Macroom Town,2016,5 - 9 years,0,0,0
Macroom Town,2016,50 - 54 years,1,0,1
Macroom Town,2016,55 - 59 years,1,2,3
Macroom Town,2016,60 - 64 years,0,1,1
Macroom Town,2016,65 - 69 years,2,2,4
Macroom Town,2016,70 - 74 years,3,3,6
Macroom Town,2016,75 - 79 years,3,4,7
Macroom Town,2016,80 - 84 years,6,7,13
Macroom Town,2016,85 years and over,9,6,15
Macroom Town,2016,Under 1 year,0,0,0
Macroom Town,2017,1 - 4 years,0,0,0
Macroom Town,2017,10 - 14 years,0,0,0
Macroom Town,2017,15 - 19 years,0,0,0
Macroom Town,2017,20 - 24 years,0,0,0
Macroom Town,2017,25 - 29 years,0,1,1
Macroom Town,2017,30 - 34 years,1,0,1
Macroom Town,2017,35 - 39 years,2,1,3
Macroom Town,2017,40 - 44 years,1,1,2
Macroom Town,2017,45 - 49 years,0,3,3
Macroom Town,2017,5 - 9 years,0,0,0
Macroom Town,2017,50 - 54 years,1,0,1
Macroom Town,2017,55 - 59 years,1,2,3
Macroom Town,2017,60 - 64 years,3,2,5
Macroom Town,2017,65 - 69 years,2,2,4
Macroom Town,2017,70 - 74 years,3,1,4
Macroom Town,2017,75 - 79 years,3,5,8
Macroom Town,2017,80 - 84 years,1,7,8
Macroom Town,2017,85 years and over,8,4,12
Macroom Town,2017,Under 1 year,0,0,0
Macroom Town,2018,1 - 4 years,0,0,0
Macroom Town,2018,10 - 14 years,0,0,0
Macroom Town,2018,15 - 19 years,0,0,0
Macroom Town,2018,20 - 24 years,0,0,0
Macroom Town,2018,25 - 29 years,0,0,0
Macroom Town,2018,30 - 34 years,0,0,0
Macroom Town,2018,35 - 39 years,0,0,0
Macroom Town,2018,40 - 44 years,0,1,1
Macroom Town,2018,45 - 49 years,0,1,1
Macroom Town,2018,5 - 9 years,0,0,0
Macroom Town,2018,50 - 54 years,0,1,1
Macroom Town,2018,55 - 59 years,0,1,1
Macroom Town,2018,60 - 64 years,0,1,1
Macroom Town,2018,65 - 69 years,1,3,4
Macroom Town,2018,70 - 74 years,1,3,4
Macroom Town,2018,75 - 79 years,2,5,7
Macroom Town,2018,80 - 84 years,5,2,7
Macroom Town,2018,85 years and over,14,2,16
Macroom Town,2018,Under 1 year,0,0,0
Macroom Town,2019,1 - 4 years,0,0,0
Macroom Town,2019,10 - 14 years,0,0,0
Macroom Town,2019,15 - 19 years,0,0,0
Macroom Town,2019,20 - 24 years,0,0,0
Macroom Town,2019,25 - 29 years,0,0,0
Macroom Town,2019,30 - 34 years,0,0,0
Macroom Town,2019,35 - 39 years,0,0,0
Macroom Town,2019,40 - 44 years,0,1,1
Macroom Town,2019,45 - 49 years,0,1,1
Macroom Town,2019,5 - 9 years,0,0,0
Macroom Town,2019,50 - 54 years,0,1,1
Macroom Town,2019,55 - 59 years,0,1,1
Macroom Town,2019,60 - 64 years,0,1,1
Macroom Town,2019,65 - 69 years,1,3,4
Macroom Town,2019,70 - 74 years,1,3,4
Macroom Town,2019,75 - 79 years,2,5,7
Macroom Town,2019,80 - 84 years,5,2,7
Macroom Town,2019,85 years and over,14,2,16
Macroom Town,2019,Under 1 year,0,0,0
Macroom Town,2020,1 - 4 years,0,0,0
Macroom Town,2020,10 - 14 years,0,0,0
Macroom Town,2020,15 - 19 years,0,0,0
Macroom Town,2020,20 - 24 years,0,0,0
Macroom Town,2020,25 - 29 years,0,0,0
Macroom Town,2020,30 - 34 years,0,0,0
Macroom Town,2020,35 - 39 years,0,0,0
Macroom Town,2020,40 - 44 years,0,1,1
Macroom Town,2020,45 - 49 years,0,1,1
Macroom Town,2020,5 - 9 years,0,0,0
Macroom Town,2020,50 - 54 years,0,1,1
Macroom Town,2020,55 - 59 years,0,1,1
Macroom Town,2020,60 - 64 years,0,1,1
Macroom Town,2020,65 - 69 years,1,3,4
Macroom Town,2020,70 - 74 years,1,3,4
Macroom Town,2020,75 - 79 years,2,5,7
Macroom Town,2020,80 - 84 years,5,2,7
Macroom Town,2020,85 years and over,14,2,16
Macroom Town,2020,Under 1 year,0,0,0
Mallow Town,2007,1 - 4 years,0,0,0
Mallow Town,2007,10 - 14 years,0,0,0
Mallow Town,2007,15 - 19 years,0,2,2
Mallow Town,2007,20 - 24 years,0,1,1
Mallow Town,2007,25 - 29 years,0,1,1
Mallow Town,2007,30 - 34 years,0,0,0
Mallow Town,2007,35 - 39 years,1,4,5
Mallow Town,2007,40 - 44 years,1,2,3
Mallow Town,2007,45 - 49 years,2,4,6
Mallow Town,2007,5 - 9 years,0,0,0
Mallow Town,2007,50 - 54 years,0,3,3
Mallow Town,2007,55 - 59 years,3,4,7
Mallow Town,2007,60 - 64 years,5,3,8
Mallow Town,2007,65 - 69 years,4,7,11
Mallow Town,2007,70 - 74 years,8,12,20
Mallow Town,2007,75 - 79 years,12,14,26
Mallow Town,2007,80 - 84 years,9,16,25
Mallow Town,2007,85 years and over,37,20,57
Mallow Town,2007,Under 1 year,3,2,5
Mallow Town,2008,1 - 4 years,0,0,0
Mallow Town,2008,10 - 14 years,0,1,1
Mallow Town,2008,15 - 19 years,0,2,2
Mallow Town,2008,20 - 24 years,0,1,1
Mallow Town,2008,25 - 29 years,0,2,2
Mallow Town,2008,30 - 34 years,1,0,1
Mallow Town,2008,35 - 39 years,1,4,5
Mallow Town,2008,40 - 44 years,2,1,3
Mallow Town,2008,45 - 49 years,2,3,5
Mallow Town,2008,5 - 9 years,0,0,0
Mallow Town,2008,50 - 54 years,0,1,1
Mallow Town,2008,55 - 59 years,2,3,5
Mallow Town,2008,60 - 64 years,3,9,12
Mallow Town,2008,65 - 69 years,2,5,7
Mallow Town,2008,70 - 74 years,6,11,17
Mallow Town,2008,75 - 79 years,7,12,19
Mallow Town,2008,80 - 84 years,17,15,32
Mallow Town,2008,85 years and over,41,28,69
Mallow Town,2008,Under 1 year,2,3,5
Mallow Town,2009,1 - 4 years,0,0,0
Mallow Town,2009,10 - 14 years,0,1,1
Mallow Town,2009,15 - 19 years,0,2,2
Mallow Town,2009,20 - 24 years,0,1,1
Mallow Town,2009,25 - 29 years,0,1,1
Mallow Town,2009,30 - 34 years,1,0,1
Mallow Town,2009,35 - 39 years,1,1,2
Mallow Town,2009,40 - 44 years,2,1,3
Mallow Town,2009,45 - 49 years,2,1,3
Mallow Town,2009,5 - 9 years,0,0,0
Mallow Town,2009,50 - 54 years,0,1,1
Mallow Town,2009,55 - 59 years,2,6,8
Mallow Town,2009,60 - 64 years,1,9,10
Mallow Town,2009,65 - 69 years,1,5,6
Mallow Town,2009,70 - 74 years,2,3,5
Mallow Town,2009,75 - 79 years,5,8,13
Mallow Town,2009,80 - 84 years,7,4,11
Mallow Town,2009,85 years and over,17,9,26
Mallow Town,2009,Under 1 year,1,3,4
Mallow Town,2010,1 - 4 years,0,1,1
Mallow Town,2010,10 - 14 years,0,1,1
Mallow Town,2010,15 - 19 years,0,2,2
Mallow Town,2010,20 - 24 years,0,1,1
Mallow Town,2010,25 - 29 years,0,2,2
Mallow Town,2010,30 - 34 years,1,0,1
Mallow Town,2010,35 - 39 years,1,1,2
Mallow Town,2010,40 - 44 years,2,1,3
Mallow Town,2010,45 - 49 years,2,1,3
Mallow Town,2010,5 - 9 years,0,0,0
Mallow Town,2010,50 - 54 years,2,2,4
Mallow Town,2010,55 - 59 years,2,4,6
Mallow Town,2010,60 - 64 years,4,3,7
Mallow Town,2010,65 - 69 years,3,4,7
Mallow Town,2010,70 - 74 years,4,7,11
Mallow Town,2010,75 - 79 years,9,5,14
Mallow Town,2010,80 - 84 years,11,6,17
Mallow Town,2010,85 years and over,19,10,29
Mallow Town,2010,Under 1 year,1,3,4
Mallow Town,2011,1 - 4 years,0,0,0
Mallow Town,2011,10 - 14 years,0,0,0
Mallow Town,2011,15 - 19 years,0,0,0
Mallow Town,2011,20 - 24 years,0,0,0
Mallow Town,2011,25 - 29 years,0,1,1
Mallow Town,2011,30 - 34 years,0,1,1
Mallow Town,2011,35 - 39 years,0,0,0
Mallow Town,2011,40 - 44 years,0,1,1
Mallow Town,2011,45 - 49 years,1,0,1
Mallow Town,2011,5 - 9 years,0,0,0
Mallow Town,2011,50 - 54 years,0,0,0
Mallow Town,2011,55 - 59 years,0,0,0
Mallow Town,2011,60 - 64 years,1,1,2
Mallow Town,2011,65 - 69 years,1,2,3
Mallow Town,2011,70 - 74 years,1,6,7
Mallow Town,2011,75 - 79 years,3,4,7
Mallow Town,2011,80 - 84 years,5,2,7
Mallow Town,2011,85 years and over,11,6,17
Mallow Town,2011,Under 1 year,1,0,1
Mallow Town,2012,1 - 4 years,0,0,0
Mallow Town,2012,10 - 14 years,0,0,0
Mallow Town,2012,15 - 19 years,0,1,1
Mallow Town,2012,20 - 24 years,0,2,2
Mallow Town,2012,25 - 29 years,0,1,1
Mallow Town,2012,30 - 34 years,0,1,1
Mallow Town,2012,35 - 39 years,0,1,1
Mallow Town,2012,40 - 44 years,1,1,2
Mallow Town,2012,45 - 49 years,1,0,1
Mallow Town,2012,5 - 9 years,0,0,0
Mallow Town,2012,50 - 54 years,1,0,1
Mallow Town,2012,55 - 59 years,1,3,4
Mallow Town,2012,60 - 64 years,4,3,7
Mallow Town,2012,65 - 69 years,4,7,11
Mallow Town,2012,70 - 74 years,3,8,11
Mallow Town,2012,75 - 79 years,5,10,15
Mallow Town,2012,80 - 84 years,15,9,24
Mallow Town,2012,85 years and over,20,14,34
Mallow Town,2012,Under 1 year,1,0,1
Mallow Town,2013,1 - 4 years,0,0,0
Mallow Town,2013,10 - 14 years,0,0,0
Mallow Town,2013,15 - 19 years,0,0,0
Mallow Town,2013,20 - 24 years,0,1,1
Mallow Town,2013,25 - 29 years,0,2,2
Mallow Town,2013,30 - 34 years,0,1,1
Mallow Town,2013,35 - 39 years,0,0,0
Mallow Town,2013,40 - 44 years,0,2,2
Mallow Town,2013,45 - 49 years,0,1,1
Mallow Town,2013,5 - 9 years,0,0,0
Mallow Town,2013,50 - 54 years,1,3,4
Mallow Town,2013,55 - 59 years,1,0,1
Mallow Town,2013,60 - 64 years,3,4,7
Mallow Town,2013,65 - 69 years,4,8,12
Mallow Town,2013,70 - 74 years,2,2,4
Mallow Town,2013,75 - 79 years,3,10,13
Mallow Town,2013,80 - 84 years,6,9,15
Mallow Town,2013,85 years and over,19,12,31
Mallow Town,2013,Under 1 year,0,2,2
Mallow Town,2014,1 - 4 years,1,0,1
Mallow Town,2014,10 - 14 years,0,0,0
Mallow Town,2014,15 - 19 years,0,0,0
Mallow Town,2014,20 - 24 years,0,1,1
Mallow Town,2014,25 - 29 years,0,1,1
Mallow Town,2014,30 - 34 years,0,1,1
Mallow Town,2014,35 - 39 years,2,3,5
Mallow Town,2014,40 - 44 years,1,1,2
Mallow Town,2014,45 - 49 years,1,1,2
Mallow Town,2014,5 - 9 years,0,0,0
Mallow Town,2014,50 - 54 years,1,1,2
Mallow Town,2014,55 - 59 years,2,2,4
Mallow Town,2014,60 - 64 years,3,4,7
Mallow Town,2014,65 - 69 years,2,3,5
Mallow Town,2014,70 - 74 years,2,3,5
Mallow Town,2014,75 - 79 years,4,12,16
Mallow Town,2014,80 - 84 years,8,4,12
Mallow Town,2014,85 years and over,14,9,23
Mallow Town,2014,Under 1 year,1,2,3
Mallow Town,2015,1 - 4 years,1,0,1
Mallow Town,2015,10 - 14 years,0,0,0
Mallow Town,2015,15 - 19 years,0,0,0
Mallow Town,2015,20 - 24 years,0,1,1
Mallow Town,2015,25 - 29 years,0,1,1
Mallow Town,2015,30 - 34 years,0,1,1
Mallow Town,2015,35 - 39 years,2,3,5
Mallow Town,2015,40 - 44 years,1,1,2
Mallow Town,2015,45 - 49 years,1,1,2
Mallow Town,2015,5 - 9 years,0,0,0
Mallow Town,2015,50 - 54 years,1,1,2
Mallow Town,2015,55 - 59 years,2,2,4
Mallow Town,2015,60 - 64 years,3,4,7
Mallow Town,2015,65 - 69 years,2,3,5
Mallow Town,2015,70 - 74 years,2,3,5
Mallow Town,2015,75 - 79 years,4,12,16
Mallow Town,2015,80 - 84 years,8,4,12
Mallow Town,2015,85 years and over,14,9,23
Mallow Town,2015,Under 1 year,1,2,3
Mallow Town,2016,1 - 4 years,1,0,1
Mallow Town,2016,10 - 14 years,0,0,0
Mallow Town,2016,15 - 19 years,0,0,0
Mallow Town,2016,20 - 24 years,0,1,1
Mallow Town,2016,25 - 29 years,0,1,1
Mallow Town,2016,30 - 34 years,0,1,1
Mallow Town,2016,35 - 39 years,2,3,5
Mallow Town,2016,40 - 44 years,1,1,2
Mallow Town,2016,45 - 49 years,1,1,2
Mallow Town,2016,5 - 9 years,0,0,0
Mallow Town,2016,50 - 54 years,1,1,2
Mallow Town,2016,55 - 59 years,2,2,4
Mallow Town,2016,60 - 64 years,3,4,7
Mallow Town,2016,65 - 69 years,2,3,5
Mallow Town,2016,70 - 74 years,2,3,5
Mallow Town,2016,75 - 79 years,4,12,16
Mallow Town,2016,80 - 84 years,8,4,12
Mallow Town,2016,85 years and over,14,9,23
Mallow Town,2016,Under 1 year,1,2,3
Mallow Town,2017,1 - 4 years,1,0,1
Mallow Town,2017,10 - 14 years,0,0,0
Mallow Town,2017,15 - 19 years,1,0,1
Mallow Town,2017,20 - 24 years,0,1,1
Mallow Town,2017,25 - 29 years,0,1,1
Mallow Town,2017,30 - 34 years,0,1,1
Mallow Town,2017,35 - 39 years,2,1,3
Mallow Town,2017,40 - 44 years,1,1,2
Mallow Town,2017,45 - 49 years,1,1,2
Mallow Town,2017,5 - 9 years,0,0,0
Mallow Town,2017,50 - 54 years,1,1,2
Mallow Town,2017,55 - 59 years,2,1,3
Mallow Town,2017,60 - 64 years,2,2,4
Mallow Town,2017,65 - 69 years,3,3,6
Mallow Town,2017,70 - 74 years,4,2,6
Mallow Town,2017,75 - 79 years,3,6,9
Mallow Town,2017,80 - 84 years,3,4,7
Mallow Town,2017,85 years and over,19,6,25
Mallow Town,2017,Under 1 year,1,2,3
Mallow Town,2018,1 - 4 years,0,0,0
Mallow Town,2018,10 - 14 years,0,0,0
Mallow Town,2018,15 - 19 years,0,0,0
Mallow Town,2018,20 - 24 years,0,0,0
Mallow Town,2018,25 - 29 years,1,0,1
Mallow Town,2018,30 - 34 years,0,0,0
Mallow Town,2018,35 - 39 years,0,0,0
Mallow Town,2018,40 - 44 years,2,0,2
Mallow Town,2018,45 - 49 years,1,0,1
Mallow Town,2018,5 - 9 years,0,0,0
Mallow Town,2018,50 - 54 years,2,2,4
Mallow Town,2018,55 - 59 years,1,3,4
Mallow Town,2018,60 - 64 years,1,1,2
Mallow Town,2018,65 - 69 years,5,1,6
Mallow Town,2018,70 - 74 years,1,8,9
Mallow Town,2018,75 - 79 years,3,3,6
Mallow Town,2018,80 - 84 years,10,7,17
Mallow Town,2018,85 years and over,17,10,27
Mallow Town,2018,Under 1 year,1,0,1
Mallow Town,2019,1 - 4 years,0,0,0
Mallow Town,2019,10 - 14 years,0,0,0
Mallow Town,2019,15 - 19 years,0,0,0
Mallow Town,2019,20 - 24 years,0,0,0
Mallow Town,2019,25 - 29 years,1,0,1
Mallow Town,2019,30 - 34 years,0,0,0
Mallow Town,2019,35 - 39 years,0,0,0
Mallow Town,2019,40 - 44 years,2,0,2
Mallow Town,2019,45 - 49 years,1,0,1
Mallow Town,2019,5 - 9 years,0,0,0
Mallow Town,2019,50 - 54 years,2,2,4
Mallow Town,2019,55 - 59 years,1,3,4
Mallow Town,2019,60 - 64 years,1,1,2
Mallow Town,2019,65 - 69 years,5,1,6
Mallow Town,2019,70 - 74 years,1,8,9
Mallow Town,2019,75 - 79 years,3,3,6
Mallow Town,2019,80 - 84 years,10,7,17
Mallow Town,2019,85 years and over,17,10,27
Mallow Town,2019,Under 1 year,1,0,1
Mallow Town,2020,1 - 4 years,0,0,0
Mallow Town,2020,10 - 14 years,0,0,0
Mallow Town,2020,15 - 19 years,0,0,0
Mallow Town,2020,20 - 24 years,0,0,0
Mallow Town,2020,25 - 29 years,1,0,1
Mallow Town,2020,30 - 34 years,0,0,0
Mallow Town,2020,35 - 39 years,0,0,0
Mallow Town,2020,40 - 44 years,2,0,2
Mallow Town,2020,45 - 49 years,1,0,1
Mallow Town,2020,5 - 9 years,0,0,0
Mallow Town,2020,50 - 54 years,2,2,4
Mallow Town,2020,55 - 59 years,1,3,4
Mallow Town,2020,60 - 64 years,1,1,2
Mallow Town,2020,65 - 69 years,5,1,6
Mallow Town,2020,70 - 74 years,1,8,9
Mallow Town,2020,75 - 79 years,3,3,6
Mallow Town,2020,80 - 84 years,10,7,17
Mallow Town,2020,85 years and over,17,10,27
Mallow Town,2020,Under 1 year,1,0,1
Mayo,2007,1 - 4 years,0,2,2
Mayo,2007,10 - 14 years,0,0,0
Mayo,2007,15 - 19 years,3,2,5
Mayo,2007,20 - 24 years,1,5,6
Mayo,2007,25 - 29 years,0,6,6
Mayo,2007,30 - 34 years,3,4,7
Mayo,2007,35 - 39 years,1,5,6
Mayo,2007,40 - 44 years,3,5,8
Mayo,2007,45 - 49 years,6,13,19
Mayo,2007,5 - 9 years,0,0,0
Mayo,2007,50 - 54 years,10,18,28
Mayo,2007,55 - 59 years,11,37,48
Mayo,2007,60 - 64 years,15,42,57
Mayo,2007,65 - 69 years,24,40,64
Mayo,2007,70 - 74 years,39,59,98
Mayo,2007,75 - 79 years,64,95,159
Mayo,2007,80 - 84 years,94,106,200
Mayo,2007,85 years and over,218,127,345
Mayo,2007,Under 1 year,2,4,6
Mayo,2008,1 - 4 years,1,2,3
Mayo,2008,10 - 14 years,1,1,2
Mayo,2008,15 - 19 years,1,3,4
Mayo,2008,20 - 24 years,1,3,4
Mayo,2008,25 - 29 years,3,4,7
Mayo,2008,30 - 34 years,3,3,6
Mayo,2008,35 - 39 years,2,5,7
Mayo,2008,40 - 44 years,5,8,13
Mayo,2008,45 - 49 years,10,11,21
Mayo,2008,5 - 9 years,0,0,0
Mayo,2008,50 - 54 years,12,24,36
Mayo,2008,55 - 59 years,19,34,53
Mayo,2008,60 - 64 years,17,36,53
Mayo,2008,65 - 69 years,26,65,91
Mayo,2008,70 - 74 years,28,72,100
Mayo,2008,75 - 79 years,78,86,164
Mayo,2008,80 - 84 years,88,112,200
Mayo,2008,85 years and over,246,114,360
Mayo,2008,Under 1 year,4,3,7
Mayo,2009,1 - 4 years,1,2,3
Mayo,2009,10 - 14 years,1,1,2
Mayo,2009,15 - 19 years,1,6,7
Mayo,2009,20 - 24 years,1,3,4
Mayo,2009,25 - 29 years,2,5,7
Mayo,2009,30 - 34 years,3,5,8
Mayo,2009,35 - 39 years,1,8,9
Mayo,2009,40 - 44 years,3,8,11
Mayo,2009,45 - 49 years,6,15,21
Mayo,2009,5 - 9 years,0,0,0
Mayo,2009,50 - 54 years,11,15,26
Mayo,2009,55 - 59 years,10,35,45
Mayo,2009,60 - 64 years,17,45,62
Mayo,2009,65 - 69 years,21,50,71
Mayo,2009,70 - 74 years,42,54,96
Mayo,2009,75 - 79 years,41,90,131
Mayo,2009,80 - 84 years,81,91,172
Mayo,2009,85 years and over,221,137,358
Mayo,2009,Under 1 year,2,3,5
Mayo,2010,1 - 4 years,1,2,3
Mayo,2010,10 - 14 years,1,1,2
Mayo,2010,15 - 19 years,4,3,7
Mayo,2010,20 - 24 years,1,3,4
Mayo,2010,25 - 29 years,1,4,5
Mayo,2010,30 - 34 years,1,4,5
Mayo,2010,35 - 39 years,1,6,7
Mayo,2010,40 - 44 years,4,8,12
Mayo,2010,45 - 49 years,5,9,14
Mayo,2010,5 - 9 years,0,1,1
Mayo,2010,50 - 54 years,15,24,39
Mayo,2010,55 - 59 years,13,27,40
Mayo,2010,60 - 64 years,25,41,66
Mayo,2010,65 - 69 years,34,58,92
Mayo,2010,70 - 74 years,43,51,94
Mayo,2010,75 - 79 years,63,89,152
Mayo,2010,80 - 84 years,91,87,178
Mayo,2010,85 years and over,254,160,414
Mayo,2010,Under 1 year,1,5,6
Mayo,2011,1 - 4 years,0,1,1
Mayo,2011,10 - 14 years,1,0,1
Mayo,2011,15 - 19 years,2,6,8
Mayo,2011,20 - 24 years,1,4,5
Mayo,2011,25 - 29 years,1,5,6
Mayo,2011,30 - 34 years,2,5,7
Mayo,2011,35 - 39 years,2,9,11
Mayo,2011,40 - 44 years,5,4,9
Mayo,2011,45 - 49 years,10,7,17
Mayo,2011,5 - 9 years,0,0,0
Mayo,2011,50 - 54 years,10,13,23
Mayo,2011,55 - 59 years,16,26,42
Mayo,2011,60 - 64 years,18,44,62
Mayo,2011,65 - 69 years,19,41,60
Mayo,2011,70 - 74 years,18,52,70
Mayo,2011,75 - 79 years,53,88,141
Mayo,2011,80 - 84 years,73,90,163
Mayo,2011,85 years and over,267,137,404
Mayo,2011,Under 1 year,1,4,5
Mayo,2012,1 - 4 years,1,1,2
Mayo,2012,10 - 14 years,1,0,1
Mayo,2012,15 - 19 years,1,1,2
Mayo,2012,20 - 24 years,1,6,7
Mayo,2012,25 - 29 years,1,3,4
Mayo,2012,30 - 34 years,3,7,10
Mayo,2012,35 - 39 years,6,9,15
Mayo,2012,40 - 44 years,8,10,18
Mayo,2012,45 - 49 years,4,9,13
Mayo,2012,5 - 9 years,0,0,0
Mayo,2012,50 - 54 years,14,16,30
Mayo,2012,55 - 59 years,10,21,31
Mayo,2012,60 - 64 years,25,26,51
Mayo,2012,65 - 69 years,26,43,69
Mayo,2012,70 - 74 years,46,63,109
Mayo,2012,75 - 79 years,51,77,128
Mayo,2012,80 - 84 years,95,115,210
Mayo,2012,85 years and over,242,157,399
Mayo,2012,Under 1 year,2,2,4
Mayo,2013,1 - 4 years,0,2,2
Mayo,2013,10 - 14 years,0,1,1
Mayo,2013,15 - 19 years,1,1,2
Mayo,2013,20 - 24 years,3,2,5
Mayo,2013,25 - 29 years,4,5,9
Mayo,2013,30 - 34 years,1,3,4
Mayo,2013,35 - 39 years,2,5,7
Mayo,2013,40 - 44 years,2,4,6
Mayo,2013,45 - 49 years,2,5,7
Mayo,2013,5 - 9 years,0,0,0
Mayo,2013,50 - 54 years,9,16,25
Mayo,2013,55 - 59 years,19,28,47
Mayo,2013,60 - 64 years,36,46,82
Mayo,2013,65 - 69 years,31,53,84
Mayo,2013,70 - 74 years,45,59,104
Mayo,2013,75 - 79 years,55,73,128
Mayo,2013,80 - 84 years,81,103,184
Mayo,2013,85 years and over,281,170,451
Mayo,2013,Under 1 year,2,2,4
Mayo,2014,1 - 4 years,1,1,2
Mayo,2014,10 - 14 years,0,1,1
Mayo,2014,15 - 19 years,1,1,2
Mayo,2014,20 - 24 years,1,3,4
Mayo,2014,25 - 29 years,4,6,10
Mayo,2014,30 - 34 years,3,1,4
Mayo,2014,35 - 39 years,1,5,6
Mayo,2014,40 - 44 years,4,9,13
Mayo,2014,45 - 49 years,6,9,15
Mayo,2014,5 - 9 years,0,2,2
Mayo,2014,50 - 54 years,9,18,27
Mayo,2014,55 - 59 years,11,22,33
Mayo,2014,60 - 64 years,21,36,57
Mayo,2014,65 - 69 years,21,49,70
Mayo,2014,70 - 74 years,32,71,103
Mayo,2014,75 - 79 years,52,73,125
Mayo,2014,80 - 84 years,88,98,186
Mayo,2014,85 years and over,249,149,398
Mayo,2014,Under 1 year,6,4,10
Mayo,2015,1 - 4 years,1,1,2
Mayo,2015,10 - 14 years,0,1,1
Mayo,2015,15 - 19 years,1,1,2
Mayo,2015,20 - 24 years,1,2,3
Mayo,2015,25 - 29 years,4,2,6
Mayo,2015,30 - 34 years,3,6,9
Mayo,2015,35 - 39 years,6,3,9
Mayo,2015,40 - 44 years,4,5,9
Mayo,2015,45 - 49 years,5,11,16
Mayo,2015,5 - 9 years,0,1,1
Mayo,2015,50 - 54 years,6,14,20
Mayo,2015,55 - 59 years,21,21,42
Mayo,2015,60 - 64 years,16,43,59
Mayo,2015,65 - 69 years,33,52,85
Mayo,2015,70 - 74 years,33,68,101
Mayo,2015,75 - 79 years,48,87,135
Mayo,2015,80 - 84 years,73,106,179
Mayo,2015,85 years and over,253,132,385
Mayo,2015,Under 1 year,1,5,6
Mayo,2016,1 - 4 years,1,1,2
Mayo,2016,10 - 14 years,0,1,1
Mayo,2016,15 - 19 years,1,1,2
Mayo,2016,20 - 24 years,1,3,4
Mayo,2016,25 - 29 years,1,3,4
Mayo,2016,30 - 34 years,1,2,3
Mayo,2016,35 - 39 years,1,8,9
Mayo,2016,40 - 44 years,6,5,11
Mayo,2016,45 - 49 years,4,5,9
Mayo,2016,5 - 9 years,1,1,2
Mayo,2016,50 - 54 years,8,22,30
Mayo,2016,55 - 59 years,18,23,41
Mayo,2016,60 - 64 years,19,32,51
Mayo,2016,65 - 69 years,31,43,74
Mayo,2016,70 - 74 years,42,81,123
Mayo,2016,75 - 79 years,56,78,134
Mayo,2016,80 - 84 years,72,108,180
Mayo,2016,85 years and over,238,173,411
Mayo,2016,Under 1 year,3,5,8
Mayo,2017,1 - 4 years,1,1,2
Mayo,2017,10 - 14 years,1,1,2
Mayo,2017,15 - 19 years,1,1,2
Mayo,2017,20 - 24 years,1,5,6
Mayo,2017,25 - 29 years,1,7,8
Mayo,2017,30 - 34 years,1,3,4
Mayo,2017,35 - 39 years,3,6,9
Mayo,2017,40 - 44 years,6,6,12
Mayo,2017,45 - 49 years,2,6,8
Mayo,2017,5 - 9 years,1,1,2
Mayo,2017,50 - 54 years,8,14,22
Mayo,2017,55 - 59 years,16,18,34
Mayo,2017,60 - 64 years,26,33,59
Mayo,2017,65 - 69 years,28,50,78
Mayo,2017,70 - 74 years,35,73,108
Mayo,2017,75 - 79 years,60,83,143
Mayo,2017,80 - 84 years,83,93,176
Mayo,2017,85 years and over,241,168,409
Mayo,2017,Under 1 year,3,1,4
Mayo,2018,1 - 4 years,0,0,0
Mayo,2018,10 - 14 years,0,2,2
Mayo,2018,15 - 19 years,0,0,0
Mayo,2018,20 - 24 years,0,2,2
Mayo,2018,25 - 29 years,2,3,5
Mayo,2018,30 - 34 years,1,2,3
Mayo,2018,35 - 39 years,0,5,5
Mayo,2018,40 - 44 years,4,5,9
Mayo,2018,45 - 49 years,7,6,13
Mayo,2018,5 - 9 years,0,1,1
Mayo,2018,50 - 54 years,13,9,22
Mayo,2018,55 - 59 years,16,26,42
Mayo,2018,60 - 64 years,21,43,64
Mayo,2018,65 - 69 years,36,59,95
Mayo,2018,70 - 74 years,39,82,121
Mayo,2018,75 - 79 years,44,85,129
Mayo,2018,80 - 84 years,65,107,172
Mayo,2018,85 years and over,246,173,419
Mayo,2018,Under 1 year,2,1,3
Mayo,2019,1 - 4 years,0,0,0
Mayo,2019,10 - 14 years,0,1,1
Mayo,2019,15 - 19 years,0,0,0
Mayo,2019,20 - 24 years,0,1,1
Mayo,2019,25 - 29 years,1,3,4
Mayo,2019,30 - 34 years,0,2,2
Mayo,2019,35 - 39 years,3,3,6
Mayo,2019,40 - 44 years,3,4,7
Mayo,2019,45 - 49 years,5,7,12
Mayo,2019,5 - 9 years,0,0,0
Mayo,2019,50 - 54 years,8,11,19
Mayo,2019,55 - 59 years,13,26,39
Mayo,2019,60 - 64 years,22,36,58
Mayo,2019,65 - 69 years,22,60,82
Mayo,2019,70 - 74 years,51,90,141
Mayo,2019,75 - 79 years,52,77,129
Mayo,2019,80 - 84 years,58,97,155
Mayo,2019,85 years and over,232,144,376
Mayo,2019,Under 1 year,2,3,5
Mayo,2020,1 - 4 years,0,0,0
Mayo,2020,10 - 14 years,0,1,1
Mayo,2020,15 - 19 years,0,1,1
Mayo,2020,20 - 24 years,0,2,2
Mayo,2020,25 - 29 years,1,3,4
Mayo,2020,30 - 34 years,0,4,4
Mayo,2020,35 - 39 years,2,2,4
Mayo,2020,40 - 44 years,4,3,7
Mayo,2020,45 - 49 years,10,8,18
Mayo,2020,5 - 9 years,0,0,0
Mayo,2020,50 - 54 years,5,16,21
Mayo,2020,55 - 59 years,25,23,48
Mayo,2020,60 - 64 years,18,30,48
Mayo,2020,65 - 69 years,40,42,82
Mayo,2020,70 - 74 years,49,73,122
Mayo,2020,75 - 79 years,63,91,154
Mayo,2020,80 - 84 years,86,114,200
Mayo,2020,85 years and over,226,177,403
Mayo,2020,Under 1 year,2,1,3
Meath,2007,1 - 4 years,5,1,6
Meath,2007,10 - 14 years,0,1,1
Meath,2007,15 - 19 years,1,4,5
Meath,2007,20 - 24 years,1,5,6
Meath,2007,25 - 29 years,2,5,7
Meath,2007,30 - 34 years,3,5,8
Meath,2007,35 - 39 years,2,6,8
Meath,2007,40 - 44 years,6,7,13
Meath,2007,45 - 49 years,11,11,22
Meath,2007,5 - 9 years,0,0,0
Meath,2007,50 - 54 years,7,15,22
Meath,2007,55 - 59 years,15,22,37
Meath,2007,60 - 64 years,13,37,50
Meath,2007,65 - 69 years,25,40,65
Meath,2007,70 - 74 years,29,42,71
Meath,2007,75 - 79 years,50,55,105
Meath,2007,80 - 84 years,60,71,131
Meath,2007,85 years and over,154,74,228
Meath,2007,Under 1 year,5,10,15
Meath,2008,1 - 4 years,2,2,4
Meath,2008,10 - 14 years,0,2,2
Meath,2008,15 - 19 years,3,5,8
Meath,2008,20 - 24 years,2,4,6
Meath,2008,25 - 29 years,1,9,10
Meath,2008,30 - 34 years,2,7,9
Meath,2008,35 - 39 years,4,7,11
Meath,2008,40 - 44 years,6,4,10
Meath,2008,45 - 49 years,12,7,19
Meath,2008,5 - 9 years,0,0,0
Meath,2008,50 - 54 years,8,21,29
Meath,2008,55 - 59 years,9,26,35
Meath,2008,60 - 64 years,21,37,58
Meath,2008,65 - 69 years,18,37,55
Meath,2008,70 - 74 years,32,59,91
Meath,2008,75 - 79 years,47,61,108
Meath,2008,80 - 84 years,70,59,129
Meath,2008,85 years and over,136,96,232
Meath,2008,Under 1 year,10,6,16
Meath,2009,1 - 4 years,2,2,4
Meath,2009,10 - 14 years,0,2,2
Meath,2009,15 - 19 years,1,3,4
Meath,2009,20 - 24 years,5,4,9
Meath,2009,25 - 29 years,3,5,8
Meath,2009,30 - 34 years,3,6,9
Meath,2009,35 - 39 years,5,11,16
Meath,2009,40 - 44 years,7,8,15
Meath,2009,45 - 49 years,3,14,17
Meath,2009,5 - 9 years,1,0,1
Meath,2009,50 - 54 years,10,18,28
Meath,2009,55 - 59 years,14,19,33
Meath,2009,60 - 64 years,24,29,53
Meath,2009,65 - 69 years,13,37,50
Meath,2009,70 - 74 years,29,61,90
Meath,2009,75 - 79 years,40,54,94
Meath,2009,80 - 84 years,69,73,142
Meath,2009,85 years and over,148,87,235
Meath,2009,Under 1 year,2,6,8
Meath,2010,1 - 4 years,1,2,3
Meath,2010,10 - 14 years,0,2,2
Meath,2010,15 - 19 years,1,3,4
Meath,2010,20 - 24 years,1,2,3
Meath,2010,25 - 29 years,2,2,4
Meath,2010,30 - 34 years,2,3,5
Meath,2010,35 - 39 years,4,7,11
Meath,2010,40 - 44 years,3,13,16
Meath,2010,45 - 49 years,7,7,14
Meath,2010,5 - 9 years,1,0,1
Meath,2010,50 - 54 years,15,7,22
Meath,2010,55 - 59 years,13,19,32
Meath,2010,60 - 64 years,24,16,40
Meath,2010,65 - 69 years,21,41,62
Meath,2010,70 - 74 years,24,44,68
Meath,2010,75 - 79 years,60,54,114
Meath,2010,80 - 84 years,65,64,129
Meath,2010,85 years and over,135,89,224
Meath,2010,Under 1 year,10,3,13
Meath,2011,1 - 4 years,0,1,1
Meath,2011,10 - 14 years,2,0,2
Meath,2011,15 - 19 years,0,2,2
Meath,2011,20 - 24 years,1,7,8
Meath,2011,25 - 29 years,1,3,4
Meath,2011,30 - 34 years,4,5,9
Meath,2011,35 - 39 years,1,9,10
Meath,2011,40 - 44 years,7,5,12
Meath,2011,45 - 49 years,6,10,16
Meath,2011,5 - 9 years,0,0,0
Meath,2011,50 - 54 years,7,13,20
Meath,2011,55 - 59 years,8,23,31
Meath,2011,60 - 64 years,23,39,62
Meath,2011,65 - 69 years,31,43,74
Meath,2011,70 - 74 years,27,48,75
Meath,2011,75 - 79 years,52,48,100
Meath,2011,80 - 84 years,64,66,130
Meath,2011,85 years and over,150,85,235
Meath,2011,Under 1 year,4,10,14
Meath,2012,1 - 4 years,0,3,3
Meath,2012,10 - 14 years,2,1,3
Meath,2012,15 - 19 years,1,2,3
Meath,2012,20 - 24 years,1,3,4
Meath,2012,25 - 29 years,1,4,5
Meath,2012,30 - 34 years,5,8,13
Meath,2012,35 - 39 years,4,9,13
Meath,2012,40 - 44 years,5,5,10
Meath,2012,45 - 49 years,7,6,13
Meath,2012,5 - 9 years,2,2,4
Meath,2012,50 - 54 years,12,19,31
Meath,2012,55 - 59 years,19,27,46
Meath,2012,60 - 64 years,27,53,80
Meath,2012,65 - 69 years,30,34,64
Meath,2012,70 - 74 years,25,40,65
Meath,2012,75 - 79 years,53,66,119
Meath,2012,80 - 84 years,67,73,140
Meath,2012,85 years and over,147,91,238
Meath,2012,Under 1 year,6,6,12
Meath,2013,1 - 4 years,0,0,0
Meath,2013,10 - 14 years,0,1,1
Meath,2013,15 - 19 years,1,1,2
Meath,2013,20 - 24 years,2,2,4
Meath,2013,25 - 29 years,3,0,3
Meath,2013,30 - 34 years,3,11,14
Meath,2013,35 - 39 years,4,9,13
Meath,2013,40 - 44 years,5,5,10
Meath,2013,45 - 49 years,4,13,17
Meath,2013,5 - 9 years,0,0,0
Meath,2013,50 - 54 years,16,16,32
Meath,2013,55 - 59 years,9,25,34
Meath,2013,60 - 64 years,18,40,58
Meath,2013,65 - 69 years,33,38,71
Meath,2013,70 - 74 years,25,43,68
Meath,2013,75 - 79 years,47,60,107
Meath,2013,80 - 84 years,81,64,145
Meath,2013,85 years and over,154,94,248
Meath,2013,Under 1 year,2,5,7
Meath,2014,1 - 4 years,1,0,1
Meath,2014,10 - 14 years,1,1,2
Meath,2014,15 - 19 years,1,1,2
Meath,2014,20 - 24 years,1,3,4
Meath,2014,25 - 29 years,3,6,9
Meath,2014,30 - 34 years,4,6,10
Meath,2014,35 - 39 years,2,7,9
Meath,2014,40 - 44 years,3,10,13
Meath,2014,45 - 49 years,6,12,18
Meath,2014,5 - 9 years,1,0,1
Meath,2014,50 - 54 years,11,11,22
Meath,2014,55 - 59 years,12,23,35
Meath,2014,60 - 64 years,17,32,49
Meath,2014,65 - 69 years,25,49,74
Meath,2014,70 - 74 years,35,46,81
Meath,2014,75 - 79 years,49,60,109
Meath,2014,80 - 84 years,77,60,137
Meath,2014,85 years and over,178,100,278
Meath,2014,Under 1 year,3,4,7
Meath,2015,1 - 4 years,2,0,2
Meath,2015,10 - 14 years,1,1,2
Meath,2015,15 - 19 years,1,3,4
Meath,2015,20 - 24 years,4,4,8
Meath,2015,25 - 29 years,1,3,4
Meath,2015,30 - 34 years,1,2,3
Meath,2015,35 - 39 years,3,8,11
Meath,2015,40 - 44 years,6,5,11
Meath,2015,45 - 49 years,5,17,22
Meath,2015,5 - 9 years,1,0,1
Meath,2015,50 - 54 years,12,12,24
Meath,2015,55 - 59 years,18,23,41
Meath,2015,60 - 64 years,18,31,49
Meath,2015,65 - 69 years,34,40,74
Meath,2015,70 - 74 years,33,68,101
Meath,2015,75 - 79 years,53,64,117
Meath,2015,80 - 84 years,62,77,139
Meath,2015,85 years and over,164,118,282
Meath,2015,Under 1 year,3,4,7
Meath,2016,1 - 4 years,1,0,1
Meath,2016,10 - 14 years,1,1,2
Meath,2016,15 - 19 years,1,2,3
Meath,2016,20 - 24 years,4,5,9
Meath,2016,25 - 29 years,1,2,3
Meath,2016,30 - 34 years,1,6,7
Meath,2016,35 - 39 years,3,5,8
Meath,2016,40 - 44 years,2,10,12
Meath,2016,45 - 49 years,7,11,18
Meath,2016,5 - 9 years,1,0,1
Meath,2016,50 - 54 years,10,9,19
Meath,2016,55 - 59 years,18,21,39
Meath,2016,60 - 64 years,24,43,67
Meath,2016,65 - 69 years,35,39,74
Meath,2016,70 - 74 years,29,61,90
Meath,2016,75 - 79 years,52,61,113
Meath,2016,80 - 84 years,72,77,149
Meath,2016,85 years and over,163,93,256
Meath,2016,Under 1 year,3,2,5
Meath,2017,1 - 4 years,1,1,2
Meath,2017,10 - 14 years,1,1,2
Meath,2017,15 - 19 years,1,2,3
Meath,2017,20 - 24 years,4,4,8
Meath,2017,25 - 29 years,1,4,5
Meath,2017,30 - 34 years,1,3,4
Meath,2017,35 - 39 years,2,7,9
Meath,2017,40 - 44 years,5,15,20
Meath,2017,45 - 49 years,11,11,22
Meath,2017,5 - 9 years,2,1,3
Meath,2017,50 - 54 years,10,15,25
Meath,2017,55 - 59 years,9,23,32
Meath,2017,60 - 64 years,21,30,51
Meath,2017,65 - 69 years,36,40,76
Meath,2017,70 - 74 years,31,61,92
Meath,2017,75 - 79 years,57,72,129
Meath,2017,80 - 84 years,53,88,141
Meath,2017,85 years and over,175,110,285
Meath,2017,Under 1 year,4,2,6
Meath,2018,1 - 4 years,0,1,1
Meath,2018,10 - 14 years,0,0,0
Meath,2018,15 - 19 years,0,2,2
Meath,2018,20 - 24 years,1,3,4
Meath,2018,25 - 29 years,1,1,2
Meath,2018,30 - 34 years,3,3,6
Meath,2018,35 - 39 years,8,2,10
Meath,2018,40 - 44 years,5,10,15
Meath,2018,45 - 49 years,8,9,17
Meath,2018,5 - 9 years,1,1,2
Meath,2018,50 - 54 years,11,18,29
Meath,2018,55 - 59 years,17,30,47
Meath,2018,60 - 64 years,18,27,45
Meath,2018,65 - 69 years,33,39,72
Meath,2018,70 - 74 years,43,62,105
Meath,2018,75 - 79 years,43,81,124
Meath,2018,80 - 84 years,71,85,156
Meath,2018,85 years and over,170,158,328
Meath,2018,Under 1 year,6,7,13
Meath,2019,1 - 4 years,0,3,3
Meath,2019,10 - 14 years,0,0,0
Meath,2019,15 - 19 years,0,0,0
Meath,2019,20 - 24 years,1,5,6
Meath,2019,25 - 29 years,0,5,5
Meath,2019,30 - 34 years,1,4,5
Meath,2019,35 - 39 years,4,6,10
Meath,2019,40 - 44 years,2,13,15
Meath,2019,45 - 49 years,8,12,20
Meath,2019,5 - 9 years,1,1,2
Meath,2019,50 - 54 years,9,13,22
Meath,2019,55 - 59 years,13,24,37
Meath,2019,60 - 64 years,18,27,45
Meath,2019,65 - 69 years,22,39,61
Meath,2019,70 - 74 years,45,73,118
Meath,2019,75 - 79 years,45,80,125
Meath,2019,80 - 84 years,68,72,140
Meath,2019,85 years and over,160,140,300
Meath,2019,Under 1 year,5,8,13
Meath,2020,1 - 4 years,0,3,3
Meath,2020,10 - 14 years,0,0,0
Meath,2020,15 - 19 years,0,3,3
Meath,2020,20 - 24 years,1,1,2
Meath,2020,25 - 29 years,1,4,5
Meath,2020,30 - 34 years,2,7,9
Meath,2020,35 - 39 years,5,6,11
Meath,2020,40 - 44 years,5,15,20
Meath,2020,45 - 49 years,6,12,18
Meath,2020,5 - 9 years,1,1,2
Meath,2020,50 - 54 years,15,19,34
Meath,2020,55 - 59 years,18,19,37
Meath,2020,60 - 64 years,18,34,52
Meath,2020,65 - 69 years,33,48,81
Meath,2020,70 - 74 years,55,73,128
Meath,2020,75 - 79 years,60,79,139
Meath,2020,80 - 84 years,74,67,141
Meath,2020,85 years and over,192,121,313
Meath,2020,Under 1 year,3,3,6
Midleton Town,2007,1 - 4 years,0,0,0
Midleton Town,2007,10 - 14 years,0,0,0
Midleton Town,2007,15 - 19 years,0,0,0
Midleton Town,2007,20 - 24 years,0,0,0
Midleton Town,2007,25 - 29 years,0,1,1
Midleton Town,2007,30 - 34 years,0,0,0
Midleton Town,2007,35 - 39 years,0,0,0
Midleton Town,2007,40 - 44 years,1,0,1
Midleton Town,2007,45 - 49 years,0,2,2
Midleton Town,2007,5 - 9 years,0,0,0
Midleton Town,2007,50 - 54 years,0,0,0
Midleton Town,2007,55 - 59 years,1,1,2
Midleton Town,2007,60 - 64 years,4,0,4
Midleton Town,2007,65 - 69 years,0,2,2
Midleton Town,2007,70 - 74 years,2,1,3
Midleton Town,2007,75 - 79 years,3,1,4
Midleton Town,2007,80 - 84 years,3,2,5
Midleton Town,2007,85 years and over,11,5,16
Midleton Town,2007,Under 1 year,1,0,1
Midleton Town,2008,1 - 4 years,0,0,0
Midleton Town,2008,10 - 14 years,0,0,0
Midleton Town,2008,15 - 19 years,0,2,2
Midleton Town,2008,20 - 24 years,0,1,1
Midleton Town,2008,25 - 29 years,0,1,1
Midleton Town,2008,30 - 34 years,0,0,0
Midleton Town,2008,35 - 39 years,0,0,0
Midleton Town,2008,40 - 44 years,1,0,1
Midleton Town,2008,45 - 49 years,1,2,3
Midleton Town,2008,5 - 9 years,0,0,0
Midleton Town,2008,50 - 54 years,0,1,1
Midleton Town,2008,55 - 59 years,1,1,2
Midleton Town,2008,60 - 64 years,1,1,2
Midleton Town,2008,65 - 69 years,2,1,3
Midleton Town,2008,70 - 74 years,2,5,7
Midleton Town,2008,75 - 79 years,3,4,7
Midleton Town,2008,80 - 84 years,8,5,13
Midleton Town,2008,85 years and over,12,3,15
Midleton Town,2008,Under 1 year,1,1,2
Midleton Town,2009,1 - 4 years,0,1,1
Midleton Town,2009,10 - 14 years,0,0,0
Midleton Town,2009,15 - 19 years,0,2,2
Midleton Town,2009,20 - 24 years,0,1,1
Midleton Town,2009,25 - 29 years,1,1,2
Midleton Town,2009,30 - 34 years,0,1,1
Midleton Town,2009,35 - 39 years,0,0,0
Midleton Town,2009,40 - 44 years,1,0,1
Midleton Town,2009,45 - 49 years,1,2,3
Midleton Town,2009,5 - 9 years,0,0,0
Midleton Town,2009,50 - 54 years,0,2,2
Midleton Town,2009,55 - 59 years,1,1,2
Midleton Town,2009,60 - 64 years,1,1,2
Midleton Town,2009,65 - 69 years,2,1,3
Midleton Town,2009,70 - 74 years,2,4,6
Midleton Town,2009,75 - 79 years,3,2,5
Midleton Town,2009,80 - 84 years,4,4,8
Midleton Town,2009,85 years and over,11,4,15
Midleton Town,2009,Under 1 year,1,1,2
Midleton Town,2010,1 - 4 years,0,1,1
Midleton Town,2010,10 - 14 years,0,0,0
Midleton Town,2010,15 - 19 years,0,2,2
Midleton Town,2010,20 - 24 years,1,1,2
Midleton Town,2010,25 - 29 years,1,1,2
Midleton Town,2010,30 - 34 years,0,1,1
Midleton Town,2010,35 - 39 years,0,0,0
Midleton Town,2010,40 - 44 years,1,0,1
Midleton Town,2010,45 - 49 years,1,1,2
Midleton Town,2010,5 - 9 years,0,0,0
Midleton Town,2010,50 - 54 years,0,2,2
Midleton Town,2010,55 - 59 years,1,1,2
Midleton Town,2010,60 - 64 years,1,1,2
Midleton Town,2010,65 - 69 years,2,3,5
Midleton Town,2010,70 - 74 years,3,1,4
Midleton Town,2010,75 - 79 years,1,1,2
Midleton Town,2010,80 - 84 years,2,4,6
Midleton Town,2010,85 years and over,13,4,17
Midleton Town,2010,Under 1 year,2,1,3
Midleton Town,2011,1 - 4 years,0,0,0
Midleton Town,2011,10 - 14 years,0,0,0
Midleton Town,2011,15 - 19 years,0,0,0
Midleton Town,2011,20 - 24 years,0,0,0
Midleton Town,2011,25 - 29 years,0,0,0
Midleton Town,2011,30 - 34 years,0,0,0
Midleton Town,2011,35 - 39 years,0,0,0
Midleton Town,2011,40 - 44 years,0,0,0
Midleton Town,2011,45 - 49 years,0,0,0
Midleton Town,2011,5 - 9 years,0,0,0
Midleton Town,2011,50 - 54 years,0,1,1
Midleton Town,2011,55 - 59 years,3,4,7
Midleton Town,2011,60 - 64 years,0,4,4
Midleton Town,2011,65 - 69 years,2,2,4
Midleton Town,2011,70 - 74 years,2,2,4
Midleton Town,2011,75 - 79 years,2,3,5
Midleton Town,2011,80 - 84 years,3,5,8
Midleton Town,2011,85 years and over,5,4,9
Midleton Town,2011,Under 1 year,1,1,2
Midleton Town,2012,1 - 4 years,0,0,0
Midleton Town,2012,10 - 14 years,0,0,0
Midleton Town,2012,15 - 19 years,0,0,0
Midleton Town,2012,20 - 24 years,0,0,0
Midleton Town,2012,25 - 29 years,0,0,0
Midleton Town,2012,30 - 34 years,0,0,0
Midleton Town,2012,35 - 39 years,0,1,1
Midleton Town,2012,40 - 44 years,1,1,2
Midleton Town,2012,45 - 49 years,0,2,2
Midleton Town,2012,5 - 9 years,0,0,0
Midleton Town,2012,50 - 54 years,0,4,4
Midleton Town,2012,55 - 59 years,3,2,5
Midleton Town,2012,60 - 64 years,1,1,2
Midleton Town,2012,65 - 69 years,1,3,4
Midleton Town,2012,70 - 74 years,1,4,5
Midleton Town,2012,75 - 79 years,6,2,8
Midleton Town,2012,80 - 84 years,2,5,7
Midleton Town,2012,85 years and over,17,6,23
Midleton Town,2012,Under 1 year,1,2,3
Midleton Town,2013,1 - 4 years,0,0,0
Midleton Town,2013,10 - 14 years,0,0,0
Midleton Town,2013,15 - 19 years,0,0,0
Midleton Town,2013,20 - 24 years,0,0,0
Midleton Town,2013,25 - 29 years,0,0,0
Midleton Town,2013,30 - 34 years,0,0,0
Midleton Town,2013,35 - 39 years,0,0,0
Midleton Town,2013,40 - 44 years,1,1,2
Midleton Town,2013,45 - 49 years,0,2,2
Midleton Town,2013,5 - 9 years,0,0,0
Midleton Town,2013,50 - 54 years,1,3,4
Midleton Town,2013,55 - 59 years,0,0,0
Midleton Town,2013,60 - 64 years,2,0,2
Midleton Town,2013,65 - 69 years,2,1,3
Midleton Town,2013,70 - 74 years,1,0,1
Midleton Town,2013,75 - 79 years,5,4,9
Midleton Town,2013,80 - 84 years,1,3,4
Midleton Town,2013,85 years and over,9,3,12
Midleton Town,2013,Under 1 year,0,0,0
Midleton Town,2014,1 - 4 years,0,0,0
Midleton Town,2014,10 - 14 years,0,0,0
Midleton Town,2014,15 - 19 years,0,0,0
Midleton Town,2014,20 - 24 years,1,0,1
Midleton Town,2014,25 - 29 years,0,0,0
Midleton Town,2014,30 - 34 years,0,0,0
Midleton Town,2014,35 - 39 years,0,0,0
Midleton Town,2014,40 - 44 years,1,1,2
Midleton Town,2014,45 - 49 years,0,1,1
Midleton Town,2014,5 - 9 years,0,0,0
Midleton Town,2014,50 - 54 years,1,3,4
Midleton Town,2014,55 - 59 years,0,2,2
Midleton Town,2014,60 - 64 years,2,1,3
Midleton Town,2014,65 - 69 years,2,4,6
Midleton Town,2014,70 - 74 years,1,4,5
Midleton Town,2014,75 - 79 years,1,4,5
Midleton Town,2014,80 - 84 years,4,3,7
Midleton Town,2014,85 years and over,13,8,21
Midleton Town,2014,Under 1 year,0,0,0
Midleton Town,2015,1 - 4 years,0,0,0
Midleton Town,2015,10 - 14 years,0,0,0
Midleton Town,2015,15 - 19 years,0,0,0
Midleton Town,2015,20 - 24 years,1,0,1
Midleton Town,2015,25 - 29 years,0,0,0
Midleton Town,2015,30 - 34 years,0,0,0
Midleton Town,2015,35 - 39 years,0,0,0
Midleton Town,2015,40 - 44 years,1,1,2
Midleton Town,2015,45 - 49 years,0,1,1
Midleton Town,2015,5 - 9 years,0,0,0
Midleton Town,2015,50 - 54 years,1,3,4
Midleton Town,2015,55 - 59 years,0,2,2
Midleton Town,2015,60 - 64 years,2,1,3
Midleton Town,2015,65 - 69 years,2,4,6
Midleton Town,2015,70 - 74 years,1,4,5
Midleton Town,2015,75 - 79 years,1,4,5
Midleton Town,2015,80 - 84 years,4,3,7
Midleton Town,2015,85 years and over,13,8,21
Midleton Town,2015,Under 1 year,0,0,0
Midleton Town,2016,1 - 4 years,0,0,0
Midleton Town,2016,10 - 14 years,0,0,0
Midleton Town,2016,15 - 19 years,0,0,0
Midleton Town,2016,20 - 24 years,1,0,1
Midleton Town,2016,25 - 29 years,0,0,0
Midleton Town,2016,30 - 34 years,0,0,0
Midleton Town,2016,35 - 39 years,0,0,0
Midleton Town,2016,40 - 44 years,1,1,2
Midleton Town,2016,45 - 49 years,0,1,1
Midleton Town,2016,5 - 9 years,0,0,0
Midleton Town,2016,50 - 54 years,1,3,4
Midleton Town,2016,55 - 59 years,0,2,2
Midleton Town,2016,60 - 64 years,2,1,3
Midleton Town,2016,65 - 69 years,2,4,6
Midleton Town,2016,70 - 74 years,1,4,5
Midleton Town,2016,75 - 79 years,1,4,5
Midleton Town,2016,80 - 84 years,4,3,7
Midleton Town,2016,85 years and over,13,8,21
Midleton Town,2016,Under 1 year,0,0,0
Midleton Town,2017,1 - 4 years,0,0,0
Midleton Town,2017,10 - 14 years,0,0,0
Midleton Town,2017,15 - 19 years,0,0,0
Midleton Town,2017,20 - 24 years,1,0,1
Midleton Town,2017,25 - 29 years,0,0,0
Midleton Town,2017,30 - 34 years,0,0,0
Midleton Town,2017,35 - 39 years,0,1,1
Midleton Town,2017,40 - 44 years,1,1,2
Midleton Town,2017,45 - 49 years,1,1,2
Midleton Town,2017,5 - 9 years,0,0,0
Midleton Town,2017,50 - 54 years,1,1,2
Midleton Town,2017,55 - 59 years,0,2,2
Midleton Town,2017,60 - 64 years,1,2,3
Midleton Town,2017,65 - 69 years,3,4,7
Midleton Town,2017,70 - 74 years,2,2,4
Midleton Town,2017,75 - 79 years,2,1,3
Midleton Town,2017,80 - 84 years,2,2,4
Midleton Town,2017,85 years and over,10,3,13
Midleton Town,2017,Under 1 year,0,0,0
Midleton Town,2018,1 - 4 years,0,0,0
Midleton Town,2018,10 - 14 years,1,0,1
Midleton Town,2018,15 - 19 years,0,0,0
Midleton Town,2018,20 - 24 years,0,0,0
Midleton Town,2018,25 - 29 years,0,0,0
Midleton Town,2018,30 - 34 years,0,0,0
Midleton Town,2018,35 - 39 years,1,0,1
Midleton Town,2018,40 - 44 years,0,0,0
Midleton Town,2018,45 - 49 years,1,1,2
Midleton Town,2018,5 - 9 years,0,0,0
Midleton Town,2018,50 - 54 years,1,0,1
Midleton Town,2018,55 - 59 years,2,1,3
Midleton Town,2018,60 - 64 years,2,3,5
Midleton Town,2018,65 - 69 years,1,1,2
Midleton Town,2018,70 - 74 years,4,3,7
Midleton Town,2018,75 - 79 years,1,2,3
Midleton Town,2018,80 - 84 years,7,1,8
Midleton Town,2018,85 years and over,9,6,15
Midleton Town,2018,Under 1 year,0,0,0
Midleton Town,2019,1 - 4 years,0,0,0
Midleton Town,2019,10 - 14 years,1,0,1
Midleton Town,2019,15 - 19 years,0,0,0
Midleton Town,2019,20 - 24 years,0,0,0
Midleton Town,2019,25 - 29 years,0,0,0
Midleton Town,2019,30 - 34 years,0,0,0
Midleton Town,2019,35 - 39 years,1,0,1
Midleton Town,2019,40 - 44 years,0,0,0
Midleton Town,2019,45 - 49 years,1,1,2
Midleton Town,2019,5 - 9 years,0,0,0
Midleton Town,2019,50 - 54 years,1,0,1
Midleton Town,2019,55 - 59 years,2,1,3
Midleton Town,2019,60 - 64 years,2,3,5
Midleton Town,2019,65 - 69 years,1,1,2
Midleton Town,2019,70 - 74 years,4,3,7
Midleton Town,2019,75 - 79 years,1,2,3
Midleton Town,2019,80 - 84 years,7,1,8
Midleton Town,2019,85 years and over,9,6,15
Midleton Town,2019,Under 1 year,0,0,0
Midleton Town,2020,1 - 4 years,0,0,0
Midleton Town,2020,10 - 14 years,1,0,1
Midleton Town,2020,15 - 19 years,0,0,0
Midleton Town,2020,20 - 24 years,0,0,0
Midleton Town,2020,25 - 29 years,0,0,0
Midleton Town,2020,30 - 34 years,0,0,0
Midleton Town,2020,35 - 39 years,1,0,1
Midleton Town,2020,40 - 44 years,0,0,0
Midleton Town,2020,45 - 49 years,1,1,2
Midleton Town,2020,5 - 9 years,0,0,0
Midleton Town,2020,50 - 54 years,1,0,1
Midleton Town,2020,55 - 59 years,2,1,3
Midleton Town,2020,60 - 64 years,2,3,5
Midleton Town,2020,65 - 69 years,1,1,2
Midleton Town,2020,70 - 74 years,4,3,7
Midleton Town,2020,75 - 79 years,1,2,3
Midleton Town,2020,80 - 84 years,7,1,8
Midleton Town,2020,85 years and over,9,6,15
Midleton Town,2020,Under 1 year,0,0,0
Monaghan,2007,1 - 4 years,1,2,3
Monaghan,2007,10 - 14 years,0,0,0
Monaghan,2007,15 - 19 years,0,2,2
Monaghan,2007,20 - 24 years,0,0,0
Monaghan,2007,25 - 29 years,0,1,1
Monaghan,2007,30 - 34 years,0,4,4
Monaghan,2007,35 - 39 years,2,1,3
Monaghan,2007,40 - 44 years,2,3,5
Monaghan,2007,45 - 49 years,1,2,3
Monaghan,2007,5 - 9 years,0,2,2
Monaghan,2007,50 - 54 years,4,4,8
Monaghan,2007,55 - 59 years,5,12,17
Monaghan,2007,60 - 64 years,8,16,24
Monaghan,2007,65 - 69 years,17,15,32
Monaghan,2007,70 - 74 years,20,24,44
Monaghan,2007,75 - 79 years,26,37,63
Monaghan,2007,80 - 84 years,40,40,80
Monaghan,2007,85 years and over,94,47,141
Monaghan,2007,Under 1 year,0,0,0
Monaghan,2008,1 - 4 years,1,2,3
Monaghan,2008,10 - 14 years,0,0,0
Monaghan,2008,15 - 19 years,0,2,2
Monaghan,2008,20 - 24 years,0,3,3
Monaghan,2008,25 - 29 years,2,1,3
Monaghan,2008,30 - 34 years,0,4,4
Monaghan,2008,35 - 39 years,1,1,2
Monaghan,2008,40 - 44 years,4,1,5
Monaghan,2008,45 - 49 years,3,1,4
Monaghan,2008,5 - 9 years,0,2,2
Monaghan,2008,50 - 54 years,6,6,12
Monaghan,2008,55 - 59 years,3,8,11
Monaghan,2008,60 - 64 years,6,18,24
Monaghan,2008,65 - 69 years,10,13,23
Monaghan,2008,70 - 74 years,14,23,37
Monaghan,2008,75 - 79 years,22,30,52
Monaghan,2008,80 - 84 years,36,45,81
Monaghan,2008,85 years and over,65,44,109
Monaghan,2008,Under 1 year,2,1,3
Monaghan,2009,1 - 4 years,1,1,2
Monaghan,2009,10 - 14 years,0,0,0
Monaghan,2009,15 - 19 years,1,1,2
Monaghan,2009,20 - 24 years,0,2,2
Monaghan,2009,25 - 29 years,2,3,5
Monaghan,2009,30 - 34 years,2,1,3
Monaghan,2009,35 - 39 years,2,1,3
Monaghan,2009,40 - 44 years,2,4,6
Monaghan,2009,45 - 49 years,2,11,13
Monaghan,2009,5 - 9 years,0,2,2
Monaghan,2009,50 - 54 years,5,9,14
Monaghan,2009,55 - 59 years,6,14,20
Monaghan,2009,60 - 64 years,8,14,22
Monaghan,2009,65 - 69 years,14,15,29
Monaghan,2009,70 - 74 years,16,26,42
Monaghan,2009,75 - 79 years,28,32,60
Monaghan,2009,80 - 84 years,41,43,84
Monaghan,2009,85 years and over,87,41,128
Monaghan,2009,Under 1 year,1,1,2
Monaghan,2010,1 - 4 years,1,1,2
Monaghan,2010,10 - 14 years,0,0,0
Monaghan,2010,15 - 19 years,1,1,2
Monaghan,2010,20 - 24 years,0,2,2
Monaghan,2010,25 - 29 years,2,2,4
Monaghan,2010,30 - 34 years,2,3,5
Monaghan,2010,35 - 39 years,1,1,2
Monaghan,2010,40 - 44 years,2,3,5
Monaghan,2010,45 - 49 years,4,8,12
Monaghan,2010,5 - 9 years,0,2,2
Monaghan,2010,50 - 54 years,4,6,10
Monaghan,2010,55 - 59 years,5,14,19
Monaghan,2010,60 - 64 years,6,13,19
Monaghan,2010,65 - 69 years,14,15,29
Monaghan,2010,70 - 74 years,13,13,26
Monaghan,2010,75 - 79 years,25,42,67
Monaghan,2010,80 - 84 years,43,39,82
Monaghan,2010,85 years and over,68,40,108
Monaghan,2010,Under 1 year,5,1,6
Monaghan,2011,1 - 4 years,0,0,0
Monaghan,2011,10 - 14 years,1,0,1
Monaghan,2011,15 - 19 years,2,1,3
Monaghan,2011,20 - 24 years,1,2,3
Monaghan,2011,25 - 29 years,1,3,4
Monaghan,2011,30 - 34 years,2,4,6
Monaghan,2011,35 - 39 years,2,3,5
Monaghan,2011,40 - 44 years,0,0,0
Monaghan,2011,45 - 49 years,5,5,10
Monaghan,2011,5 - 9 years,0,0,0
Monaghan,2011,50 - 54 years,3,7,10
Monaghan,2011,55 - 59 years,2,14,16
Monaghan,2011,60 - 64 years,7,21,28
Monaghan,2011,65 - 69 years,21,16,37
Monaghan,2011,70 - 74 years,13,20,33
Monaghan,2011,75 - 79 years,18,39,57
Monaghan,2011,80 - 84 years,34,31,65
Monaghan,2011,85 years and over,70,57,127
Monaghan,2011,Under 1 year,2,1,3
Monaghan,2012,1 - 4 years,1,1,2
Monaghan,2012,10 - 14 years,2,2,4
Monaghan,2012,15 - 19 years,2,2,4
Monaghan,2012,20 - 24 years,1,2,3
Monaghan,2012,25 - 29 years,1,3,4
Monaghan,2012,30 - 34 years,2,2,4
Monaghan,2012,35 - 39 years,4,3,7
Monaghan,2012,40 - 44 years,3,2,5
Monaghan,2012,45 - 49 years,5,4,9
Monaghan,2012,5 - 9 years,1,0,1
Monaghan,2012,50 - 54 years,5,8,13
Monaghan,2012,55 - 59 years,11,8,19
Monaghan,2012,60 - 64 years,8,19,27
Monaghan,2012,65 - 69 years,13,19,32
Monaghan,2012,70 - 74 years,12,23,35
Monaghan,2012,75 - 79 years,19,21,40
Monaghan,2012,80 - 84 years,39,34,73
Monaghan,2012,85 years and over,95,51,146
Monaghan,2012,Under 1 year,2,1,3
Monaghan,2013,1 - 4 years,0,0,0
Monaghan,2013,10 - 14 years,1,0,1
Monaghan,2013,15 - 19 years,0,1,1
Monaghan,2013,20 - 24 years,0,3,3
Monaghan,2013,25 - 29 years,0,1,1
Monaghan,2013,30 - 34 years,3,1,4
Monaghan,2013,35 - 39 years,1,2,3
Monaghan,2013,40 - 44 years,2,5,7
Monaghan,2013,45 - 49 years,2,5,7
Monaghan,2013,5 - 9 years,0,0,0
Monaghan,2013,50 - 54 years,8,6,14
Monaghan,2013,55 - 59 years,2,8,10
Monaghan,2013,60 - 64 years,10,11,21
Monaghan,2013,65 - 69 years,13,22,35
Monaghan,2013,70 - 74 years,11,20,31
Monaghan,2013,75 - 79 years,23,26,49
Monaghan,2013,80 - 84 years,33,37,70
Monaghan,2013,85 years and over,89,59,148
Monaghan,2013,Under 1 year,2,5,7
Monaghan,2014,1 - 4 years,0,1,1
Monaghan,2014,10 - 14 years,1,0,1
Monaghan,2014,15 - 19 years,0,1,1
Monaghan,2014,20 - 24 years,0,1,1
Monaghan,2014,25 - 29 years,0,3,3
Monaghan,2014,30 - 34 years,2,2,4
Monaghan,2014,35 - 39 years,1,1,2
Monaghan,2014,40 - 44 years,2,6,8
Monaghan,2014,45 - 49 years,3,2,5
Monaghan,2014,5 - 9 years,0,1,1
Monaghan,2014,50 - 54 years,4,8,12
Monaghan,2014,55 - 59 years,7,11,18
Monaghan,2014,60 - 64 years,4,8,12
Monaghan,2014,65 - 69 years,14,21,35
Monaghan,2014,70 - 74 years,16,28,44
Monaghan,2014,75 - 79 years,17,31,48
Monaghan,2014,80 - 84 years,38,36,74
Monaghan,2014,85 years and over,86,72,158
Monaghan,2014,Under 1 year,2,2,4
Monaghan,2015,1 - 4 years,0,1,1
Monaghan,2015,10 - 14 years,1,0,1
Monaghan,2015,15 - 19 years,0,1,1
Monaghan,2015,20 - 24 years,0,1,1
Monaghan,2015,25 - 29 years,0,1,1
Monaghan,2015,30 - 34 years,2,2,4
Monaghan,2015,35 - 39 years,1,5,6
Monaghan,2015,40 - 44 years,1,4,5
Monaghan,2015,45 - 49 years,2,5,7
Monaghan,2015,5 - 9 years,0,1,1
Monaghan,2015,50 - 54 years,7,3,10
Monaghan,2015,55 - 59 years,5,10,15
Monaghan,2015,60 - 64 years,11,11,22
Monaghan,2015,65 - 69 years,11,21,32
Monaghan,2015,70 - 74 years,17,26,43
Monaghan,2015,75 - 79 years,22,26,48
Monaghan,2015,80 - 84 years,39,31,70
Monaghan,2015,85 years and over,90,55,145
Monaghan,2015,Under 1 year,2,2,4
Monaghan,2016,1 - 4 years,0,1,1
Monaghan,2016,10 - 14 years,1,0,1
Monaghan,2016,15 - 19 years,0,1,1
Monaghan,2016,20 - 24 years,0,2,2
Monaghan,2016,25 - 29 years,0,1,1
Monaghan,2016,30 - 34 years,2,4,6
Monaghan,2016,35 - 39 years,2,1,3
Monaghan,2016,40 - 44 years,1,3,4
Monaghan,2016,45 - 49 years,2,6,8
Monaghan,2016,5 - 9 years,0,1,1
Monaghan,2016,50 - 54 years,6,12,18
Monaghan,2016,55 - 59 years,6,8,14
Monaghan,2016,60 - 64 years,3,14,17
Monaghan,2016,65 - 69 years,14,16,30
Monaghan,2016,70 - 74 years,16,29,45
Monaghan,2016,75 - 79 years,30,27,57
Monaghan,2016,80 - 84 years,33,38,71
Monaghan,2016,85 years and over,100,54,154
Monaghan,2016,Under 1 year,1,3,4
Monaghan,2017,1 - 4 years,0,1,1
Monaghan,2017,10 - 14 years,1,0,1
Monaghan,2017,15 - 19 years,1,1,2
Monaghan,2017,20 - 24 years,0,1,1
Monaghan,2017,25 - 29 years,2,1,3
Monaghan,2017,30 - 34 years,2,2,4
Monaghan,2017,35 - 39 years,2,1,3
Monaghan,2017,40 - 44 years,1,9,10
Monaghan,2017,45 - 49 years,3,3,6
Monaghan,2017,5 - 9 years,2,1,3
Monaghan,2017,50 - 54 years,7,5,12
Monaghan,2017,55 - 59 years,5,7,12
Monaghan,2017,60 - 64 years,8,17,25
Monaghan,2017,65 - 69 years,7,17,24
Monaghan,2017,70 - 74 years,19,20,39
Monaghan,2017,75 - 79 years,18,38,56
Monaghan,2017,80 - 84 years,39,38,77
Monaghan,2017,85 years and over,101,50,151
Monaghan,2017,Under 1 year,2,1,3
Monaghan,2018,1 - 4 years,0,0,0
Monaghan,2018,10 - 14 years,1,0,1
Monaghan,2018,15 - 19 years,1,1,2
Monaghan,2018,20 - 24 years,0,1,1
Monaghan,2018,25 - 29 years,0,0,0
Monaghan,2018,30 - 34 years,0,1,1
Monaghan,2018,35 - 39 years,1,3,4
Monaghan,2018,40 - 44 years,2,1,3
Monaghan,2018,45 - 49 years,0,4,4
Monaghan,2018,5 - 9 years,0,0,0
Monaghan,2018,50 - 54 years,6,8,14
Monaghan,2018,55 - 59 years,7,8,15
Monaghan,2018,60 - 64 years,3,13,16
Monaghan,2018,65 - 69 years,14,23,37
Monaghan,2018,70 - 74 years,17,26,43
Monaghan,2018,75 - 79 years,26,29,55
Monaghan,2018,80 - 84 years,19,49,68
Monaghan,2018,85 years and over,91,68,159
Monaghan,2018,Under 1 year,1,1,2
Monaghan,2019,1 - 4 years,0,0,0
Monaghan,2019,10 - 14 years,0,0,0
Monaghan,2019,15 - 19 years,1,1,2
Monaghan,2019,20 - 24 years,0,0,0
Monaghan,2019,25 - 29 years,1,1,2
Monaghan,2019,30 - 34 years,0,0,0
Monaghan,2019,35 - 39 years,4,4,8
Monaghan,2019,40 - 44 years,3,3,6
Monaghan,2019,45 - 49 years,4,4,8
Monaghan,2019,5 - 9 years,0,0,0
Monaghan,2019,50 - 54 years,7,7,14
Monaghan,2019,55 - 59 years,5,5,10
Monaghan,2019,60 - 64 years,18,18,36
Monaghan,2019,65 - 69 years,18,18,36
Monaghan,2019,70 - 74 years,20,20,40
Monaghan,2019,75 - 79 years,31,31,62
Monaghan,2019,80 - 84 years,36,36,72
Monaghan,2019,85 years and over,65,65,130
Monaghan,2019,Under 1 year,0,0,0
Monaghan,2020,1 - 4 years,0,1,1
Monaghan,2020,10 - 14 years,0,1,1
Monaghan,2020,15 - 19 years,1,2,3
Monaghan,2020,20 - 24 years,0,1,1
Monaghan,2020,25 - 29 years,1,2,3
Monaghan,2020,30 - 34 years,0,0,0
Monaghan,2020,35 - 39 years,1,4,5
Monaghan,2020,40 - 44 years,3,2,5
Monaghan,2020,45 - 49 years,3,6,9
Monaghan,2020,5 - 9 years,0,0,0
Monaghan,2020,50 - 54 years,3,5,8
Monaghan,2020,55 - 59 years,6,15,21
Monaghan,2020,60 - 64 years,12,14,26
Monaghan,2020,65 - 69 years,9,17,26
Monaghan,2020,70 - 74 years,18,22,40
Monaghan,2020,75 - 79 years,27,32,59
Monaghan,2020,80 - 84 years,35,32,67
Monaghan,2020,85 years and over,106,76,182
Monaghan,2020,Under 1 year,0,0,0
Monaghan Town,2007,1 - 4 years,0,0,0
Monaghan Town,2007,10 - 14 years,0,0,0
Monaghan Town,2007,15 - 19 years,0,0,0
Monaghan Town,2007,20 - 24 years,0,0,0
Monaghan Town,2007,25 - 29 years,0,1,1
Monaghan Town,2007,30 - 34 years,0,0,0
Monaghan Town,2007,35 - 39 years,0,0,0
Monaghan Town,2007,40 - 44 years,1,1,2
Monaghan Town,2007,45 - 49 years,0,0,0
Monaghan Town,2007,5 - 9 years,0,0,0
Monaghan Town,2007,50 - 54 years,1,1,2
Monaghan Town,2007,55 - 59 years,0,2,2
Monaghan Town,2007,60 - 64 years,3,1,4
Monaghan Town,2007,65 - 69 years,4,0,4
Monaghan Town,2007,70 - 74 years,3,4,7
Monaghan Town,2007,75 - 79 years,3,4,7
Monaghan Town,2007,80 - 84 years,7,1,8
Monaghan Town,2007,85 years and over,8,3,11
Monaghan Town,2007,Under 1 year,0,0,0
Monaghan Town,2008,1 - 4 years,0,0,0
Monaghan Town,2008,10 - 14 years,0,0,0
Monaghan Town,2008,15 - 19 years,0,0,0
Monaghan Town,2008,20 - 24 years,0,0,0
Monaghan Town,2008,25 - 29 years,0,1,1
Monaghan Town,2008,30 - 34 years,0,0,0
Monaghan Town,2008,35 - 39 years,0,0,0
Monaghan Town,2008,40 - 44 years,1,1,2
Monaghan Town,2008,45 - 49 years,0,0,0
Monaghan Town,2008,5 - 9 years,0,0,0
Monaghan Town,2008,50 - 54 years,1,1,2
Monaghan Town,2008,55 - 59 years,1,2,3
Monaghan Town,2008,60 - 64 years,1,2,3
Monaghan Town,2008,65 - 69 years,4,1,5
Monaghan Town,2008,70 - 74 years,4,5,9
Monaghan Town,2008,75 - 79 years,5,4,9
Monaghan Town,2008,80 - 84 years,6,7,13
Monaghan Town,2008,85 years and over,10,4,14
Monaghan Town,2008,Under 1 year,0,0,0
Monaghan Town,2009,1 - 4 years,0,0,0
Monaghan Town,2009,10 - 14 years,0,0,0
Monaghan Town,2009,15 - 19 years,0,1,1
Monaghan Town,2009,20 - 24 years,0,0,0
Monaghan Town,2009,25 - 29 years,0,1,1
Monaghan Town,2009,30 - 34 years,0,0,0
Monaghan Town,2009,35 - 39 years,0,0,0
Monaghan Town,2009,40 - 44 years,1,1,2
Monaghan Town,2009,45 - 49 years,0,0,0
Monaghan Town,2009,5 - 9 years,0,0,0
Monaghan Town,2009,50 - 54 years,1,3,4
Monaghan Town,2009,55 - 59 years,1,3,4
Monaghan Town,2009,60 - 64 years,2,2,4
Monaghan Town,2009,65 - 69 years,2,1,3
Monaghan Town,2009,70 - 74 years,3,3,6
Monaghan Town,2009,75 - 79 years,2,1,3
Monaghan Town,2009,80 - 84 years,3,6,9
Monaghan Town,2009,85 years and over,14,2,16
Monaghan Town,2009,Under 1 year,0,0,0
Monaghan Town,2010,1 - 4 years,0,0,0
Monaghan Town,2010,10 - 14 years,0,0,0
Monaghan Town,2010,15 - 19 years,0,1,1
Monaghan Town,2010,20 - 24 years,0,0,0
Monaghan Town,2010,25 - 29 years,0,1,1
Monaghan Town,2010,30 - 34 years,0,0,0
Monaghan Town,2010,35 - 39 years,0,0,0
Monaghan Town,2010,40 - 44 years,1,1,2
Monaghan Town,2010,45 - 49 years,0,0,0
Monaghan Town,2010,5 - 9 years,0,0,0
Monaghan Town,2010,50 - 54 years,1,1,2
Monaghan Town,2010,55 - 59 years,3,2,5
Monaghan Town,2010,60 - 64 years,1,1,2
Monaghan Town,2010,65 - 69 years,2,1,3
Monaghan Town,2010,70 - 74 years,3,2,5
Monaghan Town,2010,75 - 79 years,3,3,6
Monaghan Town,2010,80 - 84 years,2,4,6
Monaghan Town,2010,85 years and over,5,3,8
Monaghan Town,2010,Under 1 year,2,0,2
Monaghan Town,2011,1 - 4 years,0,0,0
Monaghan Town,2011,10 - 14 years,0,0,0
Monaghan Town,2011,15 - 19 years,0,0,0
Monaghan Town,2011,20 - 24 years,0,0,0
Monaghan Town,2011,25 - 29 years,0,0,0
Monaghan Town,2011,30 - 34 years,1,0,1
Monaghan Town,2011,35 - 39 years,0,0,0
Monaghan Town,2011,40 - 44 years,0,0,0
Monaghan Town,2011,45 - 49 years,1,0,1
Monaghan Town,2011,5 - 9 years,0,0,0
Monaghan Town,2011,50 - 54 years,1,1,2
Monaghan Town,2011,55 - 59 years,0,1,1
Monaghan Town,2011,60 - 64 years,2,3,5
Monaghan Town,2011,65 - 69 years,4,2,6
Monaghan Town,2011,70 - 74 years,1,1,2
Monaghan Town,2011,75 - 79 years,3,5,8
Monaghan Town,2011,80 - 84 years,0,2,2
Monaghan Town,2011,85 years and over,4,2,6
Monaghan Town,2011,Under 1 year,1,0,1
Monaghan Town,2012,1 - 4 years,0,0,0
Monaghan Town,2012,10 - 14 years,1,0,1
Monaghan Town,2012,15 - 19 years,0,0,0
Monaghan Town,2012,20 - 24 years,0,0,0
Monaghan Town,2012,25 - 29 years,0,2,2
Monaghan Town,2012,30 - 34 years,1,0,1
Monaghan Town,2012,35 - 39 years,0,1,1
Monaghan Town,2012,40 - 44 years,0,0,0
Monaghan Town,2012,45 - 49 years,1,0,1
Monaghan Town,2012,5 - 9 years,0,0,0
Monaghan Town,2012,50 - 54 years,2,1,3
Monaghan Town,2012,55 - 59 years,1,1,2
Monaghan Town,2012,60 - 64 years,2,3,5
Monaghan Town,2012,65 - 69 years,2,1,3
Monaghan Town,2012,70 - 74 years,1,2,3
Monaghan Town,2012,75 - 79 years,3,3,6
Monaghan Town,2012,80 - 84 years,5,4,9
Monaghan Town,2012,85 years and over,9,3,12
Monaghan Town,2012,Under 1 year,1,0,1
Monaghan Town,2013,1 - 4 years,0,0,0
Monaghan Town,2013,10 - 14 years,0,0,0
Monaghan Town,2013,15 - 19 years,0,0,0
Monaghan Town,2013,20 - 24 years,0,0,0
Monaghan Town,2013,25 - 29 years,0,0,0
Monaghan Town,2013,30 - 34 years,1,0,1
Monaghan Town,2013,35 - 39 years,0,0,0
Monaghan Town,2013,40 - 44 years,1,0,1
Monaghan Town,2013,45 - 49 years,0,1,1
Monaghan Town,2013,5 - 9 years,0,0,0
Monaghan Town,2013,50 - 54 years,1,0,1
Monaghan Town,2013,55 - 59 years,0,0,0
Monaghan Town,2013,60 - 64 years,2,2,4
Monaghan Town,2013,65 - 69 years,1,3,4
Monaghan Town,2013,70 - 74 years,1,2,3
Monaghan Town,2013,75 - 79 years,3,4,7
Monaghan Town,2013,80 - 84 years,4,6,10
Monaghan Town,2013,85 years and over,14,2,16
Monaghan Town,2013,Under 1 year,0,0,0
Monaghan Town,2014,1 - 4 years,0,0,0
Monaghan Town,2014,10 - 14 years,0,0,0
Monaghan Town,2014,15 - 19 years,0,0,0
Monaghan Town,2014,20 - 24 years,0,1,1
Monaghan Town,2014,25 - 29 years,0,1,1
Monaghan Town,2014,30 - 34 years,1,0,1
Monaghan Town,2014,35 - 39 years,1,0,1
Monaghan Town,2014,40 - 44 years,1,0,1
Monaghan Town,2014,45 - 49 years,0,1,1
Monaghan Town,2014,5 - 9 years,0,0,0
Monaghan Town,2014,50 - 54 years,1,1,2
Monaghan Town,2014,55 - 59 years,0,1,1
Monaghan Town,2014,60 - 64 years,1,1,2
Monaghan Town,2014,65 - 69 years,2,5,7
Monaghan Town,2014,70 - 74 years,3,3,6
Monaghan Town,2014,75 - 79 years,3,7,10
Monaghan Town,2014,80 - 84 years,8,4,12
Monaghan Town,2014,85 years and over,17,9,26
Monaghan Town,2014,Under 1 year,0,0,0
Monaghan Town,2015,1 - 4 years,0,0,0
Monaghan Town,2015,10 - 14 years,0,0,0
Monaghan Town,2015,15 - 19 years,0,0,0
Monaghan Town,2015,20 - 24 years,0,1,1
Monaghan Town,2015,25 - 29 years,0,1,1
Monaghan Town,2015,30 - 34 years,1,0,1
Monaghan Town,2015,35 - 39 years,1,0,1
Monaghan Town,2015,40 - 44 years,1,0,1
Monaghan Town,2015,45 - 49 years,0,1,1
Monaghan Town,2015,5 - 9 years,0,0,0
Monaghan Town,2015,50 - 54 years,1,1,2
Monaghan Town,2015,55 - 59 years,0,1,1
Monaghan Town,2015,60 - 64 years,1,1,2
Monaghan Town,2015,65 - 69 years,2,5,7
Monaghan Town,2015,70 - 74 years,3,3,6
Monaghan Town,2015,75 - 79 years,3,7,10
Monaghan Town,2015,80 - 84 years,8,4,12
Monaghan Town,2015,85 years and over,17,9,26
Monaghan Town,2015,Under 1 year,0,0,0
Monaghan Town,2016,1 - 4 years,0,0,0
Monaghan Town,2016,10 - 14 years,0,0,0
Monaghan Town,2016,15 - 19 years,0,0,0
Monaghan Town,2016,20 - 24 years,0,1,1
Monaghan Town,2016,25 - 29 years,0,1,1
Monaghan Town,2016,30 - 34 years,1,0,1
Monaghan Town,2016,35 - 39 years,1,0,1
Monaghan Town,2016,40 - 44 years,1,0,1
Monaghan Town,2016,45 - 49 years,0,1,1
Monaghan Town,2016,5 - 9 years,0,0,0
Monaghan Town,2016,50 - 54 years,1,1,2
Monaghan Town,2016,55 - 59 years,0,1,1
Monaghan Town,2016,60 - 64 years,1,1,2
Monaghan Town,2016,65 - 69 years,2,5,7
Monaghan Town,2016,70 - 74 years,3,3,6
Monaghan Town,2016,75 - 79 years,3,7,10
Monaghan Town,2016,80 - 84 years,8,4,12
Monaghan Town,2016,85 years and over,17,9,26
Monaghan Town,2016,Under 1 year,0,0,0
Monaghan Town,2017,1 - 4 years,0,0,0
Monaghan Town,2017,10 - 14 years,0,0,0
Monaghan Town,2017,15 - 19 years,0,0,0
Monaghan Town,2017,20 - 24 years,0,1,1
Monaghan Town,2017,25 - 29 years,0,1,1
Monaghan Town,2017,30 - 34 years,1,1,2
Monaghan Town,2017,35 - 39 years,1,0,1
Monaghan Town,2017,40 - 44 years,1,1,2
Monaghan Town,2017,45 - 49 years,0,1,1
Monaghan Town,2017,5 - 9 years,0,0,0
Monaghan Town,2017,50 - 54 years,1,1,2
Monaghan Town,2017,55 - 59 years,1,1,2
Monaghan Town,2017,60 - 64 years,3,1,4
Monaghan Town,2017,65 - 69 years,2,3,5
Monaghan Town,2017,70 - 74 years,4,6,10
Monaghan Town,2017,75 - 79 years,5,4,9
Monaghan Town,2017,80 - 84 years,9,7,16
Monaghan Town,2017,85 years and over,14,11,25
Monaghan Town,2017,Under 1 year,0,0,0
Monaghan Town,2018,1 - 4 years,0,0,0
Monaghan Town,2018,10 - 14 years,0,0,0
Monaghan Town,2018,15 - 19 years,0,0,0
Monaghan Town,2018,20 - 24 years,0,0,0
Monaghan Town,2018,25 - 29 years,0,0,0
Monaghan Town,2018,30 - 34 years,0,0,0
Monaghan Town,2018,35 - 39 years,1,1,2
Monaghan Town,2018,40 - 44 years,1,0,1
Monaghan Town,2018,45 - 49 years,0,0,0
Monaghan Town,2018,5 - 9 years,0,0,0
Monaghan Town,2018,50 - 54 years,2,1,3
Monaghan Town,2018,55 - 59 years,0,0,0
Monaghan Town,2018,60 - 64 years,0,1,1
Monaghan Town,2018,65 - 69 years,3,6,9
Monaghan Town,2018,70 - 74 years,1,6,7
Monaghan Town,2018,75 - 79 years,6,5,11
Monaghan Town,2018,80 - 84 years,2,6,8
Monaghan Town,2018,85 years and over,12,11,23
Monaghan Town,2018,Under 1 year,0,0,0
Monaghan Town,2019,1 - 4 years,0,0,0
Monaghan Town,2019,10 - 14 years,0,0,0
Monaghan Town,2019,15 - 19 years,0,0,0
Monaghan Town,2019,20 - 24 years,0,0,0
Monaghan Town,2019,25 - 29 years,0,0,0
Monaghan Town,2019,30 - 34 years,0,0,0
Monaghan Town,2019,35 - 39 years,1,1,2
Monaghan Town,2019,40 - 44 years,1,0,1
Monaghan Town,2019,45 - 49 years,0,0,0
Monaghan Town,2019,5 - 9 years,0,0,0
Monaghan Town,2019,50 - 54 years,2,1,3
Monaghan Town,2019,55 - 59 years,0,0,0
Monaghan Town,2019,60 - 64 years,0,1,1
Monaghan Town,2019,65 - 69 years,3,6,9
Monaghan Town,2019,70 - 74 years,1,6,7
Monaghan Town,2019,75 - 79 years,6,5,11
Monaghan Town,2019,80 - 84 years,2,6,8
Monaghan Town,2019,85 years and over,12,11,23
Monaghan Town,2019,Under 1 year,0,0,0
Monaghan Town,2020,1 - 4 years,0,0,0
Monaghan Town,2020,10 - 14 years,0,0,0
Monaghan Town,2020,15 - 19 years,0,0,0
Monaghan Town,2020,20 - 24 years,0,0,0
Monaghan Town,2020,25 - 29 years,0,0,0
Monaghan Town,2020,30 - 34 years,0,0,0
Monaghan Town,2020,35 - 39 years,1,1,2
Monaghan Town,2020,40 - 44 years,1,0,1
Monaghan Town,2020,45 - 49 years,0,0,0
Monaghan Town,2020,5 - 9 years,0,0,0
Monaghan Town,2020,50 - 54 years,2,1,3
Monaghan Town,2020,55 - 59 years,0,0,0
Monaghan Town,2020,60 - 64 years,0,1,1
Monaghan Town,2020,65 - 69 years,3,6,9
Monaghan Town,2020,70 - 74 years,1,6,7
Monaghan Town,2020,75 - 79 years,6,5,11
Monaghan Town,2020,80 - 84 years,2,6,8
Monaghan Town,2020,85 years and over,12,11,23
Monaghan Town,2020,Under 1 year,0,0,0
Munster,2007,1 - 4 years,3,9,12
Munster,2007,10 - 14 years,7,12,19
Munster,2007,15 - 19 years,8,28,36
Munster,2007,20 - 24 years,13,56,69
Munster,2007,25 - 29 years,20,55,75
Munster,2007,30 - 34 years,16,40,56
Munster,2007,35 - 39 years,23,53,76
Munster,2007,40 - 44 years,35,63,98
Munster,2007,45 - 49 years,64,109,173
Munster,2007,5 - 9 years,3,4,7
Munster,2007,50 - 54 years,86,157,243
Munster,2007,55 - 59 years,142,231,373
Munster,2007,60 - 64 years,202,306,508
Munster,2007,65 - 69 years,213,385,598
Munster,2007,70 - 74 years,383,548,931
Munster,2007,75 - 79 years,564,704,1268
Munster,2007,80 - 84 years,774,767,1541
Munster,2007,85 years and over,1465,823,2288
Munster,2007,Under 1 year,36,32,68
Munster,2008,1 - 4 years,3,12,15
Munster,2008,10 - 14 years,5,12,17
Munster,2008,15 - 19 years,12,32,44
Munster,2008,20 - 24 years,10,43,53
Munster,2008,25 - 29 years,16,37,53
Munster,2008,30 - 34 years,20,51,71
Munster,2008,35 - 39 years,34,68,102
Munster,2008,40 - 44 years,47,70,117
Munster,2008,45 - 49 years,73,102,175
Munster,2008,5 - 9 years,3,7,10
Munster,2008,50 - 54 years,100,151,251
Munster,2008,55 - 59 years,124,239,363
Munster,2008,60 - 64 years,193,335,528
Munster,2008,65 - 69 years,221,428,649
Munster,2008,70 - 74 years,328,545,873
Munster,2008,75 - 79 years,526,630,1156
Munster,2008,80 - 84 years,741,686,1427
Munster,2008,85 years and over,1556,914,2470
Munster,2008,Under 1 year,29,55,84
Munster,2009,1 - 4 years,8,9,17
Munster,2009,10 - 14 years,4,6,10
Munster,2009,15 - 19 years,4,32,36
Munster,2009,20 - 24 years,12,46,58
Munster,2009,25 - 29 years,19,54,73
Munster,2009,30 - 34 years,18,62,80
Munster,2009,35 - 39 years,34,82,116
Munster,2009,40 - 44 years,43,75,118
Munster,2009,45 - 49 years,78,121,199
Munster,2009,5 - 9 years,2,2,4
Munster,2009,50 - 54 years,96,152,248
Munster,2009,55 - 59 years,147,204,351
Munster,2009,60 - 64 years,185,330,515
Munster,2009,65 - 69 years,215,403,618
Munster,2009,70 - 74 years,322,560,882
Munster,2009,75 - 79 years,489,685,1174
Munster,2009,80 - 84 years,737,727,1464
Munster,2009,85 years and over,1510,906,2416
Munster,2009,Under 1 year,30,47,77
Munster,2010,1 - 4 years,7,7,14
Munster,2010,10 - 14 years,4,3,7
Munster,2010,15 - 19 years,16,29,45
Munster,2010,20 - 24 years,8,54,62
Munster,2010,25 - 29 years,6,51,57
Munster,2010,30 - 34 years,20,47,67
Munster,2010,35 - 39 years,35,65,100
Munster,2010,40 - 44 years,58,75,133
Munster,2010,45 - 49 years,78,101,179
Munster,2010,5 - 9 years,6,5,11
Munster,2010,50 - 54 years,101,150,251
Munster,2010,55 - 59 years,130,209,339
Munster,2010,60 - 64 years,174,321,495
Munster,2010,65 - 69 years,273,393,666
Munster,2010,70 - 74 years,308,517,825
Munster,2010,75 - 79 years,471,633,1104
Munster,2010,80 - 84 years,684,734,1418
Munster,2010,85 years and over,1615,910,2525
Munster,2010,Under 1 year,38,51,89
Munster,2011,1 - 4 years,2,8,10
Munster,2011,10 - 14 years,1,4,5
Munster,2011,15 - 19 years,8,21,29
Munster,2011,20 - 24 years,19,36,55
Munster,2011,25 - 29 years,20,49,69
Munster,2011,30 - 34 years,17,49,66
Munster,2011,35 - 39 years,21,55,76
Munster,2011,40 - 44 years,45,66,111
Munster,2011,45 - 49 years,71,94,165
Munster,2011,5 - 9 years,3,7,10
Munster,2011,50 - 54 years,91,165,256
Munster,2011,55 - 59 years,130,206,336
Munster,2011,60 - 64 years,191,330,521
Munster,2011,65 - 69 years,247,375,622
Munster,2011,70 - 74 years,319,520,839
Munster,2011,75 - 79 years,491,653,1144
Munster,2011,80 - 84 years,672,708,1380
Munster,2011,85 years and over,1729,945,2674
Munster,2011,Under 1 year,36,43,79
Munster,2012,1 - 4 years,5,3,8
Munster,2012,10 - 14 years,3,7,10
Munster,2012,15 - 19 years,5,22,27
Munster,2012,20 - 24 years,11,52,63
Munster,2012,25 - 29 years,15,36,51
Munster,2012,30 - 34 years,15,46,61
Munster,2012,35 - 39 years,25,49,74
Munster,2012,40 - 44 years,44,65,109
Munster,2012,45 - 49 years,76,98,174
Munster,2012,5 - 9 years,3,7,10
Munster,2012,50 - 54 years,91,164,255
Munster,2012,55 - 59 years,137,179,316
Munster,2012,60 - 64 years,174,328,502
Munster,2012,65 - 69 years,241,437,678
Munster,2012,70 - 74 years,302,506,808
Munster,2012,75 - 79 years,467,638,1105
Munster,2012,80 - 84 years,703,764,1467
Munster,2012,85 years and over,1772,1076,2848
Munster,2012,Under 1 year,41,30,71
Munster,2013,1 - 4 years,5,7,12
Munster,2013,10 - 14 years,4,8,12
Munster,2013,15 - 19 years,9,16,25
Munster,2013,20 - 24 years,8,34,42
Munster,2013,25 - 29 years,10,36,46
Munster,2013,30 - 34 years,23,36,59
Munster,2013,35 - 39 years,23,50,73
Munster,2013,40 - 44 years,34,72,106
Munster,2013,45 - 49 years,77,111,188
Munster,2013,5 - 9 years,4,7,11
Munster,2013,50 - 54 years,95,147,242
Munster,2013,55 - 59 years,114,214,328
Munster,2013,60 - 64 years,193,274,467
Munster,2013,65 - 69 years,258,475,733
Munster,2013,70 - 74 years,326,517,843
Munster,2013,75 - 79 years,493,661,1154
Munster,2013,80 - 84 years,705,757,1462
Munster,2013,85 years and over,1890,1130,3020
Munster,2013,Under 1 year,34,42,76
Munster,2014,1 - 4 years,5,9,14
Munster,2014,10 - 14 years,4,9,13
Munster,2014,15 - 19 years,3,20,23
Munster,2014,20 - 24 years,8,38,46
Munster,2014,25 - 29 years,10,36,46
Munster,2014,30 - 34 years,18,52,70
Munster,2014,35 - 39 years,29,48,77
Munster,2014,40 - 44 years,31,64,95
Munster,2014,45 - 49 years,71,90,161
Munster,2014,5 - 9 years,5,6,11
Munster,2014,50 - 54 years,98,133,231
Munster,2014,55 - 59 years,142,243,385
Munster,2014,60 - 64 years,184,307,491
Munster,2014,65 - 69 years,280,452,732
Munster,2014,70 - 74 years,355,548,903
Munster,2014,75 - 79 years,470,659,1129
Munster,2014,80 - 84 years,728,754,1482
Munster,2014,85 years and over,1786,1051,2837
Munster,2014,Under 1 year,30,38,68
Munster,2015,1 - 4 years,1,8,9
Munster,2015,10 - 14 years,1,1,2
Munster,2015,15 - 19 years,6,14,20
Munster,2015,20 - 24 years,11,26,37
Munster,2015,25 - 29 years,23,37,60
Munster,2015,30 - 34 years,26,42,68
Munster,2015,35 - 39 years,22,46,68
Munster,2015,40 - 44 years,40,78,118
Munster,2015,45 - 49 years,59,78,137
Munster,2015,5 - 9 years,1,5,6
Munster,2015,50 - 54 years,93,189,282
Munster,2015,55 - 59 years,169,204,373
Munster,2015,60 - 64 years,167,264,431
Munster,2015,65 - 69 years,262,460,722
Munster,2015,70 - 74 years,327,535,862
Munster,2015,75 - 79 years,471,660,1131
Munster,2015,80 - 84 years,682,790,1472
Munster,2015,85 years and over,1970,1149,3119
Munster,2015,Under 1 year,24,30,54
Munster,2016,1 - 4 years,6,6,12
Munster,2016,10 - 14 years,4,4,8
Munster,2016,15 - 19 years,14,19,33
Munster,2016,20 - 24 years,2,25,27
Munster,2016,25 - 29 years,9,32,41
Munster,2016,30 - 34 years,19,36,55
Munster,2016,35 - 39 years,27,50,77
Munster,2016,40 - 44 years,38,81,119
Munster,2016,45 - 49 years,55,100,155
Munster,2016,5 - 9 years,1,1,2
Munster,2016,50 - 54 years,97,121,218
Munster,2016,55 - 59 years,152,213,365
Munster,2016,60 - 64 years,192,299,491
Munster,2016,65 - 69 years,286,441,727
Munster,2016,70 - 74 years,387,571,958
Munster,2016,75 - 79 years,516,726,1242
Munster,2016,80 - 84 years,791,853,1644
Munster,2016,85 years and over,2048,1216,3264
Munster,2016,Under 1 year,22,25,47
Munster,2017,1 - 4 years,2,5,7
Munster,2017,10 - 14 years,2,3,5
Munster,2017,15 - 19 years,11,16,27
Munster,2017,20 - 24 years,12,16,28
Munster,2017,25 - 29 years,9,33,42
Munster,2017,30 - 34 years,26,41,67
Munster,2017,35 - 39 years,29,45,74
Munster,2017,40 - 44 years,50,61,111
Munster,2017,45 - 49 years,70,86,156
Munster,2017,5 - 9 years,3,3,6
Munster,2017,50 - 54 years,87,155,242
Munster,2017,55 - 59 years,122,197,319
Munster,2017,60 - 64 years,205,275,480
Munster,2017,65 - 69 years,237,394,631
Munster,2017,70 - 74 years,397,516,913
Munster,2017,75 - 79 years,470,719,1189
Munster,2017,80 - 84 years,698,779,1477
Munster,2017,85 years and over,2015,1157,3172
Munster,2017,Under 1 year,26,18,44
Munster,2018,1 - 4 years,3,4,7
Munster,2018,10 - 14 years,4,6,10
Munster,2018,15 - 19 years,6,17,23
Munster,2018,20 - 24 years,7,26,33
Munster,2018,25 - 29 years,17,25,42
Munster,2018,30 - 34 years,15,47,62
Munster,2018,35 - 39 years,32,46,78
Munster,2018,40 - 44 years,37,73,110
Munster,2018,45 - 49 years,67,113,180
Munster,2018,5 - 9 years,1,2,3
Munster,2018,50 - 54 years,85,144,229
Munster,2018,55 - 59 years,143,208,351
Munster,2018,60 - 64 years,188,313,501
Munster,2018,65 - 69 years,278,436,714
Munster,2018,70 - 74 years,384,591,975
Munster,2018,75 - 79 years,514,724,1238
Munster,2018,80 - 84 years,749,786,1535
Munster,2018,85 years and over,1856,1276,3132
Munster,2018,Under 1 year,24,24,48
Munster,2019,1 - 4 years,2,6,8
Munster,2019,10 - 14 years,3,4,7
Munster,2019,15 - 19 years,6,18,24
Munster,2019,20 - 24 years,5,26,31
Munster,2019,25 - 29 years,13,27,40
Munster,2019,30 - 34 years,13,38,51
Munster,2019,35 - 39 years,33,40,73
Munster,2019,40 - 44 years,44,81,125
Munster,2019,45 - 49 years,56,112,168
Munster,2019,5 - 9 years,2,4,6
Munster,2019,50 - 54 years,105,130,235
Munster,2019,55 - 59 years,117,225,342
Munster,2019,60 - 64 years,170,299,469
Munster,2019,65 - 69 years,286,370,656
Munster,2019,70 - 74 years,420,596,1016
Munster,2019,75 - 79 years,470,704,1174
Munster,2019,80 - 84 years,731,788,1519
Munster,2019,85 years and over,1890,1269,3159
Munster,2019,Under 1 year,19,22,41
Munster,2020,1 - 4 years,3,4,7
Munster,2020,10 - 14 years,2,3,5
Munster,2020,15 - 19 years,10,10,20
Munster,2020,20 - 24 years,8,19,27
Munster,2020,25 - 29 years,7,16,23
Munster,2020,30 - 34 years,16,31,47
Munster,2020,35 - 39 years,26,45,71
Munster,2020,40 - 44 years,30,62,92
Munster,2020,45 - 49 years,62,97,159
Munster,2020,5 - 9 years,5,5,10
Munster,2020,50 - 54 years,102,158,260
Munster,2020,55 - 59 years,122,184,306
Munster,2020,60 - 64 years,189,288,477
Munster,2020,65 - 69 years,258,418,676
Munster,2020,70 - 74 years,429,669,1098
Munster,2020,75 - 79 years,513,675,1188
Munster,2020,80 - 84 years,741,830,1571
Munster,2020,85 years and over,1896,1324,3220
Munster,2020,Under 1 year,16,24,40
Naas Town,2007,1 - 4 years,2,0,2
Naas Town,2007,10 - 14 years,0,0,0
Naas Town,2007,15 - 19 years,1,0,1
Naas Town,2007,20 - 24 years,0,0,0
Naas Town,2007,25 - 29 years,0,1,1
Naas Town,2007,30 - 34 years,1,1,2
Naas Town,2007,35 - 39 years,1,1,2
Naas Town,2007,40 - 44 years,1,0,1
Naas Town,2007,45 - 49 years,2,4,6
Naas Town,2007,5 - 9 years,0,0,0
Naas Town,2007,50 - 54 years,3,4,7
Naas Town,2007,55 - 59 years,0,3,3
Naas Town,2007,60 - 64 years,2,7,9
Naas Town,2007,65 - 69 years,3,6,9
Naas Town,2007,70 - 74 years,7,6,13
Naas Town,2007,75 - 79 years,6,9,15
Naas Town,2007,80 - 84 years,6,9,15
Naas Town,2007,85 years and over,16,8,24
Naas Town,2007,Under 1 year,2,2,4
Naas Town,2008,1 - 4 years,2,0,2
Naas Town,2008,10 - 14 years,0,0,0
Naas Town,2008,15 - 19 years,1,0,1
Naas Town,2008,20 - 24 years,0,2,2
Naas Town,2008,25 - 29 years,0,1,1
Naas Town,2008,30 - 34 years,1,1,2
Naas Town,2008,35 - 39 years,2,2,4
Naas Town,2008,40 - 44 years,1,3,4
Naas Town,2008,45 - 49 years,2,4,6
Naas Town,2008,5 - 9 years,0,0,0
Naas Town,2008,50 - 54 years,3,1,4
Naas Town,2008,55 - 59 years,4,3,7
Naas Town,2008,60 - 64 years,7,5,12
Naas Town,2008,65 - 69 years,3,8,11
Naas Town,2008,70 - 74 years,4,10,14
Naas Town,2008,75 - 79 years,7,9,16
Naas Town,2008,80 - 84 years,17,6,23
Naas Town,2008,85 years and over,16,12,28
Naas Town,2008,Under 1 year,1,2,3
Naas Town,2009,1 - 4 years,2,1,3
Naas Town,2009,10 - 14 years,0,0,0
Naas Town,2009,15 - 19 years,1,0,1
Naas Town,2009,20 - 24 years,0,2,2
Naas Town,2009,25 - 29 years,0,2,2
Naas Town,2009,30 - 34 years,1,1,2
Naas Town,2009,35 - 39 years,2,2,4
Naas Town,2009,40 - 44 years,1,3,4
Naas Town,2009,45 - 49 years,1,4,5
Naas Town,2009,5 - 9 years,0,0,0
Naas Town,2009,50 - 54 years,2,6,8
Naas Town,2009,55 - 59 years,1,2,3
Naas Town,2009,60 - 64 years,5,5,10
Naas Town,2009,65 - 69 years,2,4,6
Naas Town,2009,70 - 74 years,3,3,6
Naas Town,2009,75 - 79 years,3,5,8
Naas Town,2009,80 - 84 years,10,3,13
Naas Town,2009,85 years and over,28,8,36
Naas Town,2009,Under 1 year,1,2,3
Naas Town,2010,1 - 4 years,2,1,3
Naas Town,2010,10 - 14 years,0,0,0
Naas Town,2010,15 - 19 years,1,0,1
Naas Town,2010,20 - 24 years,0,2,2
Naas Town,2010,25 - 29 years,0,4,4
Naas Town,2010,30 - 34 years,1,1,2
Naas Town,2010,35 - 39 years,2,1,3
Naas Town,2010,40 - 44 years,1,1,2
Naas Town,2010,45 - 49 years,3,4,7
Naas Town,2010,5 - 9 years,0,0,0
Naas Town,2010,50 - 54 years,2,6,8
Naas Town,2010,55 - 59 years,2,5,7
Naas Town,2010,60 - 64 years,2,3,5
Naas Town,2010,65 - 69 years,5,1,6
Naas Town,2010,70 - 74 years,9,6,15
Naas Town,2010,75 - 79 years,5,12,17
Naas Town,2010,80 - 84 years,4,10,14
Naas Town,2010,85 years and over,25,9,34
Naas Town,2010,Under 1 year,2,1,3
Naas Town,2011,1 - 4 years,0,0,0
Naas Town,2011,10 - 14 years,0,0,0
Naas Town,2011,15 - 19 years,0,0,0
Naas Town,2011,20 - 24 years,0,1,1
Naas Town,2011,25 - 29 years,0,1,1
Naas Town,2011,30 - 34 years,0,1,1
Naas Town,2011,35 - 39 years,2,1,3
Naas Town,2011,40 - 44 years,0,1,1
Naas Town,2011,45 - 49 years,1,4,5
Naas Town,2011,5 - 9 years,0,0,0
Naas Town,2011,50 - 54 years,0,1,1
Naas Town,2011,55 - 59 years,1,2,3
Naas Town,2011,60 - 64 years,1,5,6
Naas Town,2011,65 - 69 years,6,7,13
Naas Town,2011,70 - 74 years,6,3,9
Naas Town,2011,75 - 79 years,7,3,10
Naas Town,2011,80 - 84 years,4,2,6
Naas Town,2011,85 years and over,13,10,23
Naas Town,2011,Under 1 year,0,3,3
Naas Town,2012,1 - 4 years,0,0,0
Naas Town,2012,10 - 14 years,0,0,0
Naas Town,2012,15 - 19 years,0,0,0
Naas Town,2012,20 - 24 years,2,1,3
Naas Town,2012,25 - 29 years,0,1,1
Naas Town,2012,30 - 34 years,0,1,1
Naas Town,2012,35 - 39 years,2,2,4
Naas Town,2012,40 - 44 years,0,3,3
Naas Town,2012,45 - 49 years,2,3,5
Naas Town,2012,5 - 9 years,0,0,0
Naas Town,2012,50 - 54 years,2,1,3
Naas Town,2012,55 - 59 years,1,6,7
Naas Town,2012,60 - 64 years,6,6,12
Naas Town,2012,65 - 69 years,4,9,13
Naas Town,2012,70 - 74 years,3,9,12
Naas Town,2012,75 - 79 years,4,8,12
Naas Town,2012,80 - 84 years,11,7,18
Naas Town,2012,85 years and over,25,9,34
Naas Town,2012,Under 1 year,0,1,1
Naas Town,2013,1 - 4 years,0,0,0
Naas Town,2013,10 - 14 years,0,0,0
Naas Town,2013,15 - 19 years,0,0,0
Naas Town,2013,20 - 24 years,0,0,0
Naas Town,2013,25 - 29 years,0,0,0
Naas Town,2013,30 - 34 years,1,1,2
Naas Town,2013,35 - 39 years,0,1,1
Naas Town,2013,40 - 44 years,0,1,1
Naas Town,2013,45 - 49 years,0,0,0
Naas Town,2013,5 - 9 years,0,0,0
Naas Town,2013,50 - 54 years,4,2,6
Naas Town,2013,55 - 59 years,2,1,3
Naas Town,2013,60 - 64 years,3,1,4
Naas Town,2013,65 - 69 years,4,5,9
Naas Town,2013,70 - 74 years,4,10,14
Naas Town,2013,75 - 79 years,4,8,12
Naas Town,2013,80 - 84 years,8,3,11
Naas Town,2013,85 years and over,16,9,25
Naas Town,2013,Under 1 year,0,0,0
Naas Town,2014,1 - 4 years,0,0,0
Naas Town,2014,10 - 14 years,0,0,0
Naas Town,2014,15 - 19 years,0,0,0
Naas Town,2014,20 - 24 years,0,1,1
Naas Town,2014,25 - 29 years,0,0,0
Naas Town,2014,30 - 34 years,1,1,2
Naas Town,2014,35 - 39 years,0,1,1
Naas Town,2014,40 - 44 years,1,1,2
Naas Town,2014,45 - 49 years,1,0,1
Naas Town,2014,5 - 9 years,0,0,0
Naas Town,2014,50 - 54 years,4,1,5
Naas Town,2014,55 - 59 years,2,3,5
Naas Town,2014,60 - 64 years,2,3,5
Naas Town,2014,65 - 69 years,2,5,7
Naas Town,2014,70 - 74 years,5,6,11
Naas Town,2014,75 - 79 years,8,5,13
Naas Town,2014,80 - 84 years,13,8,21
Naas Town,2014,85 years and over,19,11,30
Naas Town,2014,Under 1 year,0,0,0
Naas Town,2015,1 - 4 years,0,0,0
Naas Town,2015,10 - 14 years,0,0,0
Naas Town,2015,15 - 19 years,0,0,0
Naas Town,2015,20 - 24 years,0,1,1
Naas Town,2015,25 - 29 years,0,0,0
Naas Town,2015,30 - 34 years,1,1,2
Naas Town,2015,35 - 39 years,0,1,1
Naas Town,2015,40 - 44 years,1,1,2
Naas Town,2015,45 - 49 years,1,0,1
Naas Town,2015,5 - 9 years,0,0,0
Naas Town,2015,50 - 54 years,4,1,5
Naas Town,2015,55 - 59 years,2,3,5
Naas Town,2015,60 - 64 years,2,3,5
Naas Town,2015,65 - 69 years,2,5,7
Naas Town,2015,70 - 74 years,5,6,11
Naas Town,2015,75 - 79 years,8,5,13
Naas Town,2015,80 - 84 years,13,8,21
Naas Town,2015,85 years and over,19,11,30
Naas Town,2015,Under 1 year,0,0,0
Naas Town,2016,1 - 4 years,0,0,0
Naas Town,2016,10 - 14 years,0,0,0
Naas Town,2016,15 - 19 years,0,0,0
Naas Town,2016,20 - 24 years,0,1,1
Naas Town,2016,25 - 29 years,0,0,0
Naas Town,2016,30 - 34 years,1,1,2
Naas Town,2016,35 - 39 years,0,1,1
Naas Town,2016,40 - 44 years,1,1,2
Naas Town,2016,45 - 49 years,1,0,1
Naas Town,2016,5 - 9 years,0,0,0
Naas Town,2016,50 - 54 years,4,1,5
Naas Town,2016,55 - 59 years,2,3,5
Naas Town,2016,60 - 64 years,2,3,5
Naas Town,2016,65 - 69 years,2,5,7
Naas Town,2016,70 - 74 years,5,6,11
Naas Town,2016,75 - 79 years,8,5,13
Naas Town,2016,80 - 84 years,13,8,21
Naas Town,2016,85 years and over,19,11,30
Naas Town,2016,Under 1 year,0,0,0
Naas Town,2017,1 - 4 years,0,0,0
Naas Town,2017,10 - 14 years,0,0,0
Naas Town,2017,15 - 19 years,0,0,0
Naas Town,2017,20 - 24 years,0,1,1
Naas Town,2017,25 - 29 years,0,0,0
Naas Town,2017,30 - 34 years,1,1,2
Naas Town,2017,35 - 39 years,0,1,1
Naas Town,2017,40 - 44 years,1,1,2
Naas Town,2017,45 - 49 years,1,0,1
Naas Town,2017,5 - 9 years,0,0,0
Naas Town,2017,50 - 54 years,4,1,5
Naas Town,2017,55 - 59 years,3,6,9
Naas Town,2017,60 - 64 years,5,3,8
Naas Town,2017,65 - 69 years,1,5,6
Naas Town,2017,70 - 74 years,1,13,14
Naas Town,2017,75 - 79 years,7,5,12
Naas Town,2017,80 - 84 years,9,12,21
Naas Town,2017,85 years and over,22,12,34
Naas Town,2017,Under 1 year,1,0,1
Naas Town,2018,1 - 4 years,0,0,0
Naas Town,2018,10 - 14 years,0,1,1
Naas Town,2018,15 - 19 years,0,0,0
Naas Town,2018,20 - 24 years,0,1,1
Naas Town,2018,25 - 29 years,1,0,1
Naas Town,2018,30 - 34 years,0,0,0
Naas Town,2018,35 - 39 years,0,2,2
Naas Town,2018,40 - 44 years,1,1,2
Naas Town,2018,45 - 49 years,0,2,2
Naas Town,2018,5 - 9 years,0,0,0
Naas Town,2018,50 - 54 years,0,6,6
Naas Town,2018,55 - 59 years,3,3,6
Naas Town,2018,60 - 64 years,2,4,6
Naas Town,2018,65 - 69 years,1,5,6
Naas Town,2018,70 - 74 years,4,9,13
Naas Town,2018,75 - 79 years,3,10,13
Naas Town,2018,80 - 84 years,7,11,18
Naas Town,2018,85 years and over,24,11,35
Naas Town,2018,Under 1 year,0,1,1
Naas Town,2019,1 - 4 years,0,0,0
Naas Town,2019,10 - 14 years,0,1,1
Naas Town,2019,15 - 19 years,0,0,0
Naas Town,2019,20 - 24 years,0,1,1
Naas Town,2019,25 - 29 years,1,0,1
Naas Town,2019,30 - 34 years,0,0,0
Naas Town,2019,35 - 39 years,0,2,2
Naas Town,2019,40 - 44 years,1,1,2
Naas Town,2019,45 - 49 years,0,2,2
Naas Town,2019,5 - 9 years,0,0,0
Naas Town,2019,50 - 54 years,0,6,6
Naas Town,2019,55 - 59 years,3,3,6
Naas Town,2019,60 - 64 years,2,4,6
Naas Town,2019,65 - 69 years,1,5,6
Naas Town,2019,70 - 74 years,4,9,13
Naas Town,2019,75 - 79 years,3,10,13
Naas Town,2019,80 - 84 years,7,11,18
Naas Town,2019,85 years and over,24,11,35
Naas Town,2019,Under 1 year,0,1,1
Naas Town,2020,1 - 4 years,0,0,0
Naas Town,2020,10 - 14 years,0,1,1
Naas Town,2020,15 - 19 years,0,0,0
Naas Town,2020,20 - 24 years,0,1,1
Naas Town,2020,25 - 29 years,1,0,1
Naas Town,2020,30 - 34 years,0,0,0
Naas Town,2020,35 - 39 years,0,2,2
Naas Town,2020,40 - 44 years,1,1,2
Naas Town,2020,45 - 49 years,0,2,2
Naas Town,2020,5 - 9 years,0,0,0
Naas Town,2020,50 - 54 years,0,6,6
Naas Town,2020,55 - 59 years,3,3,6
Naas Town,2020,60 - 64 years,2,4,6
Naas Town,2020,65 - 69 years,1,5,6
Naas Town,2020,70 - 74 years,4,9,13
Naas Town,2020,75 - 79 years,3,10,13
Naas Town,2020,80 - 84 years,7,11,18
Naas Town,2020,85 years and over,24,11,35
Naas Town,2020,Under 1 year,0,1,1
Navan Town,2007,1 - 4 years,3,0,3
Navan Town,2007,10 - 14 years,0,0,0
Navan Town,2007,15 - 19 years,0,0,0
Navan Town,2007,20 - 24 years,0,1,1
Navan Town,2007,25 - 29 years,1,3,4
Navan Town,2007,30 - 34 years,1,1,2
Navan Town,2007,35 - 39 years,1,1,2
Navan Town,2007,40 - 44 years,1,1,2
Navan Town,2007,45 - 49 years,2,2,4
Navan Town,2007,5 - 9 years,0,0,0
Navan Town,2007,50 - 54 years,4,3,7
Navan Town,2007,55 - 59 years,4,5,9
Navan Town,2007,60 - 64 years,3,8,11
Navan Town,2007,65 - 69 years,8,14,22
Navan Town,2007,70 - 74 years,7,9,16
Navan Town,2007,75 - 79 years,18,12,30
Navan Town,2007,80 - 84 years,14,13,27
Navan Town,2007,85 years and over,23,15,38
Navan Town,2007,Under 1 year,0,1,1
Navan Town,2008,1 - 4 years,3,0,3
Navan Town,2008,10 - 14 years,0,0,0
Navan Town,2008,15 - 19 years,0,1,1
Navan Town,2008,20 - 24 years,2,1,3
Navan Town,2008,25 - 29 years,1,2,3
Navan Town,2008,30 - 34 years,1,1,2
Navan Town,2008,35 - 39 years,2,4,6
Navan Town,2008,40 - 44 years,1,1,2
Navan Town,2008,45 - 49 years,1,1,2
Navan Town,2008,5 - 9 years,0,0,0
Navan Town,2008,50 - 54 years,1,3,4
Navan Town,2008,55 - 59 years,5,3,8
Navan Town,2008,60 - 64 years,5,9,14
Navan Town,2008,65 - 69 years,6,11,17
Navan Town,2008,70 - 74 years,5,13,18
Navan Town,2008,75 - 79 years,7,13,20
Navan Town,2008,80 - 84 years,19,8,27
Navan Town,2008,85 years and over,23,19,42
Navan Town,2008,Under 1 year,5,1,6
Navan Town,2009,1 - 4 years,3,0,3
Navan Town,2009,10 - 14 years,0,0,0
Navan Town,2009,15 - 19 years,0,1,1
Navan Town,2009,20 - 24 years,1,2,3
Navan Town,2009,25 - 29 years,1,3,4
Navan Town,2009,30 - 34 years,1,1,2
Navan Town,2009,35 - 39 years,2,1,3
Navan Town,2009,40 - 44 years,1,2,3
Navan Town,2009,45 - 49 years,1,2,3
Navan Town,2009,5 - 9 years,0,0,0
Navan Town,2009,50 - 54 years,4,3,7
Navan Town,2009,55 - 59 years,4,1,5
Navan Town,2009,60 - 64 years,6,6,12
Navan Town,2009,65 - 69 years,3,5,8
Navan Town,2009,70 - 74 years,5,8,13
Navan Town,2009,75 - 79 years,3,4,7
Navan Town,2009,80 - 84 years,8,7,15
Navan Town,2009,85 years and over,14,7,21
Navan Town,2009,Under 1 year,5,1,6
Navan Town,2010,1 - 4 years,3,0,3
Navan Town,2010,10 - 14 years,0,0,0
Navan Town,2010,15 - 19 years,0,1,1
Navan Town,2010,20 - 24 years,1,2,3
Navan Town,2010,25 - 29 years,1,3,4
Navan Town,2010,30 - 34 years,1,1,2
Navan Town,2010,35 - 39 years,2,2,4
Navan Town,2010,40 - 44 years,2,4,6
Navan Town,2010,45 - 49 years,1,2,3
Navan Town,2010,5 - 9 years,0,0,0
Navan Town,2010,50 - 54 years,4,5,9
Navan Town,2010,55 - 59 years,2,4,6
Navan Town,2010,60 - 64 years,5,6,11
Navan Town,2010,65 - 69 years,3,3,6
Navan Town,2010,70 - 74 years,5,4,9
Navan Town,2010,75 - 79 years,11,6,17
Navan Town,2010,80 - 84 years,9,10,19
Navan Town,2010,85 years and over,20,13,33
Navan Town,2010,Under 1 year,3,1,4
Navan Town,2011,1 - 4 years,0,0,0
Navan Town,2011,10 - 14 years,0,0,0
Navan Town,2011,15 - 19 years,0,0,0
Navan Town,2011,20 - 24 years,0,1,1
Navan Town,2011,25 - 29 years,0,1,1
Navan Town,2011,30 - 34 years,1,0,1
Navan Town,2011,35 - 39 years,0,1,1
Navan Town,2011,40 - 44 years,1,1,2
Navan Town,2011,45 - 49 years,1,2,3
Navan Town,2011,5 - 9 years,0,0,0
Navan Town,2011,50 - 54 years,1,2,3
Navan Town,2011,55 - 59 years,2,4,6
Navan Town,2011,60 - 64 years,1,3,4
Navan Town,2011,65 - 69 years,5,4,9
Navan Town,2011,70 - 74 years,3,5,8
Navan Town,2011,75 - 79 years,5,4,9
Navan Town,2011,80 - 84 years,4,7,11
Navan Town,2011,85 years and over,14,12,26
Navan Town,2011,Under 1 year,0,1,1
Navan Town,2012,1 - 4 years,0,1,1
Navan Town,2012,10 - 14 years,0,0,0
Navan Town,2012,15 - 19 years,0,0,0
Navan Town,2012,20 - 24 years,0,1,1
Navan Town,2012,25 - 29 years,1,1,2
Navan Town,2012,30 - 34 years,3,1,4
Navan Town,2012,35 - 39 years,0,1,1
Navan Town,2012,40 - 44 years,1,1,2
Navan Town,2012,45 - 49 years,1,1,2
Navan Town,2012,5 - 9 years,1,2,3
Navan Town,2012,50 - 54 years,3,7,10
Navan Town,2012,55 - 59 years,6,3,9
Navan Town,2012,60 - 64 years,6,16,22
Navan Town,2012,65 - 69 years,5,6,11
Navan Town,2012,70 - 74 years,1,6,7
Navan Town,2012,75 - 79 years,6,13,19
Navan Town,2012,80 - 84 years,12,14,26
Navan Town,2012,85 years and over,12,10,22
Navan Town,2012,Under 1 year,3,1,4
Navan Town,2013,1 - 4 years,0,0,0
Navan Town,2013,10 - 14 years,0,0,0
Navan Town,2013,15 - 19 years,0,0,0
Navan Town,2013,20 - 24 years,1,0,1
Navan Town,2013,25 - 29 years,0,0,0
Navan Town,2013,30 - 34 years,1,4,5
Navan Town,2013,35 - 39 years,1,2,3
Navan Town,2013,40 - 44 years,1,3,4
Navan Town,2013,45 - 49 years,0,1,1
Navan Town,2013,5 - 9 years,0,0,0
Navan Town,2013,50 - 54 years,2,3,5
Navan Town,2013,55 - 59 years,1,6,7
Navan Town,2013,60 - 64 years,1,5,6
Navan Town,2013,65 - 69 years,4,6,10
Navan Town,2013,70 - 74 years,6,7,13
Navan Town,2013,75 - 79 years,7,8,15
Navan Town,2013,80 - 84 years,5,11,16
Navan Town,2013,85 years and over,23,5,28
Navan Town,2013,Under 1 year,2,2,4
Navan Town,2014,1 - 4 years,0,0,0
Navan Town,2014,10 - 14 years,0,0,0
Navan Town,2014,15 - 19 years,0,0,0
Navan Town,2014,20 - 24 years,1,0,1
Navan Town,2014,25 - 29 years,1,0,1
Navan Town,2014,30 - 34 years,1,3,4
Navan Town,2014,35 - 39 years,1,2,3
Navan Town,2014,40 - 44 years,1,2,3
Navan Town,2014,45 - 49 years,1,3,4
Navan Town,2014,5 - 9 years,0,0,0
Navan Town,2014,50 - 54 years,2,2,4
Navan Town,2014,55 - 59 years,2,2,4
Navan Town,2014,60 - 64 years,2,4,6
Navan Town,2014,65 - 69 years,1,8,9
Navan Town,2014,70 - 74 years,6,12,18
Navan Town,2014,75 - 79 years,6,11,17
Navan Town,2014,80 - 84 years,13,8,21
Navan Town,2014,85 years and over,18,15,33
Navan Town,2014,Under 1 year,1,2,3
Navan Town,2015,1 - 4 years,0,0,0
Navan Town,2015,10 - 14 years,0,0,0
Navan Town,2015,15 - 19 years,0,0,0
Navan Town,2015,20 - 24 years,1,0,1
Navan Town,2015,25 - 29 years,1,0,1
Navan Town,2015,30 - 34 years,1,3,4
Navan Town,2015,35 - 39 years,1,2,3
Navan Town,2015,40 - 44 years,1,2,3
Navan Town,2015,45 - 49 years,1,3,4
Navan Town,2015,5 - 9 years,0,0,0
Navan Town,2015,50 - 54 years,2,2,4
Navan Town,2015,55 - 59 years,2,2,4
Navan Town,2015,60 - 64 years,2,4,6
Navan Town,2015,65 - 69 years,1,8,9
Navan Town,2015,70 - 74 years,6,12,18
Navan Town,2015,75 - 79 years,6,11,17
Navan Town,2015,80 - 84 years,13,8,21
Navan Town,2015,85 years and over,18,15,33
Navan Town,2015,Under 1 year,1,2,3
Navan Town,2016,1 - 4 years,0,0,0
Navan Town,2016,10 - 14 years,0,0,0
Navan Town,2016,15 - 19 years,0,0,0
Navan Town,2016,20 - 24 years,1,0,1
Navan Town,2016,25 - 29 years,1,0,1
Navan Town,2016,30 - 34 years,1,3,4
Navan Town,2016,35 - 39 years,1,2,3
Navan Town,2016,40 - 44 years,1,2,3
Navan Town,2016,45 - 49 years,1,3,4
Navan Town,2016,5 - 9 years,0,0,0
Navan Town,2016,50 - 54 years,2,2,4
Navan Town,2016,55 - 59 years,2,2,4
Navan Town,2016,60 - 64 years,2,4,6
Navan Town,2016,65 - 69 years,1,8,9
Navan Town,2016,70 - 74 years,6,12,18
Navan Town,2016,75 - 79 years,6,11,17
Navan Town,2016,80 - 84 years,13,8,21
Navan Town,2016,85 years and over,18,15,33
Navan Town,2016,Under 1 year,1,2,3
Navan Town,2017,1 - 4 years,0,0,0
Navan Town,2017,10 - 14 years,0,0,0
Navan Town,2017,15 - 19 years,0,1,1
Navan Town,2017,20 - 24 years,1,2,3
Navan Town,2017,25 - 29 years,1,0,1
Navan Town,2017,30 - 34 years,1,3,4
Navan Town,2017,35 - 39 years,1,2,3
Navan Town,2017,40 - 44 years,3,4,7
Navan Town,2017,45 - 49 years,2,4,6
Navan Town,2017,5 - 9 years,1,0,1
Navan Town,2017,50 - 54 years,1,3,4
Navan Town,2017,55 - 59 years,1,5,6
Navan Town,2017,60 - 64 years,5,9,14
Navan Town,2017,65 - 69 years,9,5,14
Navan Town,2017,70 - 74 years,2,9,11
Navan Town,2017,75 - 79 years,12,16,28
Navan Town,2017,80 - 84 years,10,11,21
Navan Town,2017,85 years and over,16,12,28
Navan Town,2017,Under 1 year,2,2,4
Navan Town,2018,1 - 4 years,0,0,0
Navan Town,2018,10 - 14 years,0,0,0
Navan Town,2018,15 - 19 years,0,0,0
Navan Town,2018,20 - 24 years,0,1,1
Navan Town,2018,25 - 29 years,0,0,0
Navan Town,2018,30 - 34 years,1,1,2
Navan Town,2018,35 - 39 years,0,1,1
Navan Town,2018,40 - 44 years,1,3,4
Navan Town,2018,45 - 49 years,5,0,5
Navan Town,2018,5 - 9 years,1,1,2
Navan Town,2018,50 - 54 years,1,3,4
Navan Town,2018,55 - 59 years,1,6,7
Navan Town,2018,60 - 64 years,2,5,7
Navan Town,2018,65 - 69 years,3,7,10
Navan Town,2018,70 - 74 years,9,11,20
Navan Town,2018,75 - 79 years,9,12,21
Navan Town,2018,80 - 84 years,9,10,19
Navan Town,2018,85 years and over,30,26,56
Navan Town,2018,Under 1 year,2,1,3
Navan Town,2019,1 - 4 years,0,0,0
Navan Town,2019,10 - 14 years,0,0,0
Navan Town,2019,15 - 19 years,0,0,0
Navan Town,2019,20 - 24 years,0,1,1
Navan Town,2019,25 - 29 years,0,0,0
Navan Town,2019,30 - 34 years,1,1,2
Navan Town,2019,35 - 39 years,0,1,1
Navan Town,2019,40 - 44 years,1,3,4
Navan Town,2019,45 - 49 years,5,0,5
Navan Town,2019,5 - 9 years,1,1,2
Navan Town,2019,50 - 54 years,1,3,4
Navan Town,2019,55 - 59 years,1,6,7
Navan Town,2019,60 - 64 years,2,5,7
Navan Town,2019,65 - 69 years,3,7,10
Navan Town,2019,70 - 74 years,9,11,20
Navan Town,2019,75 - 79 years,9,12,21
Navan Town,2019,80 - 84 years,9,10,19
Navan Town,2019,85 years and over,30,26,56
Navan Town,2019,Under 1 year,2,1,3
Navan Town,2020,1 - 4 years,0,0,0
Navan Town,2020,10 - 14 years,0,0,0
Navan Town,2020,15 - 19 years,0,0,0
Navan Town,2020,20 - 24 years,0,1,1
Navan Town,2020,25 - 29 years,0,0,0
Navan Town,2020,30 - 34 years,1,1,2
Navan Town,2020,35 - 39 years,0,1,1
Navan Town,2020,40 - 44 years,1,3,4
Navan Town,2020,45 - 49 years,5,0,5
Navan Town,2020,5 - 9 years,1,1,2
Navan Town,2020,50 - 54 years,1,3,4
Navan Town,2020,55 - 59 years,1,6,7
Navan Town,2020,60 - 64 years,2,5,7
Navan Town,2020,65 - 69 years,3,7,10
Navan Town,2020,70 - 74 years,9,11,20
Navan Town,2020,75 - 79 years,9,12,21
Navan Town,2020,80 - 84 years,9,10,19
Navan Town,2020,85 years and over,30,26,56
Navan Town,2020,Under 1 year,2,1,3
Nenagh Town,2007,1 - 4 years,0,0,0
Nenagh Town,2007,10 - 14 years,0,0,0
Nenagh Town,2007,15 - 19 years,0,1,1
Nenagh Town,2007,20 - 24 years,0,0,0
Nenagh Town,2007,25 - 29 years,0,2,2
Nenagh Town,2007,30 - 34 years,0,0,0
Nenagh Town,2007,35 - 39 years,0,0,0
Nenagh Town,2007,40 - 44 years,0,2,2
Nenagh Town,2007,45 - 49 years,0,1,1
Nenagh Town,2007,5 - 9 years,1,0,1
Nenagh Town,2007,50 - 54 years,1,3,4
Nenagh Town,2007,55 - 59 years,1,1,2
Nenagh Town,2007,60 - 64 years,2,3,5
Nenagh Town,2007,65 - 69 years,4,2,6
Nenagh Town,2007,70 - 74 years,8,11,19
Nenagh Town,2007,75 - 79 years,10,15,25
Nenagh Town,2007,80 - 84 years,15,15,30
Nenagh Town,2007,85 years and over,25,14,39
Nenagh Town,2007,Under 1 year,2,0,2
Nenagh Town,2008,1 - 4 years,0,0,0
Nenagh Town,2008,10 - 14 years,0,1,1
Nenagh Town,2008,15 - 19 years,0,2,2
Nenagh Town,2008,20 - 24 years,0,3,3
Nenagh Town,2008,25 - 29 years,1,2,3
Nenagh Town,2008,30 - 34 years,1,1,2
Nenagh Town,2008,35 - 39 years,0,2,2
Nenagh Town,2008,40 - 44 years,2,2,4
Nenagh Town,2008,45 - 49 years,2,1,3
Nenagh Town,2008,5 - 9 years,1,0,1
Nenagh Town,2008,50 - 54 years,2,3,5
Nenagh Town,2008,55 - 59 years,1,4,5
Nenagh Town,2008,60 - 64 years,4,8,12
Nenagh Town,2008,65 - 69 years,1,4,5
Nenagh Town,2008,70 - 74 years,7,8,15
Nenagh Town,2008,75 - 79 years,12,12,24
Nenagh Town,2008,80 - 84 years,11,15,26
Nenagh Town,2008,85 years and over,21,11,32
Nenagh Town,2008,Under 1 year,2,1,3
Nenagh Town,2009,1 - 4 years,0,0,0
Nenagh Town,2009,10 - 14 years,0,1,1
Nenagh Town,2009,15 - 19 years,0,2,2
Nenagh Town,2009,20 - 24 years,0,3,3
Nenagh Town,2009,25 - 29 years,1,2,3
Nenagh Town,2009,30 - 34 years,1,4,5
Nenagh Town,2009,35 - 39 years,0,1,1
Nenagh Town,2009,40 - 44 years,2,2,4
Nenagh Town,2009,45 - 49 years,2,2,4
Nenagh Town,2009,5 - 9 years,1,0,1
Nenagh Town,2009,50 - 54 years,2,3,5
Nenagh Town,2009,55 - 59 years,1,2,3
Nenagh Town,2009,60 - 64 years,3,1,4
Nenagh Town,2009,65 - 69 years,1,3,4
Nenagh Town,2009,70 - 74 years,4,7,11
Nenagh Town,2009,75 - 79 years,3,4,7
Nenagh Town,2009,80 - 84 years,7,1,8
Nenagh Town,2009,85 years and over,13,5,18
Nenagh Town,2009,Under 1 year,1,1,2
Nenagh Town,2010,1 - 4 years,0,0,0
Nenagh Town,2010,10 - 14 years,0,1,1
Nenagh Town,2010,15 - 19 years,0,1,1
Nenagh Town,2010,20 - 24 years,1,3,4
Nenagh Town,2010,25 - 29 years,1,1,2
Nenagh Town,2010,30 - 34 years,1,4,5
Nenagh Town,2010,35 - 39 years,1,1,2
Nenagh Town,2010,40 - 44 years,1,1,2
Nenagh Town,2010,45 - 49 years,2,2,4
Nenagh Town,2010,5 - 9 years,1,0,1
Nenagh Town,2010,50 - 54 years,1,3,4
Nenagh Town,2010,55 - 59 years,3,1,4
Nenagh Town,2010,60 - 64 years,3,2,5
Nenagh Town,2010,65 - 69 years,4,3,7
Nenagh Town,2010,70 - 74 years,2,7,9
Nenagh Town,2010,75 - 79 years,4,4,8
Nenagh Town,2010,80 - 84 years,7,11,18
Nenagh Town,2010,85 years and over,18,9,27
Nenagh Town,2010,Under 1 year,1,1,2
Nenagh Town,2011,1 - 4 years,0,0,0
Nenagh Town,2011,10 - 14 years,0,0,0
Nenagh Town,2011,15 - 19 years,0,1,1
Nenagh Town,2011,20 - 24 years,0,0,0
Nenagh Town,2011,25 - 29 years,0,0,0
Nenagh Town,2011,30 - 34 years,0,0,0
Nenagh Town,2011,35 - 39 years,0,2,2
Nenagh Town,2011,40 - 44 years,3,0,3
Nenagh Town,2011,45 - 49 years,0,2,2
Nenagh Town,2011,5 - 9 years,0,0,0
Nenagh Town,2011,50 - 54 years,0,2,2
Nenagh Town,2011,55 - 59 years,1,1,2
Nenagh Town,2011,60 - 64 years,2,0,2
Nenagh Town,2011,65 - 69 years,1,0,1
Nenagh Town,2011,70 - 74 years,2,0,2
Nenagh Town,2011,75 - 79 years,1,2,3
Nenagh Town,2011,80 - 84 years,4,4,8
Nenagh Town,2011,85 years and over,14,8,22
Nenagh Town,2011,Under 1 year,0,1,1
Nenagh Town,2012,1 - 4 years,0,0,0
Nenagh Town,2012,10 - 14 years,0,0,0
Nenagh Town,2012,15 - 19 years,0,1,1
Nenagh Town,2012,20 - 24 years,0,0,0
Nenagh Town,2012,25 - 29 years,0,0,0
Nenagh Town,2012,30 - 34 years,0,1,1
Nenagh Town,2012,35 - 39 years,0,2,2
Nenagh Town,2012,40 - 44 years,1,0,1
Nenagh Town,2012,45 - 49 years,0,2,2
Nenagh Town,2012,5 - 9 years,0,0,0
Nenagh Town,2012,50 - 54 years,0,2,2
Nenagh Town,2012,55 - 59 years,2,3,5
Nenagh Town,2012,60 - 64 years,2,2,4
Nenagh Town,2012,65 - 69 years,4,4,8
Nenagh Town,2012,70 - 74 years,2,6,8
Nenagh Town,2012,75 - 79 years,7,8,15
Nenagh Town,2012,80 - 84 years,3,8,11
Nenagh Town,2012,85 years and over,13,15,28
Nenagh Town,2012,Under 1 year,0,1,1
Nenagh Town,2013,1 - 4 years,0,0,0
Nenagh Town,2013,10 - 14 years,0,0,0
Nenagh Town,2013,15 - 19 years,0,0,0
Nenagh Town,2013,20 - 24 years,0,1,1
Nenagh Town,2013,25 - 29 years,1,0,1
Nenagh Town,2013,30 - 34 years,0,0,0
Nenagh Town,2013,35 - 39 years,0,0,0
Nenagh Town,2013,40 - 44 years,1,0,1
Nenagh Town,2013,45 - 49 years,1,1,2
Nenagh Town,2013,5 - 9 years,1,0,1
Nenagh Town,2013,50 - 54 years,0,1,1
Nenagh Town,2013,55 - 59 years,1,1,2
Nenagh Town,2013,60 - 64 years,0,0,0
Nenagh Town,2013,65 - 69 years,2,6,8
Nenagh Town,2013,70 - 74 years,3,4,7
Nenagh Town,2013,75 - 79 years,2,6,8
Nenagh Town,2013,80 - 84 years,8,10,18
Nenagh Town,2013,85 years and over,13,2,15
Nenagh Town,2013,Under 1 year,1,1,2
Nenagh Town,2014,1 - 4 years,0,0,0
Nenagh Town,2014,10 - 14 years,0,0,0
Nenagh Town,2014,15 - 19 years,0,0,0
Nenagh Town,2014,20 - 24 years,0,1,1
Nenagh Town,2014,25 - 29 years,1,0,1
Nenagh Town,2014,30 - 34 years,0,1,1
Nenagh Town,2014,35 - 39 years,0,0,0
Nenagh Town,2014,40 - 44 years,1,0,1
Nenagh Town,2014,45 - 49 years,1,1,2
Nenagh Town,2014,5 - 9 years,1,0,1
Nenagh Town,2014,50 - 54 years,0,1,1
Nenagh Town,2014,55 - 59 years,1,1,2
Nenagh Town,2014,60 - 64 years,3,2,5
Nenagh Town,2014,65 - 69 years,3,5,8
Nenagh Town,2014,70 - 74 years,5,8,13
Nenagh Town,2014,75 - 79 years,1,6,7
Nenagh Town,2014,80 - 84 years,4,4,8
Nenagh Town,2014,85 years and over,14,8,22
Nenagh Town,2014,Under 1 year,1,1,2
Nenagh Town,2015,1 - 4 years,0,0,0
Nenagh Town,2015,10 - 14 years,0,0,0
Nenagh Town,2015,15 - 19 years,0,0,0
Nenagh Town,2015,20 - 24 years,0,1,1
Nenagh Town,2015,25 - 29 years,1,0,1
Nenagh Town,2015,30 - 34 years,0,1,1
Nenagh Town,2015,35 - 39 years,0,0,0
Nenagh Town,2015,40 - 44 years,1,0,1
Nenagh Town,2015,45 - 49 years,1,1,2
Nenagh Town,2015,5 - 9 years,1,0,1
Nenagh Town,2015,50 - 54 years,0,1,1
Nenagh Town,2015,55 - 59 years,1,1,2
Nenagh Town,2015,60 - 64 years,3,2,5
Nenagh Town,2015,65 - 69 years,3,5,8
Nenagh Town,2015,70 - 74 years,5,8,13
Nenagh Town,2015,75 - 79 years,1,6,7
Nenagh Town,2015,80 - 84 years,4,4,8
Nenagh Town,2015,85 years and over,14,8,22
Nenagh Town,2015,Under 1 year,1,1,2
Nenagh Town,2016,1 - 4 years,0,0,0
Nenagh Town,2016,10 - 14 years,0,0,0
Nenagh Town,2016,15 - 19 years,0,0,0
Nenagh Town,2016,20 - 24 years,0,1,1
Nenagh Town,2016,25 - 29 years,1,0,1
Nenagh Town,2016,30 - 34 years,0,1,1
Nenagh Town,2016,35 - 39 years,0,0,0
Nenagh Town,2016,40 - 44 years,1,0,1
Nenagh Town,2016,45 - 49 years,1,1,2
Nenagh Town,2016,5 - 9 years,1,0,1
Nenagh Town,2016,50 - 54 years,0,1,1
Nenagh Town,2016,55 - 59 years,1,1,2
Nenagh Town,2016,60 - 64 years,3,2,5
Nenagh Town,2016,65 - 69 years,3,5,8
Nenagh Town,2016,70 - 74 years,5,8,13
Nenagh Town,2016,75 - 79 years,1,6,7
Nenagh Town,2016,80 - 84 years,4,4,8
Nenagh Town,2016,85 years and over,14,8,22
Nenagh Town,2016,Under 1 year,1,1,2
Nenagh Town,2017,1 - 4 years,0,0,0
Nenagh Town,2017,10 - 14 years,0,0,0
Nenagh Town,2017,15 - 19 years,0,0,0
Nenagh Town,2017,20 - 24 years,0,1,1
Nenagh Town,2017,25 - 29 years,1,2,3
Nenagh Town,2017,30 - 34 years,0,1,1
Nenagh Town,2017,35 - 39 years,0,1,1
Nenagh Town,2017,40 - 44 years,1,1,2
Nenagh Town,2017,45 - 49 years,1,2,3
Nenagh Town,2017,5 - 9 years,1,0,1
Nenagh Town,2017,50 - 54 years,1,1,2
Nenagh Town,2017,55 - 59 years,1,5,6
Nenagh Town,2017,60 - 64 years,3,1,4
Nenagh Town,2017,65 - 69 years,1,2,3
Nenagh Town,2017,70 - 74 years,6,4,10
Nenagh Town,2017,75 - 79 years,4,6,10
Nenagh Town,2017,80 - 84 years,4,9,13
Nenagh Town,2017,85 years and over,19,9,28
Nenagh Town,2017,Under 1 year,1,1,2
Nenagh Town,2018,1 - 4 years,0,0,0
Nenagh Town,2018,10 - 14 years,0,0,0
Nenagh Town,2018,15 - 19 years,0,0,0
Nenagh Town,2018,20 - 24 years,0,0,0
Nenagh Town,2018,25 - 29 years,0,0,0
Nenagh Town,2018,30 - 34 years,0,0,0
Nenagh Town,2018,35 - 39 years,0,1,1
Nenagh Town,2018,40 - 44 years,1,1,2
Nenagh Town,2018,45 - 49 years,0,2,2
Nenagh Town,2018,5 - 9 years,0,0,0
Nenagh Town,2018,50 - 54 years,1,1,2
Nenagh Town,2018,55 - 59 years,1,3,4
Nenagh Town,2018,60 - 64 years,3,3,6
Nenagh Town,2018,65 - 69 years,2,4,6
Nenagh Town,2018,70 - 74 years,2,5,7
Nenagh Town,2018,75 - 79 years,4,4,8
Nenagh Town,2018,80 - 84 years,5,13,18
Nenagh Town,2018,85 years and over,20,15,35
Nenagh Town,2018,Under 1 year,0,0,0
Nenagh Town,2019,1 - 4 years,0,0,0
Nenagh Town,2019,10 - 14 years,0,0,0
Nenagh Town,2019,15 - 19 years,0,0,0
Nenagh Town,2019,20 - 24 years,0,0,0
Nenagh Town,2019,25 - 29 years,0,0,0
Nenagh Town,2019,30 - 34 years,0,0,0
Nenagh Town,2019,35 - 39 years,0,1,1
Nenagh Town,2019,40 - 44 years,1,1,2
Nenagh Town,2019,45 - 49 years,0,2,2
Nenagh Town,2019,5 - 9 years,0,0,0
Nenagh Town,2019,50 - 54 years,1,1,2
Nenagh Town,2019,55 - 59 years,1,3,4
Nenagh Town,2019,60 - 64 years,3,3,6
Nenagh Town,2019,65 - 69 years,2,4,6
Nenagh Town,2019,70 - 74 years,2,5,7
Nenagh Town,2019,75 - 79 years,4,4,8
Nenagh Town,2019,80 - 84 years,5,13,18
Nenagh Town,2019,85 years and over,20,15,35
Nenagh Town,2019,Under 1 year,0,0,0
Nenagh Town,2020,1 - 4 years,0,0,0
Nenagh Town,2020,10 - 14 years,0,0,0
Nenagh Town,2020,15 - 19 years,0,0,0
Nenagh Town,2020,20 - 24 years,0,0,0
Nenagh Town,2020,25 - 29 years,0,0,0
Nenagh Town,2020,30 - 34 years,0,0,0
Nenagh Town,2020,35 - 39 years,0,1,1
Nenagh Town,2020,40 - 44 years,1,1,2
Nenagh Town,2020,45 - 49 years,0,2,2
Nenagh Town,2020,5 - 9 years,0,0,0
Nenagh Town,2020,50 - 54 years,1,1,2
Nenagh Town,2020,55 - 59 years,1,3,4
Nenagh Town,2020,60 - 64 years,3,3,6
Nenagh Town,2020,65 - 69 years,2,4,6
Nenagh Town,2020,70 - 74 years,2,5,7
Nenagh Town,2020,75 - 79 years,4,4,8
Nenagh Town,2020,80 - 84 years,5,13,18
Nenagh Town,2020,85 years and over,20,15,35
Nenagh Town,2020,Under 1 year,0,0,0
New Ross Town,2007,1 - 4 years,0,0,0
New Ross Town,2007,10 - 14 years,0,0,0
New Ross Town,2007,15 - 19 years,0,0,0
New Ross Town,2007,20 - 24 years,0,1,1
New Ross Town,2007,25 - 29 years,0,2,2
New Ross Town,2007,30 - 34 years,0,1,1
New Ross Town,2007,35 - 39 years,1,0,1
New Ross Town,2007,40 - 44 years,0,1,1
New Ross Town,2007,45 - 49 years,1,1,2
New Ross Town,2007,5 - 9 years,0,0,0
New Ross Town,2007,50 - 54 years,1,2,3
New Ross Town,2007,55 - 59 years,1,2,3
New Ross Town,2007,60 - 64 years,0,7,7
New Ross Town,2007,65 - 69 years,5,8,13
New Ross Town,2007,70 - 74 years,2,4,6
New Ross Town,2007,75 - 79 years,8,10,18
New Ross Town,2007,80 - 84 years,8,5,13
New Ross Town,2007,85 years and over,11,5,16
New Ross Town,2007,Under 1 year,1,0,1
New Ross Town,2008,1 - 4 years,0,0,0
New Ross Town,2008,10 - 14 years,0,0,0
New Ross Town,2008,15 - 19 years,0,0,0
New Ross Town,2008,20 - 24 years,0,1,1
New Ross Town,2008,25 - 29 years,0,2,2
New Ross Town,2008,30 - 34 years,0,1,1
New Ross Town,2008,35 - 39 years,1,0,1
New Ross Town,2008,40 - 44 years,2,2,4
New Ross Town,2008,45 - 49 years,1,1,2
New Ross Town,2008,5 - 9 years,0,0,0
New Ross Town,2008,50 - 54 years,1,2,3
New Ross Town,2008,55 - 59 years,3,3,6
New Ross Town,2008,60 - 64 years,2,3,5
New Ross Town,2008,65 - 69 years,4,2,6
New Ross Town,2008,70 - 74 years,3,6,9
New Ross Town,2008,75 - 79 years,5,10,15
New Ross Town,2008,80 - 84 years,7,9,16
New Ross Town,2008,85 years and over,18,7,25
New Ross Town,2008,Under 1 year,2,0,2
New Ross Town,2009,1 - 4 years,0,0,0
New Ross Town,2009,10 - 14 years,0,0,0
New Ross Town,2009,15 - 19 years,0,0,0
New Ross Town,2009,20 - 24 years,0,1,1
New Ross Town,2009,25 - 29 years,1,2,3
New Ross Town,2009,30 - 34 years,0,1,1
New Ross Town,2009,35 - 39 years,1,0,1
New Ross Town,2009,40 - 44 years,2,2,4
New Ross Town,2009,45 - 49 years,1,1,2
New Ross Town,2009,5 - 9 years,0,0,0
New Ross Town,2009,50 - 54 years,1,1,2
New Ross Town,2009,55 - 59 years,3,2,5
New Ross Town,2009,60 - 64 years,1,3,4
New Ross Town,2009,65 - 69 years,3,2,5
New Ross Town,2009,70 - 74 years,3,4,7
New Ross Town,2009,75 - 79 years,4,7,11
New Ross Town,2009,80 - 84 years,3,4,7
New Ross Town,2009,85 years and over,2,3,5
New Ross Town,2009,Under 1 year,2,2,4
New Ross Town,2010,1 - 4 years,0,0,0
New Ross Town,2010,10 - 14 years,0,0,0
New Ross Town,2010,15 - 19 years,0,0,0
New Ross Town,2010,20 - 24 years,0,1,1
New Ross Town,2010,25 - 29 years,1,2,3
New Ross Town,2010,30 - 34 years,0,1,1
New Ross Town,2010,35 - 39 years,1,2,3
New Ross Town,2010,40 - 44 years,2,1,3
New Ross Town,2010,45 - 49 years,1,1,2
New Ross Town,2010,5 - 9 years,0,0,0
New Ross Town,2010,50 - 54 years,1,2,3
New Ross Town,2010,55 - 59 years,1,1,2
New Ross Town,2010,60 - 64 years,1,3,4
New Ross Town,2010,65 - 69 years,3,4,7
New Ross Town,2010,70 - 74 years,3,4,7
New Ross Town,2010,75 - 79 years,5,3,8
New Ross Town,2010,80 - 84 years,6,3,9
New Ross Town,2010,85 years and over,12,3,15
New Ross Town,2010,Under 1 year,2,2,4
New Ross Town,2011,1 - 4 years,0,0,0
New Ross Town,2011,10 - 14 years,0,0,0
New Ross Town,2011,15 - 19 years,0,0,0
New Ross Town,2011,20 - 24 years,0,1,1
New Ross Town,2011,25 - 29 years,0,1,1
New Ross Town,2011,30 - 34 years,0,0,0
New Ross Town,2011,35 - 39 years,1,1,2
New Ross Town,2011,40 - 44 years,1,0,1
New Ross Town,2011,45 - 49 years,1,1,2
New Ross Town,2011,5 - 9 years,0,0,0
New Ross Town,2011,50 - 54 years,2,2,4
New Ross Town,2011,55 - 59 years,0,3,3
New Ross Town,2011,60 - 64 years,1,1,2
New Ross Town,2011,65 - 69 years,3,1,4
New Ross Town,2011,70 - 74 years,1,0,1
New Ross Town,2011,75 - 79 years,3,6,9
New Ross Town,2011,80 - 84 years,3,3,6
New Ross Town,2011,85 years and over,10,2,12
New Ross Town,2011,Under 1 year,0,0,0
New Ross Town,2012,1 - 4 years,0,0,0
New Ross Town,2012,10 - 14 years,0,0,0
New Ross Town,2012,15 - 19 years,0,0,0
New Ross Town,2012,20 - 24 years,0,1,1
New Ross Town,2012,25 - 29 years,0,1,1
New Ross Town,2012,30 - 34 years,0,0,0
New Ross Town,2012,35 - 39 years,1,1,2
New Ross Town,2012,40 - 44 years,1,0,1
New Ross Town,2012,45 - 49 years,1,1,2
New Ross Town,2012,5 - 9 years,0,0,0
New Ross Town,2012,50 - 54 years,3,3,6
New Ross Town,2012,55 - 59 years,1,2,3
New Ross Town,2012,60 - 64 years,1,1,2
New Ross Town,2012,65 - 69 years,3,3,6
New Ross Town,2012,70 - 74 years,4,4,8
New Ross Town,2012,75 - 79 years,3,7,10
New Ross Town,2012,80 - 84 years,5,3,8
New Ross Town,2012,85 years and over,14,6,20
New Ross Town,2012,Under 1 year,1,1,2
New Ross Town,2013,1 - 4 years,0,0,0
New Ross Town,2013,10 - 14 years,0,0,0
New Ross Town,2013,15 - 19 years,0,0,0
New Ross Town,2013,20 - 24 years,1,0,1
New Ross Town,2013,25 - 29 years,0,0,0
New Ross Town,2013,30 - 34 years,0,2,2
New Ross Town,2013,35 - 39 years,0,1,1
New Ross Town,2013,40 - 44 years,0,1,1
New Ross Town,2013,45 - 49 years,0,0,0
New Ross Town,2013,5 - 9 years,0,0,0
New Ross Town,2013,50 - 54 years,0,0,0
New Ross Town,2013,55 - 59 years,2,1,3
New Ross Town,2013,60 - 64 years,0,2,2
New Ross Town,2013,65 - 69 years,7,2,9
New Ross Town,2013,70 - 74 years,5,1,6
New Ross Town,2013,75 - 79 years,4,4,8
New Ross Town,2013,80 - 84 years,2,5,7
New Ross Town,2013,85 years and over,9,4,13
New Ross Town,2013,Under 1 year,0,0,0
New Ross Town,2014,1 - 4 years,2,1,3
New Ross Town,2014,10 - 14 years,0,0,0
New Ross Town,2014,15 - 19 years,0,0,0
New Ross Town,2014,20 - 24 years,1,1,2
New Ross Town,2014,25 - 29 years,0,0,0
New Ross Town,2014,30 - 34 years,0,1,1
New Ross Town,2014,35 - 39 years,0,1,1
New Ross Town,2014,40 - 44 years,1,2,3
New Ross Town,2014,45 - 49 years,1,0,1
New Ross Town,2014,5 - 9 years,0,0,0
New Ross Town,2014,50 - 54 years,0,3,3
New Ross Town,2014,55 - 59 years,1,5,6
New Ross Town,2014,60 - 64 years,1,3,4
New Ross Town,2014,65 - 69 years,1,4,5
New Ross Town,2014,70 - 74 years,5,4,9
New Ross Town,2014,75 - 79 years,7,10,17
New Ross Town,2014,80 - 84 years,8,6,14
New Ross Town,2014,85 years and over,14,9,23
New Ross Town,2014,Under 1 year,0,0,0
New Ross Town,2015,1 - 4 years,2,1,3
New Ross Town,2015,10 - 14 years,0,0,0
New Ross Town,2015,15 - 19 years,0,0,0
New Ross Town,2015,20 - 24 years,1,1,2
New Ross Town,2015,25 - 29 years,0,0,0
New Ross Town,2015,30 - 34 years,0,1,1
New Ross Town,2015,35 - 39 years,0,1,1
New Ross Town,2015,40 - 44 years,1,2,3
New Ross Town,2015,45 - 49 years,1,0,1
New Ross Town,2015,5 - 9 years,0,0,0
New Ross Town,2015,50 - 54 years,0,3,3
New Ross Town,2015,55 - 59 years,1,5,6
New Ross Town,2015,60 - 64 years,1,3,4
New Ross Town,2015,65 - 69 years,1,4,5
New Ross Town,2015,70 - 74 years,5,4,9
New Ross Town,2015,75 - 79 years,7,10,17
New Ross Town,2015,80 - 84 years,8,6,14
New Ross Town,2015,85 years and over,14,9,23
New Ross Town,2015,Under 1 year,0,0,0
New Ross Town,2016,1 - 4 years,2,1,3
New Ross Town,2016,10 - 14 years,0,0,0
New Ross Town,2016,15 - 19 years,0,0,0
New Ross Town,2016,20 - 24 years,1,1,2
New Ross Town,2016,25 - 29 years,0,0,0
New Ross Town,2016,30 - 34 years,0,1,1
New Ross Town,2016,35 - 39 years,0,1,1
New Ross Town,2016,40 - 44 years,1,2,3
New Ross Town,2016,45 - 49 years,1,0,1
New Ross Town,2016,5 - 9 years,0,0,0
New Ross Town,2016,50 - 54 years,0,3,3
New Ross Town,2016,55 - 59 years,1,5,6
New Ross Town,2016,60 - 64 years,1,3,4
New Ross Town,2016,65 - 69 years,1,4,5
New Ross Town,2016,70 - 74 years,5,4,9
New Ross Town,2016,75 - 79 years,7,10,17
New Ross Town,2016,80 - 84 years,8,6,14
New Ross Town,2016,85 years and over,14,9,23
New Ross Town,2016,Under 1 year,0,0,0
New Ross Town,2017,1 - 4 years,2,1,3
New Ross Town,2017,10 - 14 years,0,0,0
New Ross Town,2017,15 - 19 years,0,0,0
New Ross Town,2017,20 - 24 years,1,1,2
New Ross Town,2017,25 - 29 years,0,0,0
New Ross Town,2017,30 - 34 years,0,1,1
New Ross Town,2017,35 - 39 years,0,1,1
New Ross Town,2017,40 - 44 years,1,2,3
New Ross Town,2017,45 - 49 years,1,0,1
New Ross Town,2017,5 - 9 years,0,0,0
New Ross Town,2017,50 - 54 years,0,3,3
New Ross Town,2017,55 - 59 years,1,1,2
New Ross Town,2017,60 - 64 years,4,3,7
New Ross Town,2017,65 - 69 years,4,3,7
New Ross Town,2017,70 - 74 years,1,6,7
New Ross Town,2017,75 - 79 years,4,7,11
New Ross Town,2017,80 - 84 years,2,3,5
New Ross Town,2017,85 years and over,17,6,23
New Ross Town,2017,Under 1 year,0,0,0
New Ross Town,2018,1 - 4 years,0,0,0
New Ross Town,2018,10 - 14 years,0,0,0
New Ross Town,2018,15 - 19 years,0,0,0
New Ross Town,2018,20 - 24 years,0,0,0
New Ross Town,2018,25 - 29 years,0,0,0
New Ross Town,2018,30 - 34 years,0,1,1
New Ross Town,2018,35 - 39 years,0,0,0
New Ross Town,2018,40 - 44 years,0,1,1
New Ross Town,2018,45 - 49 years,0,2,2
New Ross Town,2018,5 - 9 years,0,0,0
New Ross Town,2018,50 - 54 years,2,2,4
New Ross Town,2018,55 - 59 years,0,3,3
New Ross Town,2018,60 - 64 years,2,3,5
New Ross Town,2018,65 - 69 years,2,1,3
New Ross Town,2018,70 - 74 years,3,9,12
New Ross Town,2018,75 - 79 years,5,7,12
New Ross Town,2018,80 - 84 years,8,7,15
New Ross Town,2018,85 years and over,14,7,21
New Ross Town,2018,Under 1 year,0,0,0
New Ross Town,2019,1 - 4 years,0,0,0
New Ross Town,2019,10 - 14 years,0,0,0
New Ross Town,2019,15 - 19 years,0,0,0
New Ross Town,2019,20 - 24 years,0,0,0
New Ross Town,2019,25 - 29 years,0,0,0
New Ross Town,2019,30 - 34 years,0,1,1
New Ross Town,2019,35 - 39 years,0,0,0
New Ross Town,2019,40 - 44 years,0,1,1
New Ross Town,2019,45 - 49 years,0,2,2
New Ross Town,2019,5 - 9 years,0,0,0
New Ross Town,2019,50 - 54 years,2,2,4
New Ross Town,2019,55 - 59 years,0,3,3
New Ross Town,2019,60 - 64 years,2,3,5
New Ross Town,2019,65 - 69 years,2,1,3
New Ross Town,2019,70 - 74 years,3,9,12
New Ross Town,2019,75 - 79 years,5,7,12
New Ross Town,2019,80 - 84 years,8,7,15
New Ross Town,2019,85 years and over,14,7,21
New Ross Town,2019,Under 1 year,0,0,0
New Ross Town,2020,1 - 4 years,0,0,0
New Ross Town,2020,10 - 14 years,0,0,0
New Ross Town,2020,15 - 19 years,0,0,0
New Ross Town,2020,20 - 24 years,0,0,0
New Ross Town,2020,25 - 29 years,0,0,0
New Ross Town,2020,30 - 34 years,0,1,1
New Ross Town,2020,35 - 39 years,0,0,0
New Ross Town,2020,40 - 44 years,0,1,1
New Ross Town,2020,45 - 49 years,0,2,2
New Ross Town,2020,5 - 9 years,0,0,0
New Ross Town,2020,50 - 54 years,2,2,4
New Ross Town,2020,55 - 59 years,0,3,3
New Ross Town,2020,60 - 64 years,2,3,5
New Ross Town,2020,65 - 69 years,2,1,3
New Ross Town,2020,70 - 74 years,3,9,12
New Ross Town,2020,75 - 79 years,5,7,12
New Ross Town,2020,80 - 84 years,8,7,15
New Ross Town,2020,85 years and over,14,7,21
New Ross Town,2020,Under 1 year,0,0,0
North Tipperary,2007,1 - 4 years,0,1,1
North Tipperary,2007,10 - 14 years,0,1,1
North Tipperary,2007,15 - 19 years,0,2,2
North Tipperary,2007,20 - 24 years,1,1,2
North Tipperary,2007,25 - 29 years,0,5,5
North Tipperary,2007,30 - 34 years,1,2,3
North Tipperary,2007,35 - 39 years,0,1,1
North Tipperary,2007,40 - 44 years,2,4,6
North Tipperary,2007,45 - 49 years,1,5,6
North Tipperary,2007,5 - 9 years,2,0,2
North Tipperary,2007,50 - 54 years,4,10,14
North Tipperary,2007,55 - 59 years,6,9,15
North Tipperary,2007,60 - 64 years,14,23,37
North Tipperary,2007,65 - 69 years,20,17,37
North Tipperary,2007,70 - 74 years,36,47,83
North Tipperary,2007,75 - 79 years,46,53,99
North Tipperary,2007,80 - 84 years,59,69,128
North Tipperary,2007,85 years and over,110,56,166
North Tipperary,2007,Under 1 year,3,3,6
North Tipperary,2008,1 - 4 years,0,1,1
North Tipperary,2008,10 - 14 years,0,1,1
North Tipperary,2008,15 - 19 years,0,2,2
North Tipperary,2008,20 - 24 years,1,3,4
North Tipperary,2008,25 - 29 years,1,5,6
North Tipperary,2008,30 - 34 years,2,3,5
North Tipperary,2008,35 - 39 years,2,4,6
North Tipperary,2008,40 - 44 years,3,5,8
North Tipperary,2008,45 - 49 years,7,6,13
North Tipperary,2008,5 - 9 years,2,1,3
North Tipperary,2008,50 - 54 years,4,10,14
North Tipperary,2008,55 - 59 years,3,14,17
North Tipperary,2008,60 - 64 years,8,22,30
North Tipperary,2008,65 - 69 years,11,23,34
North Tipperary,2008,70 - 74 years,27,54,81
North Tipperary,2008,75 - 79 years,41,54,95
North Tipperary,2008,80 - 84 years,49,55,104
North Tipperary,2008,85 years and over,110,74,184
North Tipperary,2008,Under 1 year,1,5,6
North Tipperary,2009,1 - 4 years,0,1,1
North Tipperary,2009,10 - 14 years,0,1,1
North Tipperary,2009,15 - 19 years,0,2,2
North Tipperary,2009,20 - 24 years,1,7,8
North Tipperary,2009,25 - 29 years,1,4,5
North Tipperary,2009,30 - 34 years,1,5,6
North Tipperary,2009,35 - 39 years,1,5,6
North Tipperary,2009,40 - 44 years,1,2,3
North Tipperary,2009,45 - 49 years,5,9,14
North Tipperary,2009,5 - 9 years,2,1,3
North Tipperary,2009,50 - 54 years,6,6,12
North Tipperary,2009,55 - 59 years,7,14,21
North Tipperary,2009,60 - 64 years,16,18,34
North Tipperary,2009,65 - 69 years,22,27,49
North Tipperary,2009,70 - 74 years,21,39,60
North Tipperary,2009,75 - 79 years,45,52,97
North Tipperary,2009,80 - 84 years,61,49,110
North Tipperary,2009,85 years and over,96,73,169
North Tipperary,2009,Under 1 year,3,3,6
North Tipperary,2010,1 - 4 years,0,1,1
North Tipperary,2010,10 - 14 years,0,1,1
North Tipperary,2010,15 - 19 years,0,1,1
North Tipperary,2010,20 - 24 years,1,3,4
North Tipperary,2010,25 - 29 years,1,4,5
North Tipperary,2010,30 - 34 years,1,2,3
North Tipperary,2010,35 - 39 years,4,3,7
North Tipperary,2010,40 - 44 years,6,3,9
North Tipperary,2010,45 - 49 years,4,6,10
North Tipperary,2010,5 - 9 years,2,1,3
North Tipperary,2010,50 - 54 years,7,12,19
North Tipperary,2010,55 - 59 years,11,14,25
North Tipperary,2010,60 - 64 years,10,22,32
North Tipperary,2010,65 - 69 years,15,24,39
North Tipperary,2010,70 - 74 years,19,38,57
North Tipperary,2010,75 - 79 years,31,38,69
North Tipperary,2010,80 - 84 years,56,61,117
North Tipperary,2010,85 years and over,121,80,201
North Tipperary,2010,Under 1 year,3,1,4
North Tipperary,2011,1 - 4 years,0,0,0
North Tipperary,2011,10 - 14 years,0,0,0
North Tipperary,2011,15 - 19 years,0,3,3
North Tipperary,2011,20 - 24 years,1,1,2
North Tipperary,2011,25 - 29 years,2,2,4
North Tipperary,2011,30 - 34 years,1,1,2
North Tipperary,2011,35 - 39 years,0,6,6
North Tipperary,2011,40 - 44 years,5,4,9
North Tipperary,2011,45 - 49 years,2,8,10
North Tipperary,2011,5 - 9 years,0,0,0
North Tipperary,2011,50 - 54 years,7,9,16
North Tipperary,2011,55 - 59 years,10,9,19
North Tipperary,2011,60 - 64 years,12,24,36
North Tipperary,2011,65 - 69 years,13,28,41
North Tipperary,2011,70 - 74 years,18,25,43
North Tipperary,2011,75 - 79 years,31,52,83
North Tipperary,2011,80 - 84 years,45,52,97
North Tipperary,2011,85 years and over,128,67,195
North Tipperary,2011,Under 1 year,1,2,3
North Tipperary,2012,1 - 4 years,0,0,0
North Tipperary,2012,10 - 14 years,0,0,0
North Tipperary,2012,15 - 19 years,0,1,1
North Tipperary,2012,20 - 24 years,1,1,2
North Tipperary,2012,25 - 29 years,2,1,3
North Tipperary,2012,30 - 34 years,1,1,2
North Tipperary,2012,35 - 39 years,0,6,6
North Tipperary,2012,40 - 44 years,2,2,4
North Tipperary,2012,45 - 49 years,10,3,13
North Tipperary,2012,5 - 9 years,0,0,0
North Tipperary,2012,50 - 54 years,5,11,16
North Tipperary,2012,55 - 59 years,13,13,26
North Tipperary,2012,60 - 64 years,6,23,29
North Tipperary,2012,65 - 69 years,18,22,40
North Tipperary,2012,70 - 74 years,20,35,55
North Tipperary,2012,75 - 79 years,36,39,75
North Tipperary,2012,80 - 84 years,40,48,88
North Tipperary,2012,85 years and over,124,78,202
North Tipperary,2012,Under 1 year,6,4,10
North Tipperary,2013,1 - 4 years,0,0,0
North Tipperary,2013,10 - 14 years,2,0,2
North Tipperary,2013,15 - 19 years,1,2,3
North Tipperary,2013,20 - 24 years,0,6,6
North Tipperary,2013,25 - 29 years,1,3,4
North Tipperary,2013,30 - 34 years,1,3,4
North Tipperary,2013,35 - 39 years,0,1,1
North Tipperary,2013,40 - 44 years,3,2,5
North Tipperary,2013,45 - 49 years,3,7,10
North Tipperary,2013,5 - 9 years,1,0,1
North Tipperary,2013,50 - 54 years,5,9,14
North Tipperary,2013,55 - 59 years,7,10,17
North Tipperary,2013,60 - 64 years,10,13,23
North Tipperary,2013,65 - 69 years,18,35,53
North Tipperary,2013,70 - 74 years,19,32,51
North Tipperary,2013,75 - 79 years,23,36,59
North Tipperary,2013,80 - 84 years,45,51,96
North Tipperary,2013,85 years and over,126,63,189
North Tipperary,2013,Under 1 year,4,3,7
North Tipperary,2014,1 - 4 years,0,0,0
North Tipperary,2014,10 - 14 years,2,0,2
North Tipperary,2014,15 - 19 years,1,3,4
North Tipperary,2014,20 - 24 years,0,2,2
North Tipperary,2014,25 - 29 years,1,2,3
North Tipperary,2014,30 - 34 years,2,4,6
North Tipperary,2014,35 - 39 years,0,2,2
North Tipperary,2014,40 - 44 years,3,3,6
North Tipperary,2014,45 - 49 years,3,4,7
North Tipperary,2014,5 - 9 years,1,0,1
North Tipperary,2014,50 - 54 years,5,4,9
North Tipperary,2014,55 - 59 years,10,16,26
North Tipperary,2014,60 - 64 years,12,20,32
North Tipperary,2014,65 - 69 years,14,25,39
North Tipperary,2014,70 - 74 years,23,50,73
North Tipperary,2014,75 - 79 years,21,39,60
North Tipperary,2014,80 - 84 years,52,50,102
North Tipperary,2014,85 years and over,113,78,191
North Tipperary,2014,Under 1 year,3,3,6
North Tipperary,2015,1 - 4 years,0,1,1
North Tipperary,2015,10 - 14 years,2,0,2
North Tipperary,2015,15 - 19 years,1,3,4
North Tipperary,2015,20 - 24 years,1,2,3
North Tipperary,2015,25 - 29 years,1,1,2
North Tipperary,2015,30 - 34 years,4,4,8
North Tipperary,2015,35 - 39 years,3,3,6
North Tipperary,2015,40 - 44 years,5,5,10
North Tipperary,2015,45 - 49 years,3,4,7
North Tipperary,2015,5 - 9 years,1,0,1
North Tipperary,2015,50 - 54 years,5,8,13
North Tipperary,2015,55 - 59 years,10,10,20
North Tipperary,2015,60 - 64 years,8,21,29
North Tipperary,2015,65 - 69 years,12,37,49
North Tipperary,2015,70 - 74 years,21,21,42
North Tipperary,2015,75 - 79 years,30,44,74
North Tipperary,2015,80 - 84 years,41,45,86
North Tipperary,2015,85 years and over,142,100,242
North Tipperary,2015,Under 1 year,1,1,2
North Tipperary,2016,1 - 4 years,0,1,1
North Tipperary,2016,10 - 14 years,2,0,2
North Tipperary,2016,15 - 19 years,2,2,4
North Tipperary,2016,20 - 24 years,1,3,4
North Tipperary,2016,25 - 29 years,1,3,4
North Tipperary,2016,30 - 34 years,1,1,2
North Tipperary,2016,35 - 39 years,4,3,7
North Tipperary,2016,40 - 44 years,2,5,7
North Tipperary,2016,45 - 49 years,4,4,8
North Tipperary,2016,5 - 9 years,1,1,2
North Tipperary,2016,50 - 54 years,3,8,11
North Tipperary,2016,55 - 59 years,11,7,18
North Tipperary,2016,60 - 64 years,20,13,33
North Tipperary,2016,65 - 69 years,24,22,46
North Tipperary,2016,70 - 74 years,26,40,66
North Tipperary,2016,75 - 79 years,31,43,74
North Tipperary,2016,80 - 84 years,62,53,115
North Tipperary,2016,85 years and over,152,78,230
North Tipperary,2016,Under 1 year,1,1,2
North Tipperary,2017,1 - 4 years,1,1,2
North Tipperary,2017,10 - 14 years,1,0,1
North Tipperary,2017,15 - 19 years,2,1,3
North Tipperary,2017,20 - 24 years,1,4,5
North Tipperary,2017,25 - 29 years,1,4,5
North Tipperary,2017,30 - 34 years,1,2,3
North Tipperary,2017,35 - 39 years,1,2,3
North Tipperary,2017,40 - 44 years,5,5,10
North Tipperary,2017,45 - 49 years,3,6,9
North Tipperary,2017,5 - 9 years,1,1,2
North Tipperary,2017,50 - 54 years,5,6,11
North Tipperary,2017,55 - 59 years,2,14,16
North Tipperary,2017,60 - 64 years,10,12,22
North Tipperary,2017,65 - 69 years,16,23,39
North Tipperary,2017,70 - 74 years,26,32,58
North Tipperary,2017,75 - 79 years,24,34,58
North Tipperary,2017,80 - 84 years,36,56,92
North Tipperary,2017,85 years and over,141,85,226
North Tipperary,2017,Under 1 year,1,1,2
North Tipperary,2018,1 - 4 years,1,1,2
North Tipperary,2018,10 - 14 years,1,0,1
North Tipperary,2018,15 - 19 years,2,1,3
North Tipperary,2018,20 - 24 years,1,4,5
North Tipperary,2018,25 - 29 years,1,4,5
North Tipperary,2018,30 - 34 years,1,2,3
North Tipperary,2018,35 - 39 years,1,2,3
North Tipperary,2018,40 - 44 years,5,5,10
North Tipperary,2018,45 - 49 years,3,6,9
North Tipperary,2018,5 - 9 years,1,1,2
North Tipperary,2018,50 - 54 years,5,6,11
North Tipperary,2018,55 - 59 years,2,14,16
North Tipperary,2018,60 - 64 years,10,12,22
North Tipperary,2018,65 - 69 years,16,23,39
North Tipperary,2018,70 - 74 years,26,32,58
North Tipperary,2018,75 - 79 years,24,34,58
North Tipperary,2018,80 - 84 years,36,56,92
North Tipperary,2018,85 years and over,141,85,226
North Tipperary,2018,Under 1 year,1,1,2
North Tipperary,2019,1 - 4 years,1,1,2
North Tipperary,2019,10 - 14 years,1,0,1
North Tipperary,2019,15 - 19 years,2,1,3
North Tipperary,2019,20 - 24 years,1,4,5
North Tipperary,2019,25 - 29 years,1,4,5
North Tipperary,2019,30 - 34 years,1,2,3
North Tipperary,2019,35 - 39 years,1,2,3
North Tipperary,2019,40 - 44 years,5,5,10
North Tipperary,2019,45 - 49 years,3,6,9
North Tipperary,2019,5 - 9 years,1,1,2
North Tipperary,2019,50 - 54 years,5,6,11
North Tipperary,2019,55 - 59 years,2,14,16
North Tipperary,2019,60 - 64 years,10,12,22
North Tipperary,2019,65 - 69 years,16,23,39
North Tipperary,2019,70 - 74 years,26,32,58
North Tipperary,2019,75 - 79 years,24,34,58
North Tipperary,2019,80 - 84 years,36,56,92
North Tipperary,2019,85 years and over,141,85,226
North Tipperary,2019,Under 1 year,1,1,2
North Tipperary,2020,1 - 4 years,1,1,2
North Tipperary,2020,10 - 14 years,1,0,1
North Tipperary,2020,15 - 19 years,2,1,3
North Tipperary,2020,20 - 24 years,1,4,5
North Tipperary,2020,25 - 29 years,1,4,5
North Tipperary,2020,30 - 34 years,1,2,3
North Tipperary,2020,35 - 39 years,1,2,3
North Tipperary,2020,40 - 44 years,5,5,10
North Tipperary,2020,45 - 49 years,3,6,9
North Tipperary,2020,5 - 9 years,1,1,2
North Tipperary,2020,50 - 54 years,5,6,11
North Tipperary,2020,55 - 59 years,2,14,16
North Tipperary,2020,60 - 64 years,10,12,22
North Tipperary,2020,65 - 69 years,16,23,39
North Tipperary,2020,70 - 74 years,26,32,58
North Tipperary,2020,75 - 79 years,24,34,58
North Tipperary,2020,80 - 84 years,36,56,92
North Tipperary,2020,85 years and over,141,85,226
North Tipperary,2020,Under 1 year,1,1,2
Offaly,2007,1 - 4 years,0,0,0
Offaly,2007,10 - 14 years,0,0,0
Offaly,2007,15 - 19 years,0,1,1
Offaly,2007,20 - 24 years,1,3,4
Offaly,2007,25 - 29 years,0,4,4
Offaly,2007,30 - 34 years,1,4,5
Offaly,2007,35 - 39 years,1,0,1
Offaly,2007,40 - 44 years,6,4,10
Offaly,2007,45 - 49 years,1,6,7
Offaly,2007,5 - 9 years,0,0,0
Offaly,2007,50 - 54 years,5,5,10
Offaly,2007,55 - 59 years,8,11,19
Offaly,2007,60 - 64 years,9,22,31
Offaly,2007,65 - 69 years,10,18,28
Offaly,2007,70 - 74 years,15,31,46
Offaly,2007,75 - 79 years,28,34,62
Offaly,2007,80 - 84 years,49,38,87
Offaly,2007,85 years and over,92,41,133
Offaly,2007,Under 1 year,1,3,4
Offaly,2008,1 - 4 years,0,0,0
Offaly,2008,10 - 14 years,0,1,1
Offaly,2008,15 - 19 years,1,2,3
Offaly,2008,20 - 24 years,1,5,6
Offaly,2008,25 - 29 years,1,4,5
Offaly,2008,30 - 34 years,1,3,4
Offaly,2008,35 - 39 years,2,2,4
Offaly,2008,40 - 44 years,4,3,7
Offaly,2008,45 - 49 years,7,5,12
Offaly,2008,5 - 9 years,0,1,1
Offaly,2008,50 - 54 years,6,6,12
Offaly,2008,55 - 59 years,6,9,15
Offaly,2008,60 - 64 years,12,13,25
Offaly,2008,65 - 69 years,6,23,29
Offaly,2008,70 - 74 years,14,25,39
Offaly,2008,75 - 79 years,29,46,75
Offaly,2008,80 - 84 years,39,52,91
Offaly,2008,85 years and over,85,49,134
Offaly,2008,Under 1 year,1,3,4
Offaly,2009,1 - 4 years,0,1,1
Offaly,2009,10 - 14 years,1,1,2
Offaly,2009,15 - 19 years,1,2,3
Offaly,2009,20 - 24 years,2,4,6
Offaly,2009,25 - 29 years,1,5,6
Offaly,2009,30 - 34 years,1,7,8
Offaly,2009,35 - 39 years,3,3,6
Offaly,2009,40 - 44 years,3,1,4
Offaly,2009,45 - 49 years,4,5,9
Offaly,2009,5 - 9 years,0,1,1
Offaly,2009,50 - 54 years,5,4,9
Offaly,2009,55 - 59 years,10,9,19
Offaly,2009,60 - 64 years,9,22,31
Offaly,2009,65 - 69 years,14,23,37
Offaly,2009,70 - 74 years,17,23,40
Offaly,2009,75 - 79 years,40,35,75
Offaly,2009,80 - 84 years,47,33,80
Offaly,2009,85 years and over,79,54,133
Offaly,2009,Under 1 year,3,5,8
Offaly,2010,1 - 4 years,0,1,1
Offaly,2010,10 - 14 years,1,1,2
Offaly,2010,15 - 19 years,3,1,4
Offaly,2010,20 - 24 years,2,4,6
Offaly,2010,25 - 29 years,1,3,4
Offaly,2010,30 - 34 years,1,2,3
Offaly,2010,35 - 39 years,1,4,5
Offaly,2010,40 - 44 years,4,6,10
Offaly,2010,45 - 49 years,2,1,3
Offaly,2010,5 - 9 years,0,1,1
Offaly,2010,50 - 54 years,3,11,14
Offaly,2010,55 - 59 years,7,13,20
Offaly,2010,60 - 64 years,8,14,22
Offaly,2010,65 - 69 years,9,18,27
Offaly,2010,70 - 74 years,15,18,33
Offaly,2010,75 - 79 years,36,33,69
Offaly,2010,80 - 84 years,40,43,83
Offaly,2010,85 years and over,79,46,125
Offaly,2010,Under 1 year,3,5,8
Offaly,2011,1 - 4 years,2,0,2
Offaly,2011,10 - 14 years,0,0,0
Offaly,2011,15 - 19 years,0,2,2
Offaly,2011,20 - 24 years,0,2,2
Offaly,2011,25 - 29 years,0,3,3
Offaly,2011,30 - 34 years,3,4,7
Offaly,2011,35 - 39 years,1,4,5
Offaly,2011,40 - 44 years,8,6,14
Offaly,2011,45 - 49 years,1,5,6
Offaly,2011,5 - 9 years,0,0,0
Offaly,2011,50 - 54 years,7,8,15
Offaly,2011,55 - 59 years,5,6,11
Offaly,2011,60 - 64 years,7,16,23
Offaly,2011,65 - 69 years,15,22,37
Offaly,2011,70 - 74 years,10,28,38
Offaly,2011,75 - 79 years,27,29,56
Offaly,2011,80 - 84 years,32,47,79
Offaly,2011,85 years and over,90,52,142
Offaly,2011,Under 1 year,1,4,5
Offaly,2012,1 - 4 years,2,0,2
Offaly,2012,10 - 14 years,1,0,1
Offaly,2012,15 - 19 years,1,2,3
Offaly,2012,20 - 24 years,1,2,3
Offaly,2012,25 - 29 years,0,2,2
Offaly,2012,30 - 34 years,2,3,5
Offaly,2012,35 - 39 years,2,6,8
Offaly,2012,40 - 44 years,8,3,11
Offaly,2012,45 - 49 years,3,5,8
Offaly,2012,5 - 9 years,1,0,1
Offaly,2012,50 - 54 years,3,9,12
Offaly,2012,55 - 59 years,7,13,20
Offaly,2012,60 - 64 years,15,17,32
Offaly,2012,65 - 69 years,12,18,30
Offaly,2012,70 - 74 years,15,33,48
Offaly,2012,75 - 79 years,28,34,62
Offaly,2012,80 - 84 years,32,27,59
Offaly,2012,85 years and over,84,61,145
Offaly,2012,Under 1 year,1,1,2
Offaly,2013,1 - 4 years,0,0,0
Offaly,2013,10 - 14 years,0,0,0
Offaly,2013,15 - 19 years,1,2,3
Offaly,2013,20 - 24 years,0,0,0
Offaly,2013,25 - 29 years,1,4,5
Offaly,2013,30 - 34 years,1,1,2
Offaly,2013,35 - 39 years,0,1,1
Offaly,2013,40 - 44 years,1,4,5
Offaly,2013,45 - 49 years,4,9,13
Offaly,2013,5 - 9 years,1,0,1
Offaly,2013,50 - 54 years,2,4,6
Offaly,2013,55 - 59 years,8,4,12
Offaly,2013,60 - 64 years,8,19,27
Offaly,2013,65 - 69 years,15,14,29
Offaly,2013,70 - 74 years,19,35,54
Offaly,2013,75 - 79 years,26,37,63
Offaly,2013,80 - 84 years,39,35,74
Offaly,2013,85 years and over,103,73,176
Offaly,2013,Under 1 year,2,3,5
Offaly,2014,1 - 4 years,1,0,1
Offaly,2014,10 - 14 years,0,3,3
Offaly,2014,15 - 19 years,1,1,2
Offaly,2014,20 - 24 years,1,0,1
Offaly,2014,25 - 29 years,1,2,3
Offaly,2014,30 - 34 years,1,4,5
Offaly,2014,35 - 39 years,2,2,4
Offaly,2014,40 - 44 years,3,2,5
Offaly,2014,45 - 49 years,4,5,9
Offaly,2014,5 - 9 years,1,2,3
Offaly,2014,50 - 54 years,4,5,9
Offaly,2014,55 - 59 years,11,13,24
Offaly,2014,60 - 64 years,6,14,20
Offaly,2014,65 - 69 years,13,18,31
Offaly,2014,70 - 74 years,24,26,50
Offaly,2014,75 - 79 years,24,30,54
Offaly,2014,80 - 84 years,35,37,72
Offaly,2014,85 years and over,100,61,161
Offaly,2014,Under 1 year,2,3,5
Offaly,2015,1 - 4 years,1,0,1
Offaly,2015,10 - 14 years,0,3,3
Offaly,2015,15 - 19 years,1,1,2
Offaly,2015,20 - 24 years,1,1,2
Offaly,2015,25 - 29 years,1,3,4
Offaly,2015,30 - 34 years,1,1,2
Offaly,2015,35 - 39 years,1,4,5
Offaly,2015,40 - 44 years,2,2,4
Offaly,2015,45 - 49 years,5,5,10
Offaly,2015,5 - 9 years,1,2,3
Offaly,2015,50 - 54 years,10,4,14
Offaly,2015,55 - 59 years,7,12,19
Offaly,2015,60 - 64 years,12,10,22
Offaly,2015,65 - 69 years,8,24,32
Offaly,2015,70 - 74 years,25,45,70
Offaly,2015,75 - 79 years,21,35,56
Offaly,2015,80 - 84 years,30,44,74
Offaly,2015,85 years and over,99,64,163
Offaly,2015,Under 1 year,1,3,4
Offaly,2016,1 - 4 years,1,0,1
Offaly,2016,10 - 14 years,0,3,3
Offaly,2016,15 - 19 years,1,2,3
Offaly,2016,20 - 24 years,1,2,3
Offaly,2016,25 - 29 years,1,2,3
Offaly,2016,30 - 34 years,1,3,4
Offaly,2016,35 - 39 years,1,4,5
Offaly,2016,40 - 44 years,2,7,9
Offaly,2016,45 - 49 years,3,1,4
Offaly,2016,5 - 9 years,1,2,3
Offaly,2016,50 - 54 years,5,8,13
Offaly,2016,55 - 59 years,1,9,10
Offaly,2016,60 - 64 years,10,11,21
Offaly,2016,65 - 69 years,18,23,41
Offaly,2016,70 - 74 years,22,25,47
Offaly,2016,75 - 79 years,20,34,54
Offaly,2016,80 - 84 years,47,45,92
Offaly,2016,85 years and over,117,70,187
Offaly,2016,Under 1 year,2,3,5
Offaly,2017,1 - 4 years,1,0,1
Offaly,2017,10 - 14 years,0,3,3
Offaly,2017,15 - 19 years,1,2,3
Offaly,2017,20 - 24 years,2,3,5
Offaly,2017,25 - 29 years,1,1,2
Offaly,2017,30 - 34 years,1,3,4
Offaly,2017,35 - 39 years,2,1,3
Offaly,2017,40 - 44 years,3,4,7
Offaly,2017,45 - 49 years,3,3,6
Offaly,2017,5 - 9 years,1,1,2
Offaly,2017,50 - 54 years,6,8,14
Offaly,2017,55 - 59 years,7,11,18
Offaly,2017,60 - 64 years,10,12,22
Offaly,2017,65 - 69 years,16,19,35
Offaly,2017,70 - 74 years,21,27,48
Offaly,2017,75 - 79 years,28,28,56
Offaly,2017,80 - 84 years,48,48,96
Offaly,2017,85 years and over,90,65,155
Offaly,2017,Under 1 year,3,3,6
Offaly,2018,1 - 4 years,0,0,0
Offaly,2018,10 - 14 years,0,0,0
Offaly,2018,15 - 19 years,0,0,0
Offaly,2018,20 - 24 years,1,0,1
Offaly,2018,25 - 29 years,0,2,2
Offaly,2018,30 - 34 years,1,2,3
Offaly,2018,35 - 39 years,1,2,3
Offaly,2018,40 - 44 years,0,5,5
Offaly,2018,45 - 49 years,8,2,10
Offaly,2018,5 - 9 years,0,0,0
Offaly,2018,50 - 54 years,6,11,17
Offaly,2018,55 - 59 years,5,13,18
Offaly,2018,60 - 64 years,8,12,20
Offaly,2018,65 - 69 years,20,27,47
Offaly,2018,70 - 74 years,19,30,49
Offaly,2018,75 - 79 years,24,33,57
Offaly,2018,80 - 84 years,32,39,71
Offaly,2018,85 years and over,101,75,176
Offaly,2018,Under 1 year,2,2,4
Offaly,2019,1 - 4 years,0,1,1
Offaly,2019,10 - 14 years,0,0,0
Offaly,2019,15 - 19 years,0,0,0
Offaly,2019,20 - 24 years,0,1,1
Offaly,2019,25 - 29 years,1,2,3
Offaly,2019,30 - 34 years,1,3,4
Offaly,2019,35 - 39 years,4,4,8
Offaly,2019,40 - 44 years,1,3,4
Offaly,2019,45 - 49 years,4,1,5
Offaly,2019,5 - 9 years,0,0,0
Offaly,2019,50 - 54 years,4,12,16
Offaly,2019,55 - 59 years,4,18,22
Offaly,2019,60 - 64 years,10,13,23
Offaly,2019,65 - 69 years,17,22,39
Offaly,2019,70 - 74 years,15,25,40
Offaly,2019,75 - 79 years,24,38,62
Offaly,2019,80 - 84 years,39,32,71
Offaly,2019,85 years and over,97,59,156
Offaly,2019,Under 1 year,1,3,4
Offaly,2020,1 - 4 years,0,1,1
Offaly,2020,10 - 14 years,0,1,1
Offaly,2020,15 - 19 years,0,0,0
Offaly,2020,20 - 24 years,0,1,1
Offaly,2020,25 - 29 years,3,3,6
Offaly,2020,30 - 34 years,1,3,4
Offaly,2020,35 - 39 years,4,4,8
Offaly,2020,40 - 44 years,2,8,10
Offaly,2020,45 - 49 years,3,2,5
Offaly,2020,5 - 9 years,0,0,0
Offaly,2020,50 - 54 years,7,5,12
Offaly,2020,55 - 59 years,13,13,26
Offaly,2020,60 - 64 years,9,15,24
Offaly,2020,65 - 69 years,12,25,37
Offaly,2020,70 - 74 years,20,31,51
Offaly,2020,75 - 79 years,27,51,78
Offaly,2020,80 - 84 years,35,41,76
Offaly,2020,85 years and over,97,88,185
Offaly,2020,Under 1 year,1,3,4
ROI Total,2007,1 - 4 years,23,31,54
ROI Total,2007,10 - 14 years,18,32,50
ROI Total,2007,15 - 19 years,40,109,149
ROI Total,2007,20 - 24 years,39,163,202
ROI Total,2007,25 - 29 years,64,184,248
ROI Total,2007,30 - 34 years,80,168,248
ROI Total,2007,35 - 39 years,104,191,295
ROI Total,2007,40 - 44 years,144,258,402
ROI Total,2007,45 - 49 years,227,379,606
ROI Total,2007,5 - 9 years,9,8,17
ROI Total,2007,50 - 54 years,316,492,808
ROI Total,2007,55 - 59 years,459,802,1261
ROI Total,2007,60 - 64 years,639,1044,1683
ROI Total,2007,65 - 69 years,741,1292,2033
ROI Total,2007,70 - 74 years,1232,1709,2941
ROI Total,2007,75 - 79 years,1821,2196,4017
ROI Total,2007,80 - 84 years,2587,2387,4974
ROI Total,2007,85 years and over,5078,2821,7899
ROI Total,2007,Under 1 year,105,125,230
ROI Total,2008,1 - 4 years,22,30,52
ROI Total,2008,10 - 14 years,13,27,40
ROI Total,2008,15 - 19 years,38,93,131
ROI Total,2008,20 - 24 years,40,146,186
ROI Total,2008,25 - 29 years,67,165,232
ROI Total,2008,30 - 34 years,66,181,247
ROI Total,2008,35 - 39 years,118,217,335
ROI Total,2008,40 - 44 years,165,267,432
ROI Total,2008,45 - 49 years,288,350,638
ROI Total,2008,5 - 9 years,9,19,28
ROI Total,2008,50 - 54 years,351,494,845
ROI Total,2008,55 - 59 years,468,769,1237
ROI Total,2008,60 - 64 years,635,1081,1716
ROI Total,2008,65 - 69 years,762,1375,2137
ROI Total,2008,70 - 74 years,1085,1736,2821
ROI Total,2008,75 - 79 years,1709,2144,3853
ROI Total,2008,80 - 84 years,2520,2368,4888
ROI Total,2008,85 years and over,5339,2833,8172
ROI Total,2008,Under 1 year,122,162,284
ROI Total,2009,1 - 4 years,26,33,59
ROI Total,2009,10 - 14 years,14,17,31
ROI Total,2009,15 - 19 years,25,89,114
ROI Total,2009,20 - 24 years,38,140,178
ROI Total,2009,25 - 29 years,69,187,256
ROI Total,2009,30 - 34 years,89,194,283
ROI Total,2009,35 - 39 years,116,249,365
ROI Total,2009,40 - 44 years,141,277,418
ROI Total,2009,45 - 49 years,263,383,646
ROI Total,2009,5 - 9 years,13,10,23
ROI Total,2009,50 - 54 years,342,539,881
ROI Total,2009,55 - 59 years,486,749,1235
ROI Total,2009,60 - 64 years,665,1078,1743
ROI Total,2009,65 - 69 years,748,1333,2081
ROI Total,2009,70 - 74 years,1123,1686,2809
ROI Total,2009,75 - 79 years,1696,2150,3846
ROI Total,2009,80 - 84 years,2435,2445,4880
ROI Total,2009,85 years and over,5261,3024,8285
ROI Total,2009,Under 1 year,103,144,247
ROI Total,2010,1 - 4 years,16,29,45
ROI Total,2010,10 - 14 years,7,15,22
ROI Total,2010,15 - 19 years,30,71,101
ROI Total,2010,20 - 24 years,26,148,174
ROI Total,2010,25 - 29 years,43,153,196
ROI Total,2010,30 - 34 years,71,170,241
ROI Total,2010,35 - 39 years,98,219,317
ROI Total,2010,40 - 44 years,169,270,439
ROI Total,2010,45 - 49 years,226,371,597
ROI Total,2010,5 - 9 years,12,18,30
ROI Total,2010,50 - 54 years,347,501,848
ROI Total,2010,55 - 59 years,449,711,1160
ROI Total,2010,60 - 64 years,634,1041,1675
ROI Total,2010,65 - 69 years,867,1348,2215
ROI Total,2010,70 - 74 years,1076,1604,2680
ROI Total,2010,75 - 79 years,1611,2071,3682
ROI Total,2010,80 - 84 years,2292,2378,4670
ROI Total,2010,85 years and over,5536,3062,8598
ROI Total,2010,Under 1 year,117,154,271
ROI Total,2011,1 - 4 years,13,18,31
ROI Total,2011,10 - 14 years,10,12,22
ROI Total,2011,15 - 19 years,35,72,107
ROI Total,2011,20 - 24 years,39,134,173
ROI Total,2011,25 - 29 years,60,153,213
ROI Total,2011,30 - 34 years,81,185,266
ROI Total,2011,35 - 39 years,106,206,312
ROI Total,2011,40 - 44 years,169,277,446
ROI Total,2011,45 - 49 years,247,364,611
ROI Total,2011,5 - 9 years,9,16,25
ROI Total,2011,50 - 54 years,312,508,820
ROI Total,2011,55 - 59 years,462,720,1182
ROI Total,2011,60 - 64 years,686,1079,1765
ROI Total,2011,65 - 69 years,858,1324,2182
ROI Total,2011,70 - 74 years,1062,1650,2712
ROI Total,2011,75 - 79 years,1629,2148,3777
ROI Total,2011,80 - 84 years,2309,2293,4602
ROI Total,2011,85 years and over,5765,3183,8948
ROI Total,2011,Under 1 year,112,150,262
ROI Total,2012,1 - 4 years,18,24,42
ROI Total,2012,10 - 14 years,13,19,32
ROI Total,2012,15 - 19 years,24,57,81
ROI Total,2012,20 - 24 years,34,121,155
ROI Total,2012,25 - 29 years,49,132,181
ROI Total,2012,30 - 34 years,79,176,255
ROI Total,2012,35 - 39 years,108,209,317
ROI Total,2012,40 - 44 years,162,255,417
ROI Total,2012,45 - 49 years,224,369,593
ROI Total,2012,5 - 9 years,11,16,27
ROI Total,2012,50 - 54 years,340,542,882
ROI Total,2012,55 - 59 years,490,680,1170
ROI Total,2012,60 - 64 years,653,1087,1740
ROI Total,2012,65 - 69 years,865,1386,2251
ROI Total,2012,70 - 74 years,1062,1648,2710
ROI Total,2012,75 - 79 years,1603,2134,3737
ROI Total,2012,80 - 84 years,2370,2473,4843
ROI Total,2012,85 years and over,6014,3502,9516
ROI Total,2012,Under 1 year,122,115,237
ROI Total,2013,1 - 4 years,20,26,46
ROI Total,2013,10 - 14 years,7,18,25
ROI Total,2013,15 - 19 years,22,39,61
ROI Total,2013,20 - 24 years,38,100,138
ROI Total,2013,25 - 29 years,43,116,159
ROI Total,2013,30 - 34 years,79,171,250
ROI Total,2013,35 - 39 years,83,175,258
ROI Total,2013,40 - 44 years,129,257,386
ROI Total,2013,45 - 49 years,215,364,579
ROI Total,2013,5 - 9 years,18,16,34
ROI Total,2013,50 - 54 years,361,513,874
ROI Total,2013,55 - 59 years,461,726,1187
ROI Total,2013,60 - 64 years,655,1016,1671
ROI Total,2013,65 - 69 years,894,1428,2322
ROI Total,2013,70 - 74 years,1106,1709,2815
ROI Total,2013,75 - 79 years,1638,2077,3715
ROI Total,2013,80 - 84 years,2377,2470,4847
ROI Total,2013,85 years and over,6295,3597,9892
ROI Total,2013,Under 1 year,105,140,245
ROI Total,2014,1 - 4 years,17,23,40
ROI Total,2014,10 - 14 years,8,19,27
ROI Total,2014,15 - 19 years,16,43,59
ROI Total,2014,20 - 24 years,27,121,148
ROI Total,2014,25 - 29 years,43,125,168
ROI Total,2014,30 - 34 years,74,155,229
ROI Total,2014,35 - 39 years,93,169,262
ROI Total,2014,40 - 44 years,135,248,383
ROI Total,2014,45 - 49 years,201,328,529
ROI Total,2014,5 - 9 years,16,15,31
ROI Total,2014,50 - 54 years,326,497,823
ROI Total,2014,55 - 59 years,478,717,1195
ROI Total,2014,60 - 64 years,641,994,1635
ROI Total,2014,65 - 69 years,954,1409,2363
ROI Total,2014,70 - 74 years,1163,1722,2885
ROI Total,2014,75 - 79 years,1597,2134,3731
ROI Total,2014,80 - 84 years,2348,2446,4794
ROI Total,2014,85 years and over,6124,3602,9726
ROI Total,2014,Under 1 year,94,130,224
ROI Total,2015,1 - 4 years,13,19,32
ROI Total,2015,10 - 14 years,6,12,18
ROI Total,2015,15 - 19 years,14,52,66
ROI Total,2015,20 - 24 years,31,77,108
ROI Total,2015,25 - 29 years,45,109,154
ROI Total,2015,30 - 34 years,78,128,206
ROI Total,2015,35 - 39 years,98,172,270
ROI Total,2015,40 - 44 years,132,233,365
ROI Total,2015,45 - 49 years,204,327,531
ROI Total,2015,5 - 9 years,6,14,20
ROI Total,2015,50 - 54 years,331,516,847
ROI Total,2015,55 - 59 years,526,679,1205
ROI Total,2015,60 - 64 years,623,959,1582
ROI Total,2015,65 - 69 years,903,1405,2308
ROI Total,2015,70 - 74 years,1200,1791,2991
ROI Total,2015,75 - 79 years,1637,2226,3863
ROI Total,2015,80 - 84 years,2348,2529,4877
ROI Total,2015,85 years and over,6604,3855,10459
ROI Total,2015,Under 1 year,100,125,225
ROI Total,2016,1 - 4 years,13,18,31
ROI Total,2016,10 - 14 years,12,18,30
ROI Total,2016,15 - 19 years,31,55,86
ROI Total,2016,20 - 24 years,17,83,100
ROI Total,2016,25 - 29 years,29,93,122
ROI Total,2016,30 - 34 years,66,118,184
ROI Total,2016,35 - 39 years,90,177,267
ROI Total,2016,40 - 44 years,134,242,376
ROI Total,2016,45 - 49 years,207,342,549
ROI Total,2016,5 - 9 years,9,4,13
ROI Total,2016,50 - 54 years,326,462,788
ROI Total,2016,55 - 59 years,496,686,1182
ROI Total,2016,60 - 64 years,625,1026,1651
ROI Total,2016,65 - 69 years,968,1372,2340
ROI Total,2016,70 - 74 years,1286,1853,3139
ROI Total,2016,75 - 79 years,1697,2273,3970
ROI Total,2016,80 - 84 years,2364,2697,5061
ROI Total,2016,85 years and over,6592,3992,10584
ROI Total,2016,Under 1 year,85,109,194
ROI Total,2017,1 - 4 years,13,18,31
ROI Total,2017,10 - 14 years,8,10,18
ROI Total,2017,15 - 19 years,20,38,58
ROI Total,2017,20 - 24 years,24,66,90
ROI Total,2017,25 - 29 years,36,91,127
ROI Total,2017,30 - 34 years,63,128,191
ROI Total,2017,35 - 39 years,89,159,248
ROI Total,2017,40 - 44 years,147,243,390
ROI Total,2017,45 - 49 years,201,317,518
ROI Total,2017,5 - 9 years,15,12,27
ROI Total,2017,50 - 54 years,306,503,809
ROI Total,2017,55 - 59 years,425,700,1125
ROI Total,2017,60 - 64 years,665,931,1596
ROI Total,2017,65 - 69 years,876,1372,2248
ROI Total,2017,70 - 74 years,1267,1848,3115
ROI Total,2017,75 - 79 years,1661,2295,3956
ROI Total,2017,80 - 84 years,2374,2639,5013
ROI Total,2017,85 years and over,6641,4029,10670
ROI Total,2017,Under 1 year,98,90,188
ROI Total,2018,1 - 4 years,16,8,24
ROI Total,2018,10 - 14 years,14,21,35
ROI Total,2018,15 - 19 years,20,42,62
ROI Total,2018,20 - 24 years,30,67,97
ROI Total,2018,25 - 29 years,46,80,126
ROI Total,2018,30 - 34 years,77,119,196
ROI Total,2018,35 - 39 years,104,152,256
ROI Total,2018,40 - 44 years,148,246,394
ROI Total,2018,45 - 49 years,232,353,585
ROI Total,2018,5 - 9 years,4,9,13
ROI Total,2018,50 - 54 years,326,472,798
ROI Total,2018,55 - 59 years,467,733,1200
ROI Total,2018,60 - 64 years,620,1013,1633
ROI Total,2018,65 - 69 years,974,1458,2432
ROI Total,2018,70 - 74 years,1317,1938,3255
ROI Total,2018,75 - 79 years,1686,2313,3999
ROI Total,2018,80 - 84 years,2406,2618,5024
ROI Total,2018,85 years and over,6533,4304,10837
ROI Total,2018,Under 1 year,75,99,174
ROI Total,2019,1 - 4 years,13,16,29
ROI Total,2019,10 - 14 years,4,17,21
ROI Total,2019,15 - 19 years,21,44,65
ROI Total,2019,20 - 24 years,18,70,88
ROI Total,2019,25 - 29 years,43,88,131
ROI Total,2019,30 - 34 years,62,112,174
ROI Total,2019,35 - 39 years,108,158,266
ROI Total,2019,40 - 44 years,157,250,407
ROI Total,2019,45 - 49 years,202,358,560
ROI Total,2019,5 - 9 years,7,17,24
ROI Total,2019,50 - 54 years,336,478,814
ROI Total,2019,55 - 59 years,452,782,1234
ROI Total,2019,60 - 64 years,643,1050,1693
ROI Total,2019,65 - 69 years,911,1378,2289
ROI Total,2019,70 - 74 years,1328,1998,3326
ROI Total,2019,75 - 79 years,1640,2272,3912
ROI Total,2019,80 - 84 years,2351,2614,4965
ROI Total,2019,85 years and over,6484,4462,10946
ROI Total,2019,Under 1 year,86,104,190
ROI Total,2020,1 - 4 years,9,18,27
ROI Total,2020,10 - 14 years,6,17,23
ROI Total,2020,15 - 19 years,20,38,58
ROI Total,2020,20 - 24 years,22,56,78
ROI Total,2020,25 - 29 years,24,74,98
ROI Total,2020,30 - 34 years,52,106,158
ROI Total,2020,35 - 39 years,111,161,272
ROI Total,2020,40 - 44 years,142,228,370
ROI Total,2020,45 - 49 years,209,289,498
ROI Total,2020,5 - 9 years,7,17,24
ROI Total,2020,50 - 54 years,305,496,801
ROI Total,2020,55 - 59 years,451,675,1126
ROI Total,2020,60 - 64 years,663,976,1639
ROI Total,2020,65 - 69 years,918,1402,2320
ROI Total,2020,70 - 74 years,1409,2093,3502
ROI Total,2020,75 - 79 years,1723,2322,4045
ROI Total,2020,80 - 84 years,2465,2836,5301
ROI Total,2020,85 years and over,6704,4568,11272
ROI Total,2020,Under 1 year,75,78,153
Rest of Co. Carlow,2007,1 - 4 years,0,1,1
Rest of Co. Carlow,2007,10 - 14 years,0,0,0
Rest of Co. Carlow,2007,15 - 19 years,0,1,1
Rest of Co. Carlow,2007,20 - 24 years,0,4,4
Rest of Co. Carlow,2007,25 - 29 years,0,3,3
Rest of Co. Carlow,2007,30 - 34 years,0,1,1
Rest of Co. Carlow,2007,35 - 39 years,0,3,3
Rest of Co. Carlow,2007,40 - 44 years,0,4,4
Rest of Co. Carlow,2007,45 - 49 years,2,1,3
Rest of Co. Carlow,2007,5 - 9 years,0,0,0
Rest of Co. Carlow,2007,50 - 54 years,3,7,10
Rest of Co. Carlow,2007,55 - 59 years,6,8,14
Rest of Co. Carlow,2007,60 - 64 years,7,5,12
Rest of Co. Carlow,2007,65 - 69 years,5,11,16
Rest of Co. Carlow,2007,70 - 74 years,10,15,25
Rest of Co. Carlow,2007,75 - 79 years,20,23,43
Rest of Co. Carlow,2007,80 - 84 years,25,14,39
Rest of Co. Carlow,2007,85 years and over,41,25,66
Rest of Co. Carlow,2007,Under 1 year,1,1,2
Rest of Co. Carlow,2008,1 - 4 years,1,1,2
Rest of Co. Carlow,2008,10 - 14 years,0,0,0
Rest of Co. Carlow,2008,15 - 19 years,0,2,2
Rest of Co. Carlow,2008,20 - 24 years,0,2,2
Rest of Co. Carlow,2008,25 - 29 years,1,1,2
Rest of Co. Carlow,2008,30 - 34 years,0,1,1
Rest of Co. Carlow,2008,35 - 39 years,1,3,4
Rest of Co. Carlow,2008,40 - 44 years,2,3,5
Rest of Co. Carlow,2008,45 - 49 years,5,4,9
Rest of Co. Carlow,2008,5 - 9 years,0,0,0
Rest of Co. Carlow,2008,50 - 54 years,4,2,6
Rest of Co. Carlow,2008,55 - 59 years,4,4,8
Rest of Co. Carlow,2008,60 - 64 years,7,5,12
Rest of Co. Carlow,2008,65 - 69 years,6,14,20
Rest of Co. Carlow,2008,70 - 74 years,13,8,21
Rest of Co. Carlow,2008,75 - 79 years,11,19,30
Rest of Co. Carlow,2008,80 - 84 years,27,24,51
Rest of Co. Carlow,2008,85 years and over,40,18,58
Rest of Co. Carlow,2008,Under 1 year,1,2,3
Rest of Co. Carlow,2009,1 - 4 years,1,1,2
Rest of Co. Carlow,2009,10 - 14 years,0,0,0
Rest of Co. Carlow,2009,15 - 19 years,0,1,1
Rest of Co. Carlow,2009,20 - 24 years,2,1,3
Rest of Co. Carlow,2009,25 - 29 years,1,1,2
Rest of Co. Carlow,2009,30 - 34 years,0,1,1
Rest of Co. Carlow,2009,35 - 39 years,1,3,4
Rest of Co. Carlow,2009,40 - 44 years,1,2,3
Rest of Co. Carlow,2009,45 - 49 years,3,3,6
Rest of Co. Carlow,2009,5 - 9 years,0,0,0
Rest of Co. Carlow,2009,50 - 54 years,3,2,5
Rest of Co. Carlow,2009,55 - 59 years,2,7,9
Rest of Co. Carlow,2009,60 - 64 years,5,13,18
Rest of Co. Carlow,2009,65 - 69 years,8,15,23
Rest of Co. Carlow,2009,70 - 74 years,7,14,21
Rest of Co. Carlow,2009,75 - 79 years,8,27,35
Rest of Co. Carlow,2009,80 - 84 years,28,20,48
Rest of Co. Carlow,2009,85 years and over,39,37,76
Rest of Co. Carlow,2009,Under 1 year,2,1,3
Rest of Co. Carlow,2010,1 - 4 years,1,1,2
Rest of Co. Carlow,2010,10 - 14 years,0,1,1
Rest of Co. Carlow,2010,15 - 19 years,0,1,1
Rest of Co. Carlow,2010,20 - 24 years,2,1,3
Rest of Co. Carlow,2010,25 - 29 years,1,2,3
Rest of Co. Carlow,2010,30 - 34 years,0,1,1
Rest of Co. Carlow,2010,35 - 39 years,1,2,3
Rest of Co. Carlow,2010,40 - 44 years,1,4,5
Rest of Co. Carlow,2010,45 - 49 years,3,2,5
Rest of Co. Carlow,2010,5 - 9 years,1,0,1
Rest of Co. Carlow,2010,50 - 54 years,2,5,7
Rest of Co. Carlow,2010,55 - 59 years,4,6,10
Rest of Co. Carlow,2010,60 - 64 years,3,9,12
Rest of Co. Carlow,2010,65 - 69 years,9,9,18
Rest of Co. Carlow,2010,70 - 74 years,12,25,37
Rest of Co. Carlow,2010,75 - 79 years,14,13,27
Rest of Co. Carlow,2010,80 - 84 years,12,25,37
Rest of Co. Carlow,2010,85 years and over,40,26,66
Rest of Co. Carlow,2010,Under 1 year,2,2,4
Rest of Co. Carlow,2011,1 - 4 years,0,0,0
Rest of Co. Carlow,2011,10 - 14 years,0,0,0
Rest of Co. Carlow,2011,15 - 19 years,1,0,1
Rest of Co. Carlow,2011,20 - 24 years,0,2,2
Rest of Co. Carlow,2011,25 - 29 years,1,0,1
Rest of Co. Carlow,2011,30 - 34 years,2,2,4
Rest of Co. Carlow,2011,35 - 39 years,2,4,6
Rest of Co. Carlow,2011,40 - 44 years,2,0,2
Rest of Co. Carlow,2011,45 - 49 years,2,1,3
Rest of Co. Carlow,2011,5 - 9 years,0,0,0
Rest of Co. Carlow,2011,50 - 54 years,2,4,6
Rest of Co. Carlow,2011,55 - 59 years,5,4,9
Rest of Co. Carlow,2011,60 - 64 years,6,4,10
Rest of Co. Carlow,2011,65 - 69 years,9,7,16
Rest of Co. Carlow,2011,70 - 74 years,9,20,29
Rest of Co. Carlow,2011,75 - 79 years,14,28,42
Rest of Co. Carlow,2011,80 - 84 years,22,21,43
Rest of Co. Carlow,2011,85 years and over,46,25,71
Rest of Co. Carlow,2011,Under 1 year,1,1,2
Rest of Co. Carlow,2012,1 - 4 years,0,0,0
Rest of Co. Carlow,2012,10 - 14 years,0,1,1
Rest of Co. Carlow,2012,15 - 19 years,1,0,1
Rest of Co. Carlow,2012,20 - 24 years,0,2,2
Rest of Co. Carlow,2012,25 - 29 years,1,1,2
Rest of Co. Carlow,2012,30 - 34 years,1,2,3
Rest of Co. Carlow,2012,35 - 39 years,2,1,3
Rest of Co. Carlow,2012,40 - 44 years,3,1,4
Rest of Co. Carlow,2012,45 - 49 years,2,4,6
Rest of Co. Carlow,2012,5 - 9 years,0,1,1
Rest of Co. Carlow,2012,50 - 54 years,3,4,7
Rest of Co. Carlow,2012,55 - 59 years,2,7,9
Rest of Co. Carlow,2012,60 - 64 years,4,11,15
Rest of Co. Carlow,2012,65 - 69 years,6,8,14
Rest of Co. Carlow,2012,70 - 74 years,2,16,18
Rest of Co. Carlow,2012,75 - 79 years,10,19,29
Rest of Co. Carlow,2012,80 - 84 years,12,30,42
Rest of Co. Carlow,2012,85 years and over,48,26,74
Rest of Co. Carlow,2012,Under 1 year,1,1,2
Rest of Co. Carlow,2013,1 - 4 years,0,1,1
Rest of Co. Carlow,2013,10 - 14 years,0,0,0
Rest of Co. Carlow,2013,15 - 19 years,0,0,0
Rest of Co. Carlow,2013,20 - 24 years,1,0,1
Rest of Co. Carlow,2013,25 - 29 years,0,2,2
Rest of Co. Carlow,2013,30 - 34 years,0,1,1
Rest of Co. Carlow,2013,35 - 39 years,1,1,2
Rest of Co. Carlow,2013,40 - 44 years,0,3,3
Rest of Co. Carlow,2013,45 - 49 years,0,1,1
Rest of Co. Carlow,2013,5 - 9 years,1,1,2
Rest of Co. Carlow,2013,50 - 54 years,4,6,10
Rest of Co. Carlow,2013,55 - 59 years,4,5,9
Rest of Co. Carlow,2013,60 - 64 years,7,15,22
Rest of Co. Carlow,2013,65 - 69 years,5,14,19
Rest of Co. Carlow,2013,70 - 74 years,6,17,23
Rest of Co. Carlow,2013,75 - 79 years,19,15,34
Rest of Co. Carlow,2013,80 - 84 years,15,19,34
Rest of Co. Carlow,2013,85 years and over,49,31,80
Rest of Co. Carlow,2013,Under 1 year,0,0,0
Rest of Co. Carlow,2014,1 - 4 years,0,1,1
Rest of Co. Carlow,2014,10 - 14 years,0,0,0
Rest of Co. Carlow,2014,15 - 19 years,0,1,1
Rest of Co. Carlow,2014,20 - 24 years,1,2,3
Rest of Co. Carlow,2014,25 - 29 years,0,2,2
Rest of Co. Carlow,2014,30 - 34 years,1,1,2
Rest of Co. Carlow,2014,35 - 39 years,1,1,2
Rest of Co. Carlow,2014,40 - 44 years,1,1,2
Rest of Co. Carlow,2014,45 - 49 years,0,7,7
Rest of Co. Carlow,2014,5 - 9 years,1,1,2
Rest of Co. Carlow,2014,50 - 54 years,4,3,7
Rest of Co. Carlow,2014,55 - 59 years,3,1,4
Rest of Co. Carlow,2014,60 - 64 years,3,7,10
Rest of Co. Carlow,2014,65 - 69 years,8,11,19
Rest of Co. Carlow,2014,70 - 74 years,12,16,28
Rest of Co. Carlow,2014,75 - 79 years,13,10,23
Rest of Co. Carlow,2014,80 - 84 years,16,19,35
Rest of Co. Carlow,2014,85 years and over,43,32,75
Rest of Co. Carlow,2014,Under 1 year,1,2,3
Rest of Co. Carlow,2015,1 - 4 years,0,1,1
Rest of Co. Carlow,2015,10 - 14 years,0,0,0
Rest of Co. Carlow,2015,15 - 19 years,0,1,1
Rest of Co. Carlow,2015,20 - 24 years,1,2,3
Rest of Co. Carlow,2015,25 - 29 years,0,2,2
Rest of Co. Carlow,2015,30 - 34 years,1,1,2
Rest of Co. Carlow,2015,35 - 39 years,1,1,2
Rest of Co. Carlow,2015,40 - 44 years,1,1,2
Rest of Co. Carlow,2015,45 - 49 years,0,7,7
Rest of Co. Carlow,2015,5 - 9 years,1,1,2
Rest of Co. Carlow,2015,50 - 54 years,4,3,7
Rest of Co. Carlow,2015,55 - 59 years,3,1,4
Rest of Co. Carlow,2015,60 - 64 years,3,7,10
Rest of Co. Carlow,2015,65 - 69 years,8,11,19
Rest of Co. Carlow,2015,70 - 74 years,12,16,28
Rest of Co. Carlow,2015,75 - 79 years,13,10,23
Rest of Co. Carlow,2015,80 - 84 years,16,19,35
Rest of Co. Carlow,2015,85 years and over,43,32,75
Rest of Co. Carlow,2015,Under 1 year,1,2,3
Rest of Co. Carlow,2016,1 - 4 years,0,1,1
Rest of Co. Carlow,2016,10 - 14 years,0,0,0
Rest of Co. Carlow,2016,15 - 19 years,0,1,1
Rest of Co. Carlow,2016,20 - 24 years,1,2,3
Rest of Co. Carlow,2016,25 - 29 years,0,2,2
Rest of Co. Carlow,2016,30 - 34 years,1,1,2
Rest of Co. Carlow,2016,35 - 39 years,1,1,2
Rest of Co. Carlow,2016,40 - 44 years,1,1,2
Rest of Co. Carlow,2016,45 - 49 years,0,7,7
Rest of Co. Carlow,2016,5 - 9 years,1,1,2
Rest of Co. Carlow,2016,50 - 54 years,4,3,7
Rest of Co. Carlow,2016,55 - 59 years,3,1,4
Rest of Co. Carlow,2016,60 - 64 years,3,7,10
Rest of Co. Carlow,2016,65 - 69 years,8,11,19
Rest of Co. Carlow,2016,70 - 74 years,12,16,28
Rest of Co. Carlow,2016,75 - 79 years,13,10,23
Rest of Co. Carlow,2016,80 - 84 years,16,19,35
Rest of Co. Carlow,2016,85 years and over,43,32,75
Rest of Co. Carlow,2016,Under 1 year,1,2,3
Rest of Co. Carlow,2017,1 - 4 years,0,1,1
Rest of Co. Carlow,2017,10 - 14 years,0,0,0
Rest of Co. Carlow,2017,15 - 19 years,0,1,1
Rest of Co. Carlow,2017,20 - 24 years,1,2,3
Rest of Co. Carlow,2017,25 - 29 years,1,2,3
Rest of Co. Carlow,2017,30 - 34 years,1,1,2
Rest of Co. Carlow,2017,35 - 39 years,1,1,2
Rest of Co. Carlow,2017,40 - 44 years,1,1,2
Rest of Co. Carlow,2017,45 - 49 years,1,1,2
Rest of Co. Carlow,2017,5 - 9 years,1,1,2
Rest of Co. Carlow,2017,50 - 54 years,4,4,8
Rest of Co. Carlow,2017,55 - 59 years,1,6,7
Rest of Co. Carlow,2017,60 - 64 years,5,4,9
Rest of Co. Carlow,2017,65 - 69 years,8,15,23
Rest of Co. Carlow,2017,70 - 74 years,9,13,22
Rest of Co. Carlow,2017,75 - 79 years,13,20,33
Rest of Co. Carlow,2017,80 - 84 years,15,19,34
Rest of Co. Carlow,2017,85 years and over,54,31,85
Rest of Co. Carlow,2017,Under 1 year,1,2,3
Rest of Co. Carlow,2018,1 - 4 years,0,0,0
Rest of Co. Carlow,2018,10 - 14 years,0,1,1
Rest of Co. Carlow,2018,15 - 19 years,0,0,0
Rest of Co. Carlow,2018,20 - 24 years,0,0,0
Rest of Co. Carlow,2018,25 - 29 years,0,0,0
Rest of Co. Carlow,2018,30 - 34 years,1,1,2
Rest of Co. Carlow,2018,35 - 39 years,3,0,3
Rest of Co. Carlow,2018,40 - 44 years,1,1,2
Rest of Co. Carlow,2018,45 - 49 years,2,3,5
Rest of Co. Carlow,2018,5 - 9 years,0,0,0
Rest of Co. Carlow,2018,50 - 54 years,2,2,4
Rest of Co. Carlow,2018,55 - 59 years,3,7,10
Rest of Co. Carlow,2018,60 - 64 years,6,8,14
Rest of Co. Carlow,2018,65 - 69 years,10,10,20
Rest of Co. Carlow,2018,70 - 74 years,9,7,16
Rest of Co. Carlow,2018,75 - 79 years,10,16,26
Rest of Co. Carlow,2018,80 - 84 years,17,17,34
Rest of Co. Carlow,2018,85 years and over,38,27,65
Rest of Co. Carlow,2018,Under 1 year,0,0,0
Rest of Co. Carlow,2019,1 - 4 years,0,0,0
Rest of Co. Carlow,2019,10 - 14 years,0,1,1
Rest of Co. Carlow,2019,15 - 19 years,0,0,0
Rest of Co. Carlow,2019,20 - 24 years,0,0,0
Rest of Co. Carlow,2019,25 - 29 years,0,0,0
Rest of Co. Carlow,2019,30 - 34 years,1,1,2
Rest of Co. Carlow,2019,35 - 39 years,3,0,3
Rest of Co. Carlow,2019,40 - 44 years,1,1,2
Rest of Co. Carlow,2019,45 - 49 years,2,3,5
Rest of Co. Carlow,2019,5 - 9 years,0,0,0
Rest of Co. Carlow,2019,50 - 54 years,2,2,4
Rest of Co. Carlow,2019,55 - 59 years,3,7,10
Rest of Co. Carlow,2019,60 - 64 years,6,8,14
Rest of Co. Carlow,2019,65 - 69 years,10,10,20
Rest of Co. Carlow,2019,70 - 74 years,9,7,16
Rest of Co. Carlow,2019,75 - 79 years,10,16,26
Rest of Co. Carlow,2019,80 - 84 years,17,17,34
Rest of Co. Carlow,2019,85 years and over,38,27,65
Rest of Co. Carlow,2019,Under 1 year,0,0,0
Rest of Co. Carlow,2020,1 - 4 years,0,0,0
Rest of Co. Carlow,2020,10 - 14 years,0,1,1
Rest of Co. Carlow,2020,15 - 19 years,0,0,0
Rest of Co. Carlow,2020,20 - 24 years,0,0,0
Rest of Co. Carlow,2020,25 - 29 years,0,0,0
Rest of Co. Carlow,2020,30 - 34 years,1,1,2
Rest of Co. Carlow,2020,35 - 39 years,3,0,3
Rest of Co. Carlow,2020,40 - 44 years,1,1,2
Rest of Co. Carlow,2020,45 - 49 years,2,3,5
Rest of Co. Carlow,2020,5 - 9 years,0,0,0
Rest of Co. Carlow,2020,50 - 54 years,2,2,4
Rest of Co. Carlow,2020,55 - 59 years,3,7,10
Rest of Co. Carlow,2020,60 - 64 years,6,8,14
Rest of Co. Carlow,2020,65 - 69 years,10,10,20
Rest of Co. Carlow,2020,70 - 74 years,9,7,16
Rest of Co. Carlow,2020,75 - 79 years,10,16,26
Rest of Co. Carlow,2020,80 - 84 years,17,17,34
Rest of Co. Carlow,2020,85 years and over,38,27,65
Rest of Co. Carlow,2020,Under 1 year,0,0,0
Rest of Co. Cavan,2007,1 - 4 years,2,0,2
Rest of Co. Cavan,2007,10 - 14 years,0,0,0
Rest of Co. Cavan,2007,15 - 19 years,0,2,2
Rest of Co. Cavan,2007,20 - 24 years,0,1,1
Rest of Co. Cavan,2007,25 - 29 years,1,2,3
Rest of Co. Cavan,2007,30 - 34 years,0,5,5
Rest of Co. Cavan,2007,35 - 39 years,1,4,5
Rest of Co. Cavan,2007,40 - 44 years,0,5,5
Rest of Co. Cavan,2007,45 - 49 years,2,6,8
Rest of Co. Cavan,2007,5 - 9 years,1,0,1
Rest of Co. Cavan,2007,50 - 54 years,4,3,7
Rest of Co. Cavan,2007,55 - 59 years,7,14,21
Rest of Co. Cavan,2007,60 - 64 years,15,13,28
Rest of Co. Cavan,2007,65 - 69 years,10,20,30
Rest of Co. Cavan,2007,70 - 74 years,17,28,45
Rest of Co. Cavan,2007,75 - 79 years,34,44,78
Rest of Co. Cavan,2007,80 - 84 years,41,53,94
Rest of Co. Cavan,2007,85 years and over,96,60,156
Rest of Co. Cavan,2007,Under 1 year,1,1,2
Rest of Co. Cavan,2008,1 - 4 years,1,0,1
Rest of Co. Cavan,2008,10 - 14 years,0,0,0
Rest of Co. Cavan,2008,15 - 19 years,1,1,2
Rest of Co. Cavan,2008,20 - 24 years,2,2,4
Rest of Co. Cavan,2008,25 - 29 years,1,1,2
Rest of Co. Cavan,2008,30 - 34 years,1,5,6
Rest of Co. Cavan,2008,35 - 39 years,2,1,3
Rest of Co. Cavan,2008,40 - 44 years,2,3,5
Rest of Co. Cavan,2008,45 - 49 years,8,6,14
Rest of Co. Cavan,2008,5 - 9 years,1,0,1
Rest of Co. Cavan,2008,50 - 54 years,8,5,13
Rest of Co. Cavan,2008,55 - 59 years,10,11,21
Rest of Co. Cavan,2008,60 - 64 years,14,22,36
Rest of Co. Cavan,2008,65 - 69 years,10,18,28
Rest of Co. Cavan,2008,70 - 74 years,13,30,43
Rest of Co. Cavan,2008,75 - 79 years,11,39,50
Rest of Co. Cavan,2008,80 - 84 years,37,39,76
Rest of Co. Cavan,2008,85 years and over,82,57,139
Rest of Co. Cavan,2008,Under 1 year,1,1,2
Rest of Co. Cavan,2009,1 - 4 years,1,1,2
Rest of Co. Cavan,2009,10 - 14 years,0,1,1
Rest of Co. Cavan,2009,15 - 19 years,1,2,3
Rest of Co. Cavan,2009,20 - 24 years,2,4,6
Rest of Co. Cavan,2009,25 - 29 years,2,6,8
Rest of Co. Cavan,2009,30 - 34 years,4,2,6
Rest of Co. Cavan,2009,35 - 39 years,5,2,7
Rest of Co. Cavan,2009,40 - 44 years,1,2,3
Rest of Co. Cavan,2009,45 - 49 years,1,2,3
Rest of Co. Cavan,2009,5 - 9 years,1,1,2
Rest of Co. Cavan,2009,50 - 54 years,2,8,10
Rest of Co. Cavan,2009,55 - 59 years,6,10,16
Rest of Co. Cavan,2009,60 - 64 years,13,13,26
Rest of Co. Cavan,2009,65 - 69 years,6,20,26
Rest of Co. Cavan,2009,70 - 74 years,16,27,43
Rest of Co. Cavan,2009,75 - 79 years,16,36,52
Rest of Co. Cavan,2009,80 - 84 years,49,45,94
Rest of Co. Cavan,2009,85 years and over,77,59,136
Rest of Co. Cavan,2009,Under 1 year,2,1,3
Rest of Co. Cavan,2010,1 - 4 years,1,1,2
Rest of Co. Cavan,2010,10 - 14 years,0,1,1
Rest of Co. Cavan,2010,15 - 19 years,1,1,2
Rest of Co. Cavan,2010,20 - 24 years,2,3,5
Rest of Co. Cavan,2010,25 - 29 years,2,3,5
Rest of Co. Cavan,2010,30 - 34 years,1,2,3
Rest of Co. Cavan,2010,35 - 39 years,1,5,6
Rest of Co. Cavan,2010,40 - 44 years,1,6,7
Rest of Co. Cavan,2010,45 - 49 years,2,4,6
Rest of Co. Cavan,2010,5 - 9 years,1,1,2
Rest of Co. Cavan,2010,50 - 54 years,4,7,11
Rest of Co. Cavan,2010,55 - 59 years,8,10,18
Rest of Co. Cavan,2010,60 - 64 years,8,17,25
Rest of Co. Cavan,2010,65 - 69 years,10,25,35
Rest of Co. Cavan,2010,70 - 74 years,9,24,33
Rest of Co. Cavan,2010,75 - 79 years,20,29,49
Rest of Co. Cavan,2010,80 - 84 years,39,51,90
Rest of Co. Cavan,2010,85 years and over,109,57,166
Rest of Co. Cavan,2010,Under 1 year,2,2,4
Rest of Co. Cavan,2011,1 - 4 years,0,0,0
Rest of Co. Cavan,2011,10 - 14 years,0,0,0
Rest of Co. Cavan,2011,15 - 19 years,1,2,3
Rest of Co. Cavan,2011,20 - 24 years,0,2,2
Rest of Co. Cavan,2011,25 - 29 years,1,6,7
Rest of Co. Cavan,2011,30 - 34 years,0,1,1
Rest of Co. Cavan,2011,35 - 39 years,1,3,4
Rest of Co. Cavan,2011,40 - 44 years,2,5,7
Rest of Co. Cavan,2011,45 - 49 years,1,5,6
Rest of Co. Cavan,2011,5 - 9 years,0,0,0
Rest of Co. Cavan,2011,50 - 54 years,5,5,10
Rest of Co. Cavan,2011,55 - 59 years,4,15,19
Rest of Co. Cavan,2011,60 - 64 years,14,16,30
Rest of Co. Cavan,2011,65 - 69 years,18,21,39
Rest of Co. Cavan,2011,70 - 74 years,13,25,38
Rest of Co. Cavan,2011,75 - 79 years,24,42,66
Rest of Co. Cavan,2011,80 - 84 years,39,46,85
Rest of Co. Cavan,2011,85 years and over,107,85,192
Rest of Co. Cavan,2011,Under 1 year,2,1,3
Rest of Co. Cavan,2012,1 - 4 years,0,1,1
Rest of Co. Cavan,2012,10 - 14 years,0,0,0
Rest of Co. Cavan,2012,15 - 19 years,1,2,3
Rest of Co. Cavan,2012,20 - 24 years,1,4,5
Rest of Co. Cavan,2012,25 - 29 years,1,1,2
Rest of Co. Cavan,2012,30 - 34 years,0,1,1
Rest of Co. Cavan,2012,35 - 39 years,1,3,4
Rest of Co. Cavan,2012,40 - 44 years,2,2,4
Rest of Co. Cavan,2012,45 - 49 years,1,8,9
Rest of Co. Cavan,2012,5 - 9 years,0,0,0
Rest of Co. Cavan,2012,50 - 54 years,4,3,7
Rest of Co. Cavan,2012,55 - 59 years,8,15,23
Rest of Co. Cavan,2012,60 - 64 years,7,15,22
Rest of Co. Cavan,2012,65 - 69 years,12,24,36
Rest of Co. Cavan,2012,70 - 74 years,14,19,33
Rest of Co. Cavan,2012,75 - 79 years,23,42,65
Rest of Co. Cavan,2012,80 - 84 years,39,47,86
Rest of Co. Cavan,2012,85 years and over,105,72,177
Rest of Co. Cavan,2012,Under 1 year,1,1,2
Rest of Co. Cavan,2013,1 - 4 years,0,0,0
Rest of Co. Cavan,2013,10 - 14 years,0,0,0
Rest of Co. Cavan,2013,15 - 19 years,0,2,2
Rest of Co. Cavan,2013,20 - 24 years,0,1,1
Rest of Co. Cavan,2013,25 - 29 years,2,1,3
Rest of Co. Cavan,2013,30 - 34 years,3,2,5
Rest of Co. Cavan,2013,35 - 39 years,1,2,3
Rest of Co. Cavan,2013,40 - 44 years,3,6,9
Rest of Co. Cavan,2013,45 - 49 years,1,1,2
Rest of Co. Cavan,2013,5 - 9 years,0,0,0
Rest of Co. Cavan,2013,50 - 54 years,4,7,11
Rest of Co. Cavan,2013,55 - 59 years,5,14,19
Rest of Co. Cavan,2013,60 - 64 years,2,15,17
Rest of Co. Cavan,2013,65 - 69 years,11,24,35
Rest of Co. Cavan,2013,70 - 74 years,7,20,27
Rest of Co. Cavan,2013,75 - 79 years,18,31,49
Rest of Co. Cavan,2013,80 - 84 years,36,40,76
Rest of Co. Cavan,2013,85 years and over,97,61,158
Rest of Co. Cavan,2013,Under 1 year,0,3,3
Rest of Co. Cavan,2014,1 - 4 years,0,1,1
Rest of Co. Cavan,2014,10 - 14 years,0,0,0
Rest of Co. Cavan,2014,15 - 19 years,0,2,2
Rest of Co. Cavan,2014,20 - 24 years,0,4,4
Rest of Co. Cavan,2014,25 - 29 years,2,3,5
Rest of Co. Cavan,2014,30 - 34 years,3,2,5
Rest of Co. Cavan,2014,35 - 39 years,1,3,4
Rest of Co. Cavan,2014,40 - 44 years,3,2,5
Rest of Co. Cavan,2014,45 - 49 years,1,3,4
Rest of Co. Cavan,2014,5 - 9 years,0,0,0
Rest of Co. Cavan,2014,50 - 54 years,8,10,18
Rest of Co. Cavan,2014,55 - 59 years,4,8,12
Rest of Co. Cavan,2014,60 - 64 years,9,6,15
Rest of Co. Cavan,2014,65 - 69 years,8,18,26
Rest of Co. Cavan,2014,70 - 74 years,19,23,42
Rest of Co. Cavan,2014,75 - 79 years,21,30,51
Rest of Co. Cavan,2014,80 - 84 years,30,36,66
Rest of Co. Cavan,2014,85 years and over,96,62,158
Rest of Co. Cavan,2014,Under 1 year,2,3,5
Rest of Co. Cavan,2015,1 - 4 years,0,1,1
Rest of Co. Cavan,2015,10 - 14 years,0,0,0
Rest of Co. Cavan,2015,15 - 19 years,0,2,2
Rest of Co. Cavan,2015,20 - 24 years,0,4,4
Rest of Co. Cavan,2015,25 - 29 years,2,3,5
Rest of Co. Cavan,2015,30 - 34 years,3,2,5
Rest of Co. Cavan,2015,35 - 39 years,1,3,4
Rest of Co. Cavan,2015,40 - 44 years,3,2,5
Rest of Co. Cavan,2015,45 - 49 years,1,3,4
Rest of Co. Cavan,2015,5 - 9 years,0,0,0
Rest of Co. Cavan,2015,50 - 54 years,8,10,18
Rest of Co. Cavan,2015,55 - 59 years,4,8,12
Rest of Co. Cavan,2015,60 - 64 years,9,6,15
Rest of Co. Cavan,2015,65 - 69 years,8,18,26
Rest of Co. Cavan,2015,70 - 74 years,19,23,42
Rest of Co. Cavan,2015,75 - 79 years,21,30,51
Rest of Co. Cavan,2015,80 - 84 years,30,36,66
Rest of Co. Cavan,2015,85 years and over,96,62,158
Rest of Co. Cavan,2015,Under 1 year,2,3,5
Rest of Co. Cavan,2016,1 - 4 years,0,1,1
Rest of Co. Cavan,2016,10 - 14 years,0,0,0
Rest of Co. Cavan,2016,15 - 19 years,0,2,2
Rest of Co. Cavan,2016,20 - 24 years,0,4,4
Rest of Co. Cavan,2016,25 - 29 years,2,3,5
Rest of Co. Cavan,2016,30 - 34 years,3,2,5
Rest of Co. Cavan,2016,35 - 39 years,1,3,4
Rest of Co. Cavan,2016,40 - 44 years,3,2,5
Rest of Co. Cavan,2016,45 - 49 years,1,3,4
Rest of Co. Cavan,2016,5 - 9 years,0,0,0
Rest of Co. Cavan,2016,50 - 54 years,8,10,18
Rest of Co. Cavan,2016,55 - 59 years,4,8,12
Rest of Co. Cavan,2016,60 - 64 years,9,6,15
Rest of Co. Cavan,2016,65 - 69 years,8,18,26
Rest of Co. Cavan,2016,70 - 74 years,19,23,42
Rest of Co. Cavan,2016,75 - 79 years,21,30,51
Rest of Co. Cavan,2016,80 - 84 years,30,36,66
Rest of Co. Cavan,2016,85 years and over,96,62,158
Rest of Co. Cavan,2016,Under 1 year,2,3,5
Rest of Co. Cavan,2017,1 - 4 years,0,1,1
Rest of Co. Cavan,2017,10 - 14 years,0,0,0
Rest of Co. Cavan,2017,15 - 19 years,0,2,2
Rest of Co. Cavan,2017,20 - 24 years,0,2,2
Rest of Co. Cavan,2017,25 - 29 years,2,1,3
Rest of Co. Cavan,2017,30 - 34 years,3,2,5
Rest of Co. Cavan,2017,35 - 39 years,1,2,3
Rest of Co. Cavan,2017,40 - 44 years,3,2,5
Rest of Co. Cavan,2017,45 - 49 years,4,3,7
Rest of Co. Cavan,2017,5 - 9 years,1,0,1
Rest of Co. Cavan,2017,50 - 54 years,3,10,13
Rest of Co. Cavan,2017,55 - 59 years,1,6,7
Rest of Co. Cavan,2017,60 - 64 years,6,14,20
Rest of Co. Cavan,2017,65 - 69 years,13,14,27
Rest of Co. Cavan,2017,70 - 74 years,13,26,39
Rest of Co. Cavan,2017,75 - 79 years,22,27,49
Rest of Co. Cavan,2017,80 - 84 years,25,34,59
Rest of Co. Cavan,2017,85 years and over,90,69,159
Rest of Co. Cavan,2017,Under 1 year,2,2,4
Rest of Co. Cavan,2018,1 - 4 years,0,0,0
Rest of Co. Cavan,2018,10 - 14 years,0,0,0
Rest of Co. Cavan,2018,15 - 19 years,0,1,1
Rest of Co. Cavan,2018,20 - 24 years,0,3,3
Rest of Co. Cavan,2018,25 - 29 years,1,2,3
Rest of Co. Cavan,2018,30 - 34 years,0,3,3
Rest of Co. Cavan,2018,35 - 39 years,0,2,2
Rest of Co. Cavan,2018,40 - 44 years,4,6,10
Rest of Co. Cavan,2018,45 - 49 years,2,2,4
Rest of Co. Cavan,2018,5 - 9 years,0,0,0
Rest of Co. Cavan,2018,50 - 54 years,4,3,7
Rest of Co. Cavan,2018,55 - 59 years,5,17,22
Rest of Co. Cavan,2018,60 - 64 years,7,17,24
Rest of Co. Cavan,2018,65 - 69 years,18,20,38
Rest of Co. Cavan,2018,70 - 74 years,10,26,36
Rest of Co. Cavan,2018,75 - 79 years,19,32,51
Rest of Co. Cavan,2018,80 - 84 years,24,42,66
Rest of Co. Cavan,2018,85 years and over,91,62,153
Rest of Co. Cavan,2018,Under 1 year,0,1,1
Rest of Co. Cavan,2019,1 - 4 years,0,0,0
Rest of Co. Cavan,2019,10 - 14 years,0,0,0
Rest of Co. Cavan,2019,15 - 19 years,0,1,1
Rest of Co. Cavan,2019,20 - 24 years,0,3,3
Rest of Co. Cavan,2019,25 - 29 years,1,2,3
Rest of Co. Cavan,2019,30 - 34 years,0,3,3
Rest of Co. Cavan,2019,35 - 39 years,0,2,2
Rest of Co. Cavan,2019,40 - 44 years,4,6,10
Rest of Co. Cavan,2019,45 - 49 years,2,2,4
Rest of Co. Cavan,2019,5 - 9 years,0,0,0
Rest of Co. Cavan,2019,50 - 54 years,4,3,7
Rest of Co. Cavan,2019,55 - 59 years,5,17,22
Rest of Co. Cavan,2019,60 - 64 years,7,17,24
Rest of Co. Cavan,2019,65 - 69 years,18,20,38
Rest of Co. Cavan,2019,70 - 74 years,10,26,36
Rest of Co. Cavan,2019,75 - 79 years,19,32,51
Rest of Co. Cavan,2019,80 - 84 years,24,42,66
Rest of Co. Cavan,2019,85 years and over,91,62,153
Rest of Co. Cavan,2019,Under 1 year,0,1,1
Rest of Co. Cavan,2020,1 - 4 years,0,0,0
Rest of Co. Cavan,2020,10 - 14 years,0,0,0
Rest of Co. Cavan,2020,15 - 19 years,0,1,1
Rest of Co. Cavan,2020,20 - 24 years,0,3,3
Rest of Co. Cavan,2020,25 - 29 years,1,2,3
Rest of Co. Cavan,2020,30 - 34 years,0,3,3
Rest of Co. Cavan,2020,35 - 39 years,0,2,2
Rest of Co. Cavan,2020,40 - 44 years,4,6,10
Rest of Co. Cavan,2020,45 - 49 years,2,2,4
Rest of Co. Cavan,2020,5 - 9 years,0,0,0
Rest of Co. Cavan,2020,50 - 54 years,4,3,7
Rest of Co. Cavan,2020,55 - 59 years,5,17,22
Rest of Co. Cavan,2020,60 - 64 years,7,17,24
Rest of Co. Cavan,2020,65 - 69 years,18,20,38
Rest of Co. Cavan,2020,70 - 74 years,10,26,36
Rest of Co. Cavan,2020,75 - 79 years,19,32,51
Rest of Co. Cavan,2020,80 - 84 years,24,42,66
Rest of Co. Cavan,2020,85 years and over,91,62,153
Rest of Co. Cavan,2020,Under 1 year,0,1,1
Rest of Co. Clare,2007,1 - 4 years,0,1,1
Rest of Co. Clare,2007,10 - 14 years,0,0,0
Rest of Co. Clare,2007,15 - 19 years,0,3,3
Rest of Co. Clare,2007,20 - 24 years,3,4,7
Rest of Co. Clare,2007,25 - 29 years,0,4,4
Rest of Co. Clare,2007,30 - 34 years,2,3,5
Rest of Co. Clare,2007,35 - 39 years,3,2,5
Rest of Co. Clare,2007,40 - 44 years,0,4,4
Rest of Co. Clare,2007,45 - 49 years,5,7,12
Rest of Co. Clare,2007,5 - 9 years,0,0,0
Rest of Co. Clare,2007,50 - 54 years,3,9,12
Rest of Co. Clare,2007,55 - 59 years,6,25,31
Rest of Co. Clare,2007,60 - 64 years,17,26,43
Rest of Co. Clare,2007,65 - 69 years,12,27,39
Rest of Co. Clare,2007,70 - 74 years,17,33,50
Rest of Co. Clare,2007,75 - 79 years,34,47,81
Rest of Co. Clare,2007,80 - 84 years,54,46,100
Rest of Co. Clare,2007,85 years and over,112,69,181
Rest of Co. Clare,2007,Under 1 year,3,3,6
Rest of Co. Clare,2008,1 - 4 years,0,2,2
Rest of Co. Clare,2008,10 - 14 years,0,1,1
Rest of Co. Clare,2008,15 - 19 years,3,3,6
Rest of Co. Clare,2008,20 - 24 years,3,9,12
Rest of Co. Clare,2008,25 - 29 years,2,2,4
Rest of Co. Clare,2008,30 - 34 years,2,2,4
Rest of Co. Clare,2008,35 - 39 years,3,6,9
Rest of Co. Clare,2008,40 - 44 years,1,6,7
Rest of Co. Clare,2008,45 - 49 years,5,8,13
Rest of Co. Clare,2008,5 - 9 years,0,0,0
Rest of Co. Clare,2008,50 - 54 years,11,5,16
Rest of Co. Clare,2008,55 - 59 years,8,18,26
Rest of Co. Clare,2008,60 - 64 years,17,17,34
Rest of Co. Clare,2008,65 - 69 years,17,28,45
Rest of Co. Clare,2008,70 - 74 years,19,47,66
Rest of Co. Clare,2008,75 - 79 years,30,56,86
Rest of Co. Clare,2008,80 - 84 years,44,34,78
Rest of Co. Clare,2008,85 years and over,113,71,184
Rest of Co. Clare,2008,Under 1 year,2,4,6
Rest of Co. Clare,2009,1 - 4 years,0,1,1
Rest of Co. Clare,2009,10 - 14 years,0,1,1
Rest of Co. Clare,2009,15 - 19 years,3,1,4
Rest of Co. Clare,2009,20 - 24 years,1,3,4
Rest of Co. Clare,2009,25 - 29 years,2,3,5
Rest of Co. Clare,2009,30 - 34 years,2,5,7
Rest of Co. Clare,2009,35 - 39 years,1,4,5
Rest of Co. Clare,2009,40 - 44 years,4,7,11
Rest of Co. Clare,2009,45 - 49 years,7,6,13
Rest of Co. Clare,2009,5 - 9 years,0,0,0
Rest of Co. Clare,2009,50 - 54 years,8,7,15
Rest of Co. Clare,2009,55 - 59 years,9,17,26
Rest of Co. Clare,2009,60 - 64 years,17,26,43
Rest of Co. Clare,2009,65 - 69 years,15,25,40
Rest of Co. Clare,2009,70 - 74 years,23,48,71
Rest of Co. Clare,2009,75 - 79 years,32,47,79
Rest of Co. Clare,2009,80 - 84 years,55,62,117
Rest of Co. Clare,2009,85 years and over,116,75,191
Rest of Co. Clare,2009,Under 1 year,2,5,7
Rest of Co. Clare,2010,1 - 4 years,0,1,1
Rest of Co. Clare,2010,10 - 14 years,0,1,1
Rest of Co. Clare,2010,15 - 19 years,1,1,2
Rest of Co. Clare,2010,20 - 24 years,1,3,4
Rest of Co. Clare,2010,25 - 29 years,2,4,6
Rest of Co. Clare,2010,30 - 34 years,2,3,5
Rest of Co. Clare,2010,35 - 39 years,5,2,7
Rest of Co. Clare,2010,40 - 44 years,3,4,7
Rest of Co. Clare,2010,45 - 49 years,5,6,11
Rest of Co. Clare,2010,5 - 9 years,0,0,0
Rest of Co. Clare,2010,50 - 54 years,2,8,10
Rest of Co. Clare,2010,55 - 59 years,8,8,16
Rest of Co. Clare,2010,60 - 64 years,18,24,42
Rest of Co. Clare,2010,65 - 69 years,13,26,39
Rest of Co. Clare,2010,70 - 74 years,18,30,48
Rest of Co. Clare,2010,75 - 79 years,31,56,87
Rest of Co. Clare,2010,80 - 84 years,50,42,92
Rest of Co. Clare,2010,85 years and over,129,81,210
Rest of Co. Clare,2010,Under 1 year,3,5,8
Rest of Co. Clare,2011,1 - 4 years,0,0,0
Rest of Co. Clare,2011,10 - 14 years,0,1,1
Rest of Co. Clare,2011,15 - 19 years,0,1,1
Rest of Co. Clare,2011,20 - 24 years,2,0,2
Rest of Co. Clare,2011,25 - 29 years,0,2,2
Rest of Co. Clare,2011,30 - 34 years,1,2,3
Rest of Co. Clare,2011,35 - 39 years,1,1,2
Rest of Co. Clare,2011,40 - 44 years,2,6,8
Rest of Co. Clare,2011,45 - 49 years,5,5,10
Rest of Co. Clare,2011,5 - 9 years,0,1,1
Rest of Co. Clare,2011,50 - 54 years,6,13,19
Rest of Co. Clare,2011,55 - 59 years,13,6,19
Rest of Co. Clare,2011,60 - 64 years,16,30,46
Rest of Co. Clare,2011,65 - 69 years,12,25,37
Rest of Co. Clare,2011,70 - 74 years,22,44,66
Rest of Co. Clare,2011,75 - 79 years,25,55,80
Rest of Co. Clare,2011,80 - 84 years,48,46,94
Rest of Co. Clare,2011,85 years and over,124,70,194
Rest of Co. Clare,2011,Under 1 year,3,2,5
Rest of Co. Clare,2012,1 - 4 years,0,0,0
Rest of Co. Clare,2012,10 - 14 years,0,1,1
Rest of Co. Clare,2012,15 - 19 years,0,1,1
Rest of Co. Clare,2012,20 - 24 years,2,3,5
Rest of Co. Clare,2012,25 - 29 years,2,2,4
Rest of Co. Clare,2012,30 - 34 years,1,3,4
Rest of Co. Clare,2012,35 - 39 years,1,3,4
Rest of Co. Clare,2012,40 - 44 years,2,3,5
Rest of Co. Clare,2012,45 - 49 years,2,5,7
Rest of Co. Clare,2012,5 - 9 years,0,1,1
Rest of Co. Clare,2012,50 - 54 years,4,11,15
Rest of Co. Clare,2012,55 - 59 years,5,8,13
Rest of Co. Clare,2012,60 - 64 years,11,26,37
Rest of Co. Clare,2012,65 - 69 years,15,25,40
Rest of Co. Clare,2012,70 - 74 years,27,38,65
Rest of Co. Clare,2012,75 - 79 years,22,36,58
Rest of Co. Clare,2012,80 - 84 years,38,40,78
Rest of Co. Clare,2012,85 years and over,93,81,174
Rest of Co. Clare,2012,Under 1 year,2,3,5
Rest of Co. Clare,2013,1 - 4 years,0,0,0
Rest of Co. Clare,2013,10 - 14 years,0,0,0
Rest of Co. Clare,2013,15 - 19 years,0,3,3
Rest of Co. Clare,2013,20 - 24 years,0,0,0
Rest of Co. Clare,2013,25 - 29 years,0,2,2
Rest of Co. Clare,2013,30 - 34 years,1,1,2
Rest of Co. Clare,2013,35 - 39 years,0,3,3
Rest of Co. Clare,2013,40 - 44 years,3,5,8
Rest of Co. Clare,2013,45 - 49 years,5,8,13
Rest of Co. Clare,2013,5 - 9 years,1,1,2
Rest of Co. Clare,2013,50 - 54 years,7,5,12
Rest of Co. Clare,2013,55 - 59 years,9,12,21
Rest of Co. Clare,2013,60 - 64 years,12,18,30
Rest of Co. Clare,2013,65 - 69 years,13,41,54
Rest of Co. Clare,2013,70 - 74 years,20,32,52
Rest of Co. Clare,2013,75 - 79 years,28,30,58
Rest of Co. Clare,2013,80 - 84 years,42,54,96
Rest of Co. Clare,2013,85 years and over,102,83,185
Rest of Co. Clare,2013,Under 1 year,6,0,6
Rest of Co. Clare,2014,1 - 4 years,0,0,0
Rest of Co. Clare,2014,10 - 14 years,1,0,1
Rest of Co. Clare,2014,15 - 19 years,0,2,2
Rest of Co. Clare,2014,20 - 24 years,0,2,2
Rest of Co. Clare,2014,25 - 29 years,1,2,3
Rest of Co. Clare,2014,30 - 34 years,1,2,3
Rest of Co. Clare,2014,35 - 39 years,1,3,4
Rest of Co. Clare,2014,40 - 44 years,3,4,7
Rest of Co. Clare,2014,45 - 49 years,1,6,7
Rest of Co. Clare,2014,5 - 9 years,1,1,2
Rest of Co. Clare,2014,50 - 54 years,5,8,13
Rest of Co. Clare,2014,55 - 59 years,9,22,31
Rest of Co. Clare,2014,60 - 64 years,7,24,31
Rest of Co. Clare,2014,65 - 69 years,16,31,47
Rest of Co. Clare,2014,70 - 74 years,31,34,65
Rest of Co. Clare,2014,75 - 79 years,25,35,60
Rest of Co. Clare,2014,80 - 84 years,45,49,94
Rest of Co. Clare,2014,85 years and over,118,84,202
Rest of Co. Clare,2014,Under 1 year,5,4,9
Rest of Co. Clare,2015,1 - 4 years,0,0,0
Rest of Co. Clare,2015,10 - 14 years,1,0,1
Rest of Co. Clare,2015,15 - 19 years,0,2,2
Rest of Co. Clare,2015,20 - 24 years,0,2,2
Rest of Co. Clare,2015,25 - 29 years,1,2,3
Rest of Co. Clare,2015,30 - 34 years,1,2,3
Rest of Co. Clare,2015,35 - 39 years,1,3,4
Rest of Co. Clare,2015,40 - 44 years,3,4,7
Rest of Co. Clare,2015,45 - 49 years,1,6,7
Rest of Co. Clare,2015,5 - 9 years,1,1,2
Rest of Co. Clare,2015,50 - 54 years,5,8,13
Rest of Co. Clare,2015,55 - 59 years,9,22,31
Rest of Co. Clare,2015,60 - 64 years,7,24,31
Rest of Co. Clare,2015,65 - 69 years,16,31,47
Rest of Co. Clare,2015,70 - 74 years,31,34,65
Rest of Co. Clare,2015,75 - 79 years,25,35,60
Rest of Co. Clare,2015,80 - 84 years,45,49,94
Rest of Co. Clare,2015,85 years and over,118,84,202
Rest of Co. Clare,2015,Under 1 year,5,4,9
Rest of Co. Clare,2016,1 - 4 years,0,0,0
Rest of Co. Clare,2016,10 - 14 years,1,0,1
Rest of Co. Clare,2016,15 - 19 years,0,2,2
Rest of Co. Clare,2016,20 - 24 years,0,2,2
Rest of Co. Clare,2016,25 - 29 years,1,2,3
Rest of Co. Clare,2016,30 - 34 years,1,2,3
Rest of Co. Clare,2016,35 - 39 years,1,3,4
Rest of Co. Clare,2016,40 - 44 years,3,4,7
Rest of Co. Clare,2016,45 - 49 years,1,6,7
Rest of Co. Clare,2016,5 - 9 years,1,1,2
Rest of Co. Clare,2016,50 - 54 years,5,8,13
Rest of Co. Clare,2016,55 - 59 years,9,22,31
Rest of Co. Clare,2016,60 - 64 years,7,24,31
Rest of Co. Clare,2016,65 - 69 years,16,31,47
Rest of Co. Clare,2016,70 - 74 years,31,34,65
Rest of Co. Clare,2016,75 - 79 years,25,35,60
Rest of Co. Clare,2016,80 - 84 years,45,49,94
Rest of Co. Clare,2016,85 years and over,118,84,202
Rest of Co. Clare,2016,Under 1 year,5,4,9
Rest of Co. Clare,2017,1 - 4 years,0,2,2
Rest of Co. Clare,2017,10 - 14 years,1,1,2
Rest of Co. Clare,2017,15 - 19 years,2,1,3
Rest of Co. Clare,2017,20 - 24 years,0,2,2
Rest of Co. Clare,2017,25 - 29 years,2,2,4
Rest of Co. Clare,2017,30 - 34 years,1,1,2
Rest of Co. Clare,2017,35 - 39 years,1,4,5
Rest of Co. Clare,2017,40 - 44 years,4,3,7
Rest of Co. Clare,2017,45 - 49 years,1,5,6
Rest of Co. Clare,2017,5 - 9 years,1,1,2
Rest of Co. Clare,2017,50 - 54 years,5,10,15
Rest of Co. Clare,2017,55 - 59 years,7,17,24
Rest of Co. Clare,2017,60 - 64 years,10,18,28
Rest of Co. Clare,2017,65 - 69 years,21,24,45
Rest of Co. Clare,2017,70 - 74 years,28,36,64
Rest of Co. Clare,2017,75 - 79 years,32,34,66
Rest of Co. Clare,2017,80 - 84 years,38,42,80
Rest of Co. Clare,2017,85 years and over,139,66,205
Rest of Co. Clare,2017,Under 1 year,1,1,2
Rest of Co. Clare,2018,1 - 4 years,0,0,0
Rest of Co. Clare,2018,10 - 14 years,0,0,0
Rest of Co. Clare,2018,15 - 19 years,1,2,3
Rest of Co. Clare,2018,20 - 24 years,0,1,1
Rest of Co. Clare,2018,25 - 29 years,0,2,2
Rest of Co. Clare,2018,30 - 34 years,1,6,7
Rest of Co. Clare,2018,35 - 39 years,0,3,3
Rest of Co. Clare,2018,40 - 44 years,2,2,4
Rest of Co. Clare,2018,45 - 49 years,5,5,10
Rest of Co. Clare,2018,5 - 9 years,0,0,0
Rest of Co. Clare,2018,50 - 54 years,4,7,11
Rest of Co. Clare,2018,55 - 59 years,9,10,19
Rest of Co. Clare,2018,60 - 64 years,17,17,34
Rest of Co. Clare,2018,65 - 69 years,13,24,37
Rest of Co. Clare,2018,70 - 74 years,27,32,59
Rest of Co. Clare,2018,75 - 79 years,37,42,79
Rest of Co. Clare,2018,80 - 84 years,50,46,96
Rest of Co. Clare,2018,85 years and over,121,82,203
Rest of Co. Clare,2018,Under 1 year,3,4,7
Rest of Co. Clare,2019,1 - 4 years,0,0,0
Rest of Co. Clare,2019,10 - 14 years,0,0,0
Rest of Co. Clare,2019,15 - 19 years,1,2,3
Rest of Co. Clare,2019,20 - 24 years,0,1,1
Rest of Co. Clare,2019,25 - 29 years,0,2,2
Rest of Co. Clare,2019,30 - 34 years,1,6,7
Rest of Co. Clare,2019,35 - 39 years,0,3,3
Rest of Co. Clare,2019,40 - 44 years,2,2,4
Rest of Co. Clare,2019,45 - 49 years,5,5,10
Rest of Co. Clare,2019,5 - 9 years,0,0,0
Rest of Co. Clare,2019,50 - 54 years,4,7,11
Rest of Co. Clare,2019,55 - 59 years,9,10,19
Rest of Co. Clare,2019,60 - 64 years,17,17,34
Rest of Co. Clare,2019,65 - 69 years,13,24,37
Rest of Co. Clare,2019,70 - 74 years,27,32,59
Rest of Co. Clare,2019,75 - 79 years,37,42,79
Rest of Co. Clare,2019,80 - 84 years,50,46,96
Rest of Co. Clare,2019,85 years and over,121,82,203
Rest of Co. Clare,2019,Under 1 year,3,4,7
Rest of Co. Clare,2020,1 - 4 years,0,0,0
Rest of Co. Clare,2020,10 - 14 years,0,0,0
Rest of Co. Clare,2020,15 - 19 years,1,2,3
Rest of Co. Clare,2020,20 - 24 years,0,1,1
Rest of Co. Clare,2020,25 - 29 years,0,2,2
Rest of Co. Clare,2020,30 - 34 years,1,6,7
Rest of Co. Clare,2020,35 - 39 years,0,3,3
Rest of Co. Clare,2020,40 - 44 years,2,2,4
Rest of Co. Clare,2020,45 - 49 years,5,5,10
Rest of Co. Clare,2020,5 - 9 years,0,0,0
Rest of Co. Clare,2020,50 - 54 years,4,7,11
Rest of Co. Clare,2020,55 - 59 years,9,10,19
Rest of Co. Clare,2020,60 - 64 years,17,17,34
Rest of Co. Clare,2020,65 - 69 years,13,24,37
Rest of Co. Clare,2020,70 - 74 years,27,32,59
Rest of Co. Clare,2020,75 - 79 years,37,42,79
Rest of Co. Clare,2020,80 - 84 years,50,46,96
Rest of Co. Clare,2020,85 years and over,121,82,203
Rest of Co. Clare,2020,Under 1 year,3,4,7
Rest of Co. Cork,2007,1 - 4 years,0,6,6
Rest of Co. Cork,2007,10 - 14 years,1,3,4
Rest of Co. Cork,2007,15 - 19 years,2,3,5
Rest of Co. Cork,2007,20 - 24 years,2,10,12
Rest of Co. Cork,2007,25 - 29 years,2,10,12
Rest of Co. Cork,2007,30 - 34 years,5,2,7
Rest of Co. Cork,2007,35 - 39 years,4,12,16
Rest of Co. Cork,2007,40 - 44 years,7,9,16
Rest of Co. Cork,2007,45 - 49 years,12,28,40
Rest of Co. Cork,2007,5 - 9 years,1,2,3
Rest of Co. Cork,2007,50 - 54 years,25,24,49
Rest of Co. Cork,2007,55 - 59 years,28,38,66
Rest of Co. Cork,2007,60 - 64 years,33,55,88
Rest of Co. Cork,2007,65 - 69 years,35,75,110
Rest of Co. Cork,2007,70 - 74 years,71,91,162
Rest of Co. Cork,2007,75 - 79 years,97,120,217
Rest of Co. Cork,2007,80 - 84 years,129,132,261
Rest of Co. Cork,2007,85 years and over,296,160,456
Rest of Co. Cork,2007,Under 1 year,5,5,10
Rest of Co. Cork,2008,1 - 4 years,1,3,4
Rest of Co. Cork,2008,10 - 14 years,1,2,3
Rest of Co. Cork,2008,15 - 19 years,1,12,13
Rest of Co. Cork,2008,20 - 24 years,2,7,9
Rest of Co. Cork,2008,25 - 29 years,4,8,12
Rest of Co. Cork,2008,30 - 34 years,5,10,15
Rest of Co. Cork,2008,35 - 39 years,6,15,21
Rest of Co. Cork,2008,40 - 44 years,8,9,17
Rest of Co. Cork,2008,45 - 49 years,20,21,41
Rest of Co. Cork,2008,5 - 9 years,1,2,3
Rest of Co. Cork,2008,50 - 54 years,22,30,52
Rest of Co. Cork,2008,55 - 59 years,19,49,68
Rest of Co. Cork,2008,60 - 64 years,38,67,105
Rest of Co. Cork,2008,65 - 69 years,43,81,124
Rest of Co. Cork,2008,70 - 74 years,58,81,139
Rest of Co. Cork,2008,75 - 79 years,92,118,210
Rest of Co. Cork,2008,80 - 84 years,130,133,263
Rest of Co. Cork,2008,85 years and over,302,164,466
Rest of Co. Cork,2008,Under 1 year,8,9,17
Rest of Co. Cork,2009,1 - 4 years,3,3,6
Rest of Co. Cork,2009,10 - 14 years,1,1,2
Rest of Co. Cork,2009,15 - 19 years,1,8,9
Rest of Co. Cork,2009,20 - 24 years,4,13,17
Rest of Co. Cork,2009,25 - 29 years,3,8,11
Rest of Co. Cork,2009,30 - 34 years,3,16,19
Rest of Co. Cork,2009,35 - 39 years,12,22,34
Rest of Co. Cork,2009,40 - 44 years,7,20,27
Rest of Co. Cork,2009,45 - 49 years,15,25,40
Rest of Co. Cork,2009,5 - 9 years,1,2,3
Rest of Co. Cork,2009,50 - 54 years,16,32,48
Rest of Co. Cork,2009,55 - 59 years,26,38,64
Rest of Co. Cork,2009,60 - 64 years,37,70,107
Rest of Co. Cork,2009,65 - 69 years,38,80,118
Rest of Co. Cork,2009,70 - 74 years,61,104,165
Rest of Co. Cork,2009,75 - 79 years,95,134,229
Rest of Co. Cork,2009,80 - 84 years,146,168,314
Rest of Co. Cork,2009,85 years and over,316,205,521
Rest of Co. Cork,2009,Under 1 year,3,14,17
Rest of Co. Cork,2010,1 - 4 years,3,1,4
Rest of Co. Cork,2010,10 - 14 years,1,1,2
Rest of Co. Cork,2010,15 - 19 years,2,7,9
Rest of Co. Cork,2010,20 - 24 years,4,15,19
Rest of Co. Cork,2010,25 - 29 years,1,5,6
Rest of Co. Cork,2010,30 - 34 years,3,12,15
Rest of Co. Cork,2010,35 - 39 years,5,8,13
Rest of Co. Cork,2010,40 - 44 years,10,18,28
Rest of Co. Cork,2010,45 - 49 years,21,19,40
Rest of Co. Cork,2010,5 - 9 years,3,2,5
Rest of Co. Cork,2010,50 - 54 years,19,27,46
Rest of Co. Cork,2010,55 - 59 years,37,44,81
Rest of Co. Cork,2010,60 - 64 years,31,58,89
Rest of Co. Cork,2010,65 - 69 years,67,74,141
Rest of Co. Cork,2010,70 - 74 years,59,123,182
Rest of Co. Cork,2010,75 - 79 years,94,138,232
Rest of Co. Cork,2010,80 - 84 years,149,153,302
Rest of Co. Cork,2010,85 years and over,329,183,512
Rest of Co. Cork,2010,Under 1 year,12,11,23
Rest of Co. Cork,2011,1 - 4 years,1,1,2
Rest of Co. Cork,2011,10 - 14 years,1,1,2
Rest of Co. Cork,2011,15 - 19 years,3,7,10
Rest of Co. Cork,2011,20 - 24 years,3,8,11
Rest of Co. Cork,2011,25 - 29 years,4,12,16
Rest of Co. Cork,2011,30 - 34 years,3,15,18
Rest of Co. Cork,2011,35 - 39 years,7,13,20
Rest of Co. Cork,2011,40 - 44 years,11,23,34
Rest of Co. Cork,2011,45 - 49 years,16,24,40
Rest of Co. Cork,2011,5 - 9 years,1,2,3
Rest of Co. Cork,2011,50 - 54 years,22,35,57
Rest of Co. Cork,2011,55 - 59 years,20,52,72
Rest of Co. Cork,2011,60 - 64 years,37,62,99
Rest of Co. Cork,2011,65 - 69 years,58,66,124
Rest of Co. Cork,2011,70 - 74 years,75,99,174
Rest of Co. Cork,2011,75 - 79 years,106,142,248
Rest of Co. Cork,2011,80 - 84 years,151,168,319
Rest of Co. Cork,2011,85 years and over,377,232,609
Rest of Co. Cork,2011,Under 1 year,14,8,22
Rest of Co. Cork,2012,1 - 4 years,1,1,2
Rest of Co. Cork,2012,10 - 14 years,1,1,2
Rest of Co. Cork,2012,15 - 19 years,2,7,9
Rest of Co. Cork,2012,20 - 24 years,2,7,9
Rest of Co. Cork,2012,25 - 29 years,1,5,6
Rest of Co. Cork,2012,30 - 34 years,6,11,17
Rest of Co. Cork,2012,35 - 39 years,6,8,14
Rest of Co. Cork,2012,40 - 44 years,8,11,19
Rest of Co. Cork,2012,45 - 49 years,14,17,31
Rest of Co. Cork,2012,5 - 9 years,1,3,4
Rest of Co. Cork,2012,50 - 54 years,15,29,44
Rest of Co. Cork,2012,55 - 59 years,30,25,55
Rest of Co. Cork,2012,60 - 64 years,41,59,100
Rest of Co. Cork,2012,65 - 69 years,41,100,141
Rest of Co. Cork,2012,70 - 74 years,54,107,161
Rest of Co. Cork,2012,75 - 79 years,93,123,216
Rest of Co. Cork,2012,80 - 84 years,137,165,302
Rest of Co. Cork,2012,85 years and over,356,241,597
Rest of Co. Cork,2012,Under 1 year,10,5,15
Rest of Co. Cork,2013,1 - 4 years,2,1,3
Rest of Co. Cork,2013,10 - 14 years,1,3,4
Rest of Co. Cork,2013,15 - 19 years,2,1,3
Rest of Co. Cork,2013,20 - 24 years,1,5,6
Rest of Co. Cork,2013,25 - 29 years,2,9,11
Rest of Co. Cork,2013,30 - 34 years,7,3,10
Rest of Co. Cork,2013,35 - 39 years,4,8,12
Rest of Co. Cork,2013,40 - 44 years,8,15,23
Rest of Co. Cork,2013,45 - 49 years,15,30,45
Rest of Co. Cork,2013,5 - 9 years,0,5,5
Rest of Co. Cork,2013,50 - 54 years,17,32,49
Rest of Co. Cork,2013,55 - 59 years,19,35,54
Rest of Co. Cork,2013,60 - 64 years,40,51,91
Rest of Co. Cork,2013,65 - 69 years,56,79,135
Rest of Co. Cork,2013,70 - 74 years,57,101,158
Rest of Co. Cork,2013,75 - 79 years,102,123,225
Rest of Co. Cork,2013,80 - 84 years,162,173,335
Rest of Co. Cork,2013,85 years and over,392,255,647
Rest of Co. Cork,2013,Under 1 year,6,8,14
Rest of Co. Cork,2014,1 - 4 years,1,4,5
Rest of Co. Cork,2014,10 - 14 years,1,6,7
Rest of Co. Cork,2014,15 - 19 years,2,5,7
Rest of Co. Cork,2014,20 - 24 years,1,8,9
Rest of Co. Cork,2014,25 - 29 years,2,6,8
Rest of Co. Cork,2014,30 - 34 years,7,12,19
Rest of Co. Cork,2014,35 - 39 years,12,12,24
Rest of Co. Cork,2014,40 - 44 years,7,12,19
Rest of Co. Cork,2014,45 - 49 years,14,17,31
Rest of Co. Cork,2014,5 - 9 years,0,2,2
Rest of Co. Cork,2014,50 - 54 years,26,36,62
Rest of Co. Cork,2014,55 - 59 years,29,48,77
Rest of Co. Cork,2014,60 - 64 years,26,61,87
Rest of Co. Cork,2014,65 - 69 years,53,94,147
Rest of Co. Cork,2014,70 - 74 years,74,102,176
Rest of Co. Cork,2014,75 - 79 years,105,117,222
Rest of Co. Cork,2014,80 - 84 years,144,152,296
Rest of Co. Cork,2014,85 years and over,370,221,591
Rest of Co. Cork,2014,Under 1 year,6,8,14
Rest of Co. Cork,2015,1 - 4 years,1,4,5
Rest of Co. Cork,2015,10 - 14 years,1,6,7
Rest of Co. Cork,2015,15 - 19 years,2,5,7
Rest of Co. Cork,2015,20 - 24 years,1,8,9
Rest of Co. Cork,2015,25 - 29 years,2,6,8
Rest of Co. Cork,2015,30 - 34 years,7,12,19
Rest of Co. Cork,2015,35 - 39 years,12,12,24
Rest of Co. Cork,2015,40 - 44 years,7,12,19
Rest of Co. Cork,2015,45 - 49 years,14,17,31
Rest of Co. Cork,2015,5 - 9 years,0,2,2
Rest of Co. Cork,2015,50 - 54 years,26,36,62
Rest of Co. Cork,2015,55 - 59 years,29,48,77
Rest of Co. Cork,2015,60 - 64 years,26,61,87
Rest of Co. Cork,2015,65 - 69 years,53,94,147
Rest of Co. Cork,2015,70 - 74 years,74,102,176
Rest of Co. Cork,2015,75 - 79 years,105,117,222
Rest of Co. Cork,2015,80 - 84 years,144,152,296
Rest of Co. Cork,2015,85 years and over,370,221,591
Rest of Co. Cork,2015,Under 1 year,6,8,14
Rest of Co. Cork,2016,1 - 4 years,1,4,5
Rest of Co. Cork,2016,10 - 14 years,1,6,7
Rest of Co. Cork,2016,15 - 19 years,2,5,7
Rest of Co. Cork,2016,20 - 24 years,1,8,9
Rest of Co. Cork,2016,25 - 29 years,2,6,8
Rest of Co. Cork,2016,30 - 34 years,7,12,19
Rest of Co. Cork,2016,35 - 39 years,12,12,24
Rest of Co. Cork,2016,40 - 44 years,7,12,19
Rest of Co. Cork,2016,45 - 49 years,14,17,31
Rest of Co. Cork,2016,5 - 9 years,0,2,2
Rest of Co. Cork,2016,50 - 54 years,26,36,62
Rest of Co. Cork,2016,55 - 59 years,29,48,77
Rest of Co. Cork,2016,60 - 64 years,26,61,87
Rest of Co. Cork,2016,65 - 69 years,53,94,147
Rest of Co. Cork,2016,70 - 74 years,74,102,176
Rest of Co. Cork,2016,75 - 79 years,105,117,222
Rest of Co. Cork,2016,80 - 84 years,144,152,296
Rest of Co. Cork,2016,85 years and over,370,221,591
Rest of Co. Cork,2016,Under 1 year,6,8,14
Rest of Co. Cork,2017,1 - 4 years,1,1,2
Rest of Co. Cork,2017,10 - 14 years,1,1,2
Rest of Co. Cork,2017,15 - 19 years,5,3,8
Rest of Co. Cork,2017,20 - 24 years,1,4,5
Rest of Co. Cork,2017,25 - 29 years,1,4,5
Rest of Co. Cork,2017,30 - 34 years,6,9,15
Rest of Co. Cork,2017,35 - 39 years,10,8,18
Rest of Co. Cork,2017,40 - 44 years,17,14,31
Rest of Co. Cork,2017,45 - 49 years,23,18,41
Rest of Co. Cork,2017,5 - 9 years,1,3,4
Rest of Co. Cork,2017,50 - 54 years,23,38,61
Rest of Co. Cork,2017,55 - 59 years,29,48,77
Rest of Co. Cork,2017,60 - 64 years,59,64,123
Rest of Co. Cork,2017,65 - 69 years,51,80,131
Rest of Co. Cork,2017,70 - 74 years,89,121,210
Rest of Co. Cork,2017,75 - 79 years,97,164,261
Rest of Co. Cork,2017,80 - 84 years,153,167,320
Rest of Co. Cork,2017,85 years and over,492,273,765
Rest of Co. Cork,2017,Under 1 year,6,5,11
Rest of Co. Cork,2018,1 - 4 years,0,1,1
Rest of Co. Cork,2018,10 - 14 years,1,1,2
Rest of Co. Cork,2018,15 - 19 years,1,3,4
Rest of Co. Cork,2018,20 - 24 years,1,6,7
Rest of Co. Cork,2018,25 - 29 years,2,4,6
Rest of Co. Cork,2018,30 - 34 years,2,8,10
Rest of Co. Cork,2018,35 - 39 years,10,8,18
Rest of Co. Cork,2018,40 - 44 years,7,9,16
Rest of Co. Cork,2018,45 - 49 years,12,21,33
Rest of Co. Cork,2018,5 - 9 years,0,1,1
Rest of Co. Cork,2018,50 - 54 years,24,33,57
Rest of Co. Cork,2018,55 - 59 years,26,42,68
Rest of Co. Cork,2018,60 - 64 years,40,74,114
Rest of Co. Cork,2018,65 - 69 years,57,106,163
Rest of Co. Cork,2018,70 - 74 years,78,119,197
Rest of Co. Cork,2018,75 - 79 years,105,173,278
Rest of Co. Cork,2018,80 - 84 years,159,181,340
Rest of Co. Cork,2018,85 years and over,398,302,700
Rest of Co. Cork,2018,Under 1 year,5,6,11
Rest of Co. Cork,2019,1 - 4 years,0,1,1
Rest of Co. Cork,2019,10 - 14 years,1,1,2
Rest of Co. Cork,2019,15 - 19 years,1,3,4
Rest of Co. Cork,2019,20 - 24 years,1,6,7
Rest of Co. Cork,2019,25 - 29 years,2,4,6
Rest of Co. Cork,2019,30 - 34 years,2,8,10
Rest of Co. Cork,2019,35 - 39 years,10,8,18
Rest of Co. Cork,2019,40 - 44 years,7,9,16
Rest of Co. Cork,2019,45 - 49 years,12,21,33
Rest of Co. Cork,2019,5 - 9 years,0,1,1
Rest of Co. Cork,2019,50 - 54 years,24,33,57
Rest of Co. Cork,2019,55 - 59 years,26,42,68
Rest of Co. Cork,2019,60 - 64 years,40,74,114
Rest of Co. Cork,2019,65 - 69 years,57,106,163
Rest of Co. Cork,2019,70 - 74 years,78,119,197
Rest of Co. Cork,2019,75 - 79 years,105,173,278
Rest of Co. Cork,2019,80 - 84 years,159,181,340
Rest of Co. Cork,2019,85 years and over,398,302,700
Rest of Co. Cork,2019,Under 1 year,5,6,11
Rest of Co. Cork,2020,1 - 4 years,0,1,1
Rest of Co. Cork,2020,10 - 14 years,1,1,2
Rest of Co. Cork,2020,15 - 19 years,1,3,4
Rest of Co. Cork,2020,20 - 24 years,1,6,7
Rest of Co. Cork,2020,25 - 29 years,2,4,6
Rest of Co. Cork,2020,30 - 34 years,2,8,10
Rest of Co. Cork,2020,35 - 39 years,10,8,18
Rest of Co. Cork,2020,40 - 44 years,7,9,16
Rest of Co. Cork,2020,45 - 49 years,12,21,33
Rest of Co. Cork,2020,5 - 9 years,0,1,1
Rest of Co. Cork,2020,50 - 54 years,24,33,57
Rest of Co. Cork,2020,55 - 59 years,26,42,68
Rest of Co. Cork,2020,60 - 64 years,40,74,114
Rest of Co. Cork,2020,65 - 69 years,57,106,163
Rest of Co. Cork,2020,70 - 74 years,78,119,197
Rest of Co. Cork,2020,75 - 79 years,105,173,278
Rest of Co. Cork,2020,80 - 84 years,159,181,340
Rest of Co. Cork,2020,85 years and over,398,302,700
Rest of Co. Cork,2020,Under 1 year,5,6,11
Rest of Co. Donegal,2007,1 - 4 years,0,1,1
Rest of Co. Donegal,2007,10 - 14 years,0,0,0
Rest of Co. Donegal,2007,15 - 19 years,3,6,9
Rest of Co. Donegal,2007,20 - 24 years,0,2,2
Rest of Co. Donegal,2007,25 - 29 years,1,1,2
Rest of Co. Donegal,2007,30 - 34 years,2,2,4
Rest of Co. Donegal,2007,35 - 39 years,1,3,4
Rest of Co. Donegal,2007,40 - 44 years,3,3,6
Rest of Co. Donegal,2007,45 - 49 years,6,10,16
Rest of Co. Donegal,2007,5 - 9 years,0,0,0
Rest of Co. Donegal,2007,50 - 54 years,6,6,12
Rest of Co. Donegal,2007,55 - 59 years,14,28,42
Rest of Co. Donegal,2007,60 - 64 years,19,21,40
Rest of Co. Donegal,2007,65 - 69 years,16,31,47
Rest of Co. Donegal,2007,70 - 74 years,42,56,98
Rest of Co. Donegal,2007,75 - 79 years,44,58,102
Rest of Co. Donegal,2007,80 - 84 years,71,81,152
Rest of Co. Donegal,2007,85 years and over,188,122,310
Rest of Co. Donegal,2007,Under 1 year,1,4,5
Rest of Co. Donegal,2008,1 - 4 years,0,1,1
Rest of Co. Donegal,2008,10 - 14 years,0,0,0
Rest of Co. Donegal,2008,15 - 19 years,3,1,4
Rest of Co. Donegal,2008,20 - 24 years,2,5,7
Rest of Co. Donegal,2008,25 - 29 years,2,6,8
Rest of Co. Donegal,2008,30 - 34 years,2,4,6
Rest of Co. Donegal,2008,35 - 39 years,3,5,8
Rest of Co. Donegal,2008,40 - 44 years,4,6,10
Rest of Co. Donegal,2008,45 - 49 years,11,4,15
Rest of Co. Donegal,2008,5 - 9 years,0,1,1
Rest of Co. Donegal,2008,50 - 54 years,4,10,14
Rest of Co. Donegal,2008,55 - 59 years,18,16,34
Rest of Co. Donegal,2008,60 - 64 years,13,26,39
Rest of Co. Donegal,2008,65 - 69 years,22,50,72
Rest of Co. Donegal,2008,70 - 74 years,23,49,72
Rest of Co. Donegal,2008,75 - 79 years,47,72,119
Rest of Co. Donegal,2008,80 - 84 years,70,83,153
Rest of Co. Donegal,2008,85 years and over,183,106,289
Rest of Co. Donegal,2008,Under 1 year,4,2,6
Rest of Co. Donegal,2009,1 - 4 years,0,1,1
Rest of Co. Donegal,2009,10 - 14 years,0,0,0
Rest of Co. Donegal,2009,15 - 19 years,1,2,3
Rest of Co. Donegal,2009,20 - 24 years,2,4,6
Rest of Co. Donegal,2009,25 - 29 years,2,4,6
Rest of Co. Donegal,2009,30 - 34 years,1,2,3
Rest of Co. Donegal,2009,35 - 39 years,2,7,9
Rest of Co. Donegal,2009,40 - 44 years,4,1,5
Rest of Co. Donegal,2009,45 - 49 years,9,8,17
Rest of Co. Donegal,2009,5 - 9 years,0,1,1
Rest of Co. Donegal,2009,50 - 54 years,7,20,27
Rest of Co. Donegal,2009,55 - 59 years,19,22,41
Rest of Co. Donegal,2009,60 - 64 years,23,39,62
Rest of Co. Donegal,2009,65 - 69 years,36,38,74
Rest of Co. Donegal,2009,70 - 74 years,31,58,89
Rest of Co. Donegal,2009,75 - 79 years,52,68,120
Rest of Co. Donegal,2009,80 - 84 years,62,96,158
Rest of Co. Donegal,2009,85 years and over,207,132,339
Rest of Co. Donegal,2009,Under 1 year,2,4,6
Rest of Co. Donegal,2010,1 - 4 years,1,2,3
Rest of Co. Donegal,2010,10 - 14 years,1,0,1
Rest of Co. Donegal,2010,15 - 19 years,1,2,3
Rest of Co. Donegal,2010,20 - 24 years,2,3,5
Rest of Co. Donegal,2010,25 - 29 years,2,1,3
Rest of Co. Donegal,2010,30 - 34 years,1,2,3
Rest of Co. Donegal,2010,35 - 39 years,2,5,7
Rest of Co. Donegal,2010,40 - 44 years,3,4,7
Rest of Co. Donegal,2010,45 - 49 years,9,3,12
Rest of Co. Donegal,2010,5 - 9 years,1,1,2
Rest of Co. Donegal,2010,50 - 54 years,7,11,18
Rest of Co. Donegal,2010,55 - 59 years,20,23,43
Rest of Co. Donegal,2010,60 - 64 years,22,33,55
Rest of Co. Donegal,2010,65 - 69 years,26,52,78
Rest of Co. Donegal,2010,70 - 74 years,38,62,100
Rest of Co. Donegal,2010,75 - 79 years,53,69,122
Rest of Co. Donegal,2010,80 - 84 years,76,78,154
Rest of Co. Donegal,2010,85 years and over,198,126,324
Rest of Co. Donegal,2010,Under 1 year,2,3,5
Rest of Co. Donegal,2011,1 - 4 years,0,1,1
Rest of Co. Donegal,2011,10 - 14 years,0,0,0
Rest of Co. Donegal,2011,15 - 19 years,1,3,4
Rest of Co. Donegal,2011,20 - 24 years,1,4,5
Rest of Co. Donegal,2011,25 - 29 years,1,0,1
Rest of Co. Donegal,2011,30 - 34 years,2,3,5
Rest of Co. Donegal,2011,35 - 39 years,3,4,7
Rest of Co. Donegal,2011,40 - 44 years,5,7,12
Rest of Co. Donegal,2011,45 - 49 years,3,9,12
Rest of Co. Donegal,2011,5 - 9 years,1,1,2
Rest of Co. Donegal,2011,50 - 54 years,6,17,23
Rest of Co. Donegal,2011,55 - 59 years,9,22,31
Rest of Co. Donegal,2011,60 - 64 years,28,47,75
Rest of Co. Donegal,2011,65 - 69 years,29,35,64
Rest of Co. Donegal,2011,70 - 74 years,37,63,100
Rest of Co. Donegal,2011,75 - 79 years,36,72,108
Rest of Co. Donegal,2011,80 - 84 years,83,87,170
Rest of Co. Donegal,2011,85 years and over,185,141,326
Rest of Co. Donegal,2011,Under 1 year,2,4,6
Rest of Co. Donegal,2012,1 - 4 years,0,1,1
Rest of Co. Donegal,2012,10 - 14 years,1,1,2
Rest of Co. Donegal,2012,15 - 19 years,2,1,3
Rest of Co. Donegal,2012,20 - 24 years,1,2,3
Rest of Co. Donegal,2012,25 - 29 years,1,5,6
Rest of Co. Donegal,2012,30 - 34 years,2,4,6
Rest of Co. Donegal,2012,35 - 39 years,1,2,3
Rest of Co. Donegal,2012,40 - 44 years,3,2,5
Rest of Co. Donegal,2012,45 - 49 years,4,8,12
Rest of Co. Donegal,2012,5 - 9 years,1,1,2
Rest of Co. Donegal,2012,50 - 54 years,8,9,17
Rest of Co. Donegal,2012,55 - 59 years,7,20,27
Rest of Co. Donegal,2012,60 - 64 years,22,27,49
Rest of Co. Donegal,2012,65 - 69 years,19,48,67
Rest of Co. Donegal,2012,70 - 74 years,25,58,83
Rest of Co. Donegal,2012,75 - 79 years,51,79,130
Rest of Co. Donegal,2012,80 - 84 years,78,86,164
Rest of Co. Donegal,2012,85 years and over,220,134,354
Rest of Co. Donegal,2012,Under 1 year,5,3,8
Rest of Co. Donegal,2013,1 - 4 years,0,1,1
Rest of Co. Donegal,2013,10 - 14 years,0,1,1
Rest of Co. Donegal,2013,15 - 19 years,0,1,1
Rest of Co. Donegal,2013,20 - 24 years,0,1,1
Rest of Co. Donegal,2013,25 - 29 years,0,3,3
Rest of Co. Donegal,2013,30 - 34 years,1,7,8
Rest of Co. Donegal,2013,35 - 39 years,1,1,2
Rest of Co. Donegal,2013,40 - 44 years,3,5,8
Rest of Co. Donegal,2013,45 - 49 years,10,6,16
Rest of Co. Donegal,2013,5 - 9 years,1,1,2
Rest of Co. Donegal,2013,50 - 54 years,9,9,18
Rest of Co. Donegal,2013,55 - 59 years,8,20,28
Rest of Co. Donegal,2013,60 - 64 years,23,35,58
Rest of Co. Donegal,2013,65 - 69 years,25,42,67
Rest of Co. Donegal,2013,70 - 74 years,38,60,98
Rest of Co. Donegal,2013,75 - 79 years,46,60,106
Rest of Co. Donegal,2013,80 - 84 years,67,87,154
Rest of Co. Donegal,2013,85 years and over,232,171,403
Rest of Co. Donegal,2013,Under 1 year,3,6,9
Rest of Co. Donegal,2014,1 - 4 years,1,1,2
Rest of Co. Donegal,2014,10 - 14 years,0,1,1
Rest of Co. Donegal,2014,15 - 19 years,1,1,2
Rest of Co. Donegal,2014,20 - 24 years,0,2,2
Rest of Co. Donegal,2014,25 - 29 years,0,1,1
Rest of Co. Donegal,2014,30 - 34 years,1,4,5
Rest of Co. Donegal,2014,35 - 39 years,3,1,4
Rest of Co. Donegal,2014,40 - 44 years,2,6,8
Rest of Co. Donegal,2014,45 - 49 years,4,7,11
Rest of Co. Donegal,2014,5 - 9 years,1,1,2
Rest of Co. Donegal,2014,50 - 54 years,3,15,18
Rest of Co. Donegal,2014,55 - 59 years,12,19,31
Rest of Co. Donegal,2014,60 - 64 years,18,27,45
Rest of Co. Donegal,2014,65 - 69 years,38,53,91
Rest of Co. Donegal,2014,70 - 74 years,33,61,94
Rest of Co. Donegal,2014,75 - 79 years,43,79,122
Rest of Co. Donegal,2014,80 - 84 years,70,76,146
Rest of Co. Donegal,2014,85 years and over,211,143,354
Rest of Co. Donegal,2014,Under 1 year,1,5,6
Rest of Co. Donegal,2015,1 - 4 years,1,1,2
Rest of Co. Donegal,2015,10 - 14 years,0,1,1
Rest of Co. Donegal,2015,15 - 19 years,1,1,2
Rest of Co. Donegal,2015,20 - 24 years,0,2,2
Rest of Co. Donegal,2015,25 - 29 years,0,1,1
Rest of Co. Donegal,2015,30 - 34 years,1,4,5
Rest of Co. Donegal,2015,35 - 39 years,3,1,4
Rest of Co. Donegal,2015,40 - 44 years,2,6,8
Rest of Co. Donegal,2015,45 - 49 years,4,7,11
Rest of Co. Donegal,2015,5 - 9 years,1,1,2
Rest of Co. Donegal,2015,50 - 54 years,3,15,18
Rest of Co. Donegal,2015,55 - 59 years,12,19,31
Rest of Co. Donegal,2015,60 - 64 years,18,27,45
Rest of Co. Donegal,2015,65 - 69 years,38,53,91
Rest of Co. Donegal,2015,70 - 74 years,33,61,94
Rest of Co. Donegal,2015,75 - 79 years,43,79,122
Rest of Co. Donegal,2015,80 - 84 years,70,76,146
Rest of Co. Donegal,2015,85 years and over,211,143,354
Rest of Co. Donegal,2015,Under 1 year,1,5,6
Rest of Co. Donegal,2016,1 - 4 years,1,1,2
Rest of Co. Donegal,2016,10 - 14 years,0,1,1
Rest of Co. Donegal,2016,15 - 19 years,1,1,2
Rest of Co. Donegal,2016,20 - 24 years,0,2,2
Rest of Co. Donegal,2016,25 - 29 years,0,1,1
Rest of Co. Donegal,2016,30 - 34 years,1,4,5
Rest of Co. Donegal,2016,35 - 39 years,3,1,4
Rest of Co. Donegal,2016,40 - 44 years,2,6,8
Rest of Co. Donegal,2016,45 - 49 years,4,7,11
Rest of Co. Donegal,2016,5 - 9 years,1,1,2
Rest of Co. Donegal,2016,50 - 54 years,3,15,18
Rest of Co. Donegal,2016,55 - 59 years,12,19,31
Rest of Co. Donegal,2016,60 - 64 years,18,27,45
Rest of Co. Donegal,2016,65 - 69 years,38,53,91
Rest of Co. Donegal,2016,70 - 74 years,33,61,94
Rest of Co. Donegal,2016,75 - 79 years,43,79,122
Rest of Co. Donegal,2016,80 - 84 years,70,76,146
Rest of Co. Donegal,2016,85 years and over,211,143,354
Rest of Co. Donegal,2016,Under 1 year,1,5,6
Rest of Co. Donegal,2017,1 - 4 years,1,1,2
Rest of Co. Donegal,2017,10 - 14 years,0,1,1
Rest of Co. Donegal,2017,15 - 19 years,1,1,2
Rest of Co. Donegal,2017,20 - 24 years,0,2,2
Rest of Co. Donegal,2017,25 - 29 years,0,2,2
Rest of Co. Donegal,2017,30 - 34 years,1,3,4
Rest of Co. Donegal,2017,35 - 39 years,2,3,5
Rest of Co. Donegal,2017,40 - 44 years,2,2,4
Rest of Co. Donegal,2017,45 - 49 years,3,14,17
Rest of Co. Donegal,2017,5 - 9 years,1,1,2
Rest of Co. Donegal,2017,50 - 54 years,10,12,22
Rest of Co. Donegal,2017,55 - 59 years,8,11,19
Rest of Co. Donegal,2017,60 - 64 years,15,27,42
Rest of Co. Donegal,2017,65 - 69 years,31,45,76
Rest of Co. Donegal,2017,70 - 74 years,41,70,111
Rest of Co. Donegal,2017,75 - 79 years,54,79,133
Rest of Co. Donegal,2017,80 - 84 years,73,96,169
Rest of Co. Donegal,2017,85 years and over,209,158,367
Rest of Co. Donegal,2017,Under 1 year,6,4,10
Rest of Co. Donegal,2018,1 - 4 years,1,0,1
Rest of Co. Donegal,2018,10 - 14 years,0,0,0
Rest of Co. Donegal,2018,15 - 19 years,0,0,0
Rest of Co. Donegal,2018,20 - 24 years,0,2,2
Rest of Co. Donegal,2018,25 - 29 years,1,3,4
Rest of Co. Donegal,2018,30 - 34 years,4,0,4
Rest of Co. Donegal,2018,35 - 39 years,0,4,4
Rest of Co. Donegal,2018,40 - 44 years,2,2,4
Rest of Co. Donegal,2018,45 - 49 years,8,7,15
Rest of Co. Donegal,2018,5 - 9 years,0,0,0
Rest of Co. Donegal,2018,50 - 54 years,9,18,27
Rest of Co. Donegal,2018,55 - 59 years,15,18,33
Rest of Co. Donegal,2018,60 - 64 years,14,26,40
Rest of Co. Donegal,2018,65 - 69 years,29,46,75
Rest of Co. Donegal,2018,70 - 74 years,34,53,87
Rest of Co. Donegal,2018,75 - 79 years,59,80,139
Rest of Co. Donegal,2018,80 - 84 years,75,80,155
Rest of Co. Donegal,2018,85 years and over,223,154,377
Rest of Co. Donegal,2018,Under 1 year,2,2,4
Rest of Co. Donegal,2019,1 - 4 years,1,0,1
Rest of Co. Donegal,2019,10 - 14 years,0,0,0
Rest of Co. Donegal,2019,15 - 19 years,0,0,0
Rest of Co. Donegal,2019,20 - 24 years,0,2,2
Rest of Co. Donegal,2019,25 - 29 years,1,3,4
Rest of Co. Donegal,2019,30 - 34 years,4,0,4
Rest of Co. Donegal,2019,35 - 39 years,0,4,4
Rest of Co. Donegal,2019,40 - 44 years,2,2,4
Rest of Co. Donegal,2019,45 - 49 years,8,7,15
Rest of Co. Donegal,2019,5 - 9 years,0,0,0
Rest of Co. Donegal,2019,50 - 54 years,9,18,27
Rest of Co. Donegal,2019,55 - 59 years,15,18,33
Rest of Co. Donegal,2019,60 - 64 years,14,26,40
Rest of Co. Donegal,2019,65 - 69 years,29,46,75
Rest of Co. Donegal,2019,70 - 74 years,34,53,87
Rest of Co. Donegal,2019,75 - 79 years,59,80,139
Rest of Co. Donegal,2019,80 - 84 years,75,80,155
Rest of Co. Donegal,2019,85 years and over,223,154,377
Rest of Co. Donegal,2019,Under 1 year,2,2,4
Rest of Co. Donegal,2020,1 - 4 years,1,0,1
Rest of Co. Donegal,2020,10 - 14 years,0,0,0
Rest of Co. Donegal,2020,15 - 19 years,0,0,0
Rest of Co. Donegal,2020,20 - 24 years,0,2,2
Rest of Co. Donegal,2020,25 - 29 years,1,3,4
Rest of Co. Donegal,2020,30 - 34 years,4,0,4
Rest of Co. Donegal,2020,35 - 39 years,0,4,4
Rest of Co. Donegal,2020,40 - 44 years,2,2,4
Rest of Co. Donegal,2020,45 - 49 years,8,7,15
Rest of Co. Donegal,2020,5 - 9 years,0,0,0
Rest of Co. Donegal,2020,50 - 54 years,9,18,27
Rest of Co. Donegal,2020,55 - 59 years,15,18,33
Rest of Co. Donegal,2020,60 - 64 years,14,26,40
Rest of Co. Donegal,2020,65 - 69 years,29,46,75
Rest of Co. Donegal,2020,70 - 74 years,34,53,87
Rest of Co. Donegal,2020,75 - 79 years,59,80,139
Rest of Co. Donegal,2020,80 - 84 years,75,80,155
Rest of Co. Donegal,2020,85 years and over,223,154,377
Rest of Co. Donegal,2020,Under 1 year,2,2,4
Rest of Co. Galway,2007,1 - 4 years,1,0,1
Rest of Co. Galway,2007,10 - 14 years,2,0,2
Rest of Co. Galway,2007,15 - 19 years,0,3,3
Rest of Co. Galway,2007,20 - 24 years,1,6,7
Rest of Co. Galway,2007,25 - 29 years,2,3,5
Rest of Co. Galway,2007,30 - 34 years,3,5,8
Rest of Co. Galway,2007,35 - 39 years,2,8,10
Rest of Co. Galway,2007,40 - 44 years,11,6,17
Rest of Co. Galway,2007,45 - 49 years,6,11,17
Rest of Co. Galway,2007,5 - 9 years,0,0,0
Rest of Co. Galway,2007,50 - 54 years,5,16,21
Rest of Co. Galway,2007,55 - 59 years,17,20,37
Rest of Co. Galway,2007,60 - 64 years,21,30,51
Rest of Co. Galway,2007,65 - 69 years,21,39,60
Rest of Co. Galway,2007,70 - 74 years,32,49,81
Rest of Co. Galway,2007,75 - 79 years,52,80,132
Rest of Co. Galway,2007,80 - 84 years,99,83,182
Rest of Co. Galway,2007,85 years and over,179,119,298
Rest of Co. Galway,2007,Under 1 year,0,2,2
Rest of Co. Galway,2008,1 - 4 years,1,1,2
Rest of Co. Galway,2008,10 - 14 years,2,1,3
Rest of Co. Galway,2008,15 - 19 years,1,1,2
Rest of Co. Galway,2008,20 - 24 years,1,8,9
Rest of Co. Galway,2008,25 - 29 years,2,2,4
Rest of Co. Galway,2008,30 - 34 years,2,3,5
Rest of Co. Galway,2008,35 - 39 years,4,8,12
Rest of Co. Galway,2008,40 - 44 years,4,5,9
Rest of Co. Galway,2008,45 - 49 years,10,9,19
Rest of Co. Galway,2008,5 - 9 years,0,0,0
Rest of Co. Galway,2008,50 - 54 years,8,21,29
Rest of Co. Galway,2008,55 - 59 years,13,14,27
Rest of Co. Galway,2008,60 - 64 years,20,39,59
Rest of Co. Galway,2008,65 - 69 years,23,55,78
Rest of Co. Galway,2008,70 - 74 years,31,55,86
Rest of Co. Galway,2008,75 - 79 years,46,90,136
Rest of Co. Galway,2008,80 - 84 years,88,95,183
Rest of Co. Galway,2008,85 years and over,226,114,340
Rest of Co. Galway,2008,Under 1 year,1,4,5
Rest of Co. Galway,2009,1 - 4 years,1,2,3
Rest of Co. Galway,2009,10 - 14 years,1,1,2
Rest of Co. Galway,2009,15 - 19 years,5,1,6
Rest of Co. Galway,2009,20 - 24 years,3,2,5
Rest of Co. Galway,2009,25 - 29 years,2,3,5
Rest of Co. Galway,2009,30 - 34 years,1,8,9
Rest of Co. Galway,2009,35 - 39 years,6,4,10
Rest of Co. Galway,2009,40 - 44 years,3,7,10
Rest of Co. Galway,2009,45 - 49 years,11,17,28
Rest of Co. Galway,2009,5 - 9 years,0,0,0
Rest of Co. Galway,2009,50 - 54 years,10,18,28
Rest of Co. Galway,2009,55 - 59 years,18,34,52
Rest of Co. Galway,2009,60 - 64 years,20,41,61
Rest of Co. Galway,2009,65 - 69 years,24,58,82
Rest of Co. Galway,2009,70 - 74 years,33,60,93
Rest of Co. Galway,2009,75 - 79 years,74,96,170
Rest of Co. Galway,2009,80 - 84 years,86,95,181
Rest of Co. Galway,2009,85 years and over,220,156,376
Rest of Co. Galway,2009,Under 1 year,8,5,13
Rest of Co. Galway,2010,1 - 4 years,1,1,2
Rest of Co. Galway,2010,10 - 14 years,1,1,2
Rest of Co. Galway,2010,15 - 19 years,5,2,7
Rest of Co. Galway,2010,20 - 24 years,3,2,5
Rest of Co. Galway,2010,25 - 29 years,1,5,6
Rest of Co. Galway,2010,30 - 34 years,4,1,5
Rest of Co. Galway,2010,35 - 39 years,3,8,11
Rest of Co. Galway,2010,40 - 44 years,5,15,20
Rest of Co. Galway,2010,45 - 49 years,5,16,21
Rest of Co. Galway,2010,5 - 9 years,0,0,0
Rest of Co. Galway,2010,50 - 54 years,14,18,32
Rest of Co. Galway,2010,55 - 59 years,16,23,39
Rest of Co. Galway,2010,60 - 64 years,28,38,66
Rest of Co. Galway,2010,65 - 69 years,27,53,80
Rest of Co. Galway,2010,70 - 74 years,31,61,92
Rest of Co. Galway,2010,75 - 79 years,53,87,140
Rest of Co. Galway,2010,80 - 84 years,79,105,184
Rest of Co. Galway,2010,85 years and over,219,156,375
Rest of Co. Galway,2010,Under 1 year,2,4,6
Rest of Co. Galway,2011,1 - 4 years,1,0,1
Rest of Co. Galway,2011,10 - 14 years,0,0,0
Rest of Co. Galway,2011,15 - 19 years,2,1,3
Rest of Co. Galway,2011,20 - 24 years,2,3,5
Rest of Co. Galway,2011,25 - 29 years,1,7,8
Rest of Co. Galway,2011,30 - 34 years,5,5,10
Rest of Co. Galway,2011,35 - 39 years,4,3,7
Rest of Co. Galway,2011,40 - 44 years,9,7,16
Rest of Co. Galway,2011,45 - 49 years,11,7,18
Rest of Co. Galway,2011,5 - 9 years,1,0,1
Rest of Co. Galway,2011,50 - 54 years,11,18,29
Rest of Co. Galway,2011,55 - 59 years,17,22,39
Rest of Co. Galway,2011,60 - 64 years,27,34,61
Rest of Co. Galway,2011,65 - 69 years,32,54,86
Rest of Co. Galway,2011,70 - 74 years,35,58,93
Rest of Co. Galway,2011,75 - 79 years,58,74,132
Rest of Co. Galway,2011,80 - 84 years,84,95,179
Rest of Co. Galway,2011,85 years and over,214,158,372
Rest of Co. Galway,2011,Under 1 year,8,8,16
Rest of Co. Galway,2012,1 - 4 years,2,1,3
Rest of Co. Galway,2012,10 - 14 years,0,1,1
Rest of Co. Galway,2012,15 - 19 years,2,2,4
Rest of Co. Galway,2012,20 - 24 years,1,3,4
Rest of Co. Galway,2012,25 - 29 years,2,4,6
Rest of Co. Galway,2012,30 - 34 years,2,6,8
Rest of Co. Galway,2012,35 - 39 years,6,8,14
Rest of Co. Galway,2012,40 - 44 years,9,11,20
Rest of Co. Galway,2012,45 - 49 years,7,18,25
Rest of Co. Galway,2012,5 - 9 years,1,1,2
Rest of Co. Galway,2012,50 - 54 years,8,17,25
Rest of Co. Galway,2012,55 - 59 years,20,18,38
Rest of Co. Galway,2012,60 - 64 years,16,44,60
Rest of Co. Galway,2012,65 - 69 years,27,52,79
Rest of Co. Galway,2012,70 - 74 years,32,61,93
Rest of Co. Galway,2012,75 - 79 years,46,98,144
Rest of Co. Galway,2012,80 - 84 years,81,106,187
Rest of Co. Galway,2012,85 years and over,253,163,416
Rest of Co. Galway,2012,Under 1 year,4,5,9
Rest of Co. Galway,2013,1 - 4 years,2,0,2
Rest of Co. Galway,2013,10 - 14 years,0,1,1
Rest of Co. Galway,2013,15 - 19 years,0,0,0
Rest of Co. Galway,2013,20 - 24 years,0,6,6
Rest of Co. Galway,2013,25 - 29 years,0,3,3
Rest of Co. Galway,2013,30 - 34 years,1,3,4
Rest of Co. Galway,2013,35 - 39 years,1,4,5
Rest of Co. Galway,2013,40 - 44 years,2,4,6
Rest of Co. Galway,2013,45 - 49 years,4,9,13
Rest of Co. Galway,2013,5 - 9 years,0,0,0
Rest of Co. Galway,2013,50 - 54 years,13,25,38
Rest of Co. Galway,2013,55 - 59 years,15,24,39
Rest of Co. Galway,2013,60 - 64 years,25,38,63
Rest of Co. Galway,2013,65 - 69 years,18,50,68
Rest of Co. Galway,2013,70 - 74 years,34,61,95
Rest of Co. Galway,2013,75 - 79 years,37,72,109
Rest of Co. Galway,2013,80 - 84 years,73,92,165
Rest of Co. Galway,2013,85 years and over,230,147,377
Rest of Co. Galway,2013,Under 1 year,1,2,3
Rest of Co. Galway,2014,1 - 4 years,2,2,4
Rest of Co. Galway,2014,10 - 14 years,0,1,1
Rest of Co. Galway,2014,15 - 19 years,0,2,2
Rest of Co. Galway,2014,20 - 24 years,0,6,6
Rest of Co. Galway,2014,25 - 29 years,0,3,3
Rest of Co. Galway,2014,30 - 34 years,3,6,9
Rest of Co. Galway,2014,35 - 39 years,5,4,9
Rest of Co. Galway,2014,40 - 44 years,5,8,13
Rest of Co. Galway,2014,45 - 49 years,4,4,8
Rest of Co. Galway,2014,5 - 9 years,2,0,2
Rest of Co. Galway,2014,50 - 54 years,13,15,28
Rest of Co. Galway,2014,55 - 59 years,17,32,49
Rest of Co. Galway,2014,60 - 64 years,26,28,54
Rest of Co. Galway,2014,65 - 69 years,32,42,74
Rest of Co. Galway,2014,70 - 74 years,37,50,87
Rest of Co. Galway,2014,75 - 79 years,44,90,134
Rest of Co. Galway,2014,80 - 84 years,74,93,167
Rest of Co. Galway,2014,85 years and over,199,149,348
Rest of Co. Galway,2014,Under 1 year,4,1,5
Rest of Co. Galway,2015,1 - 4 years,2,2,4
Rest of Co. Galway,2015,10 - 14 years,0,1,1
Rest of Co. Galway,2015,15 - 19 years,0,2,2
Rest of Co. Galway,2015,20 - 24 years,0,6,6
Rest of Co. Galway,2015,25 - 29 years,0,3,3
Rest of Co. Galway,2015,30 - 34 years,3,6,9
Rest of Co. Galway,2015,35 - 39 years,5,4,9
Rest of Co. Galway,2015,40 - 44 years,5,8,13
Rest of Co. Galway,2015,45 - 49 years,4,4,8
Rest of Co. Galway,2015,5 - 9 years,2,0,2
Rest of Co. Galway,2015,50 - 54 years,13,15,28
Rest of Co. Galway,2015,55 - 59 years,17,32,49
Rest of Co. Galway,2015,60 - 64 years,26,28,54
Rest of Co. Galway,2015,65 - 69 years,32,42,74
Rest of Co. Galway,2015,70 - 74 years,37,50,87
Rest of Co. Galway,2015,75 - 79 years,44,90,134
Rest of Co. Galway,2015,80 - 84 years,74,93,167
Rest of Co. Galway,2015,85 years and over,199,149,348
Rest of Co. Galway,2015,Under 1 year,4,1,5
Rest of Co. Galway,2016,1 - 4 years,2,2,4
Rest of Co. Galway,2016,10 - 14 years,0,1,1
Rest of Co. Galway,2016,15 - 19 years,0,2,2
Rest of Co. Galway,2016,20 - 24 years,0,6,6
Rest of Co. Galway,2016,25 - 29 years,0,3,3
Rest of Co. Galway,2016,30 - 34 years,3,6,9
Rest of Co. Galway,2016,35 - 39 years,5,4,9
Rest of Co. Galway,2016,40 - 44 years,5,8,13
Rest of Co. Galway,2016,45 - 49 years,4,4,8
Rest of Co. Galway,2016,5 - 9 years,2,0,2
Rest of Co. Galway,2016,50 - 54 years,13,15,28
Rest of Co. Galway,2016,55 - 59 years,17,32,49
Rest of Co. Galway,2016,60 - 64 years,26,28,54
Rest of Co. Galway,2016,65 - 69 years,32,42,74
Rest of Co. Galway,2016,70 - 74 years,37,50,87
Rest of Co. Galway,2016,75 - 79 years,44,90,134
Rest of Co. Galway,2016,80 - 84 years,74,93,167
Rest of Co. Galway,2016,85 years and over,199,149,348
Rest of Co. Galway,2016,Under 1 year,4,1,5
Rest of Co. Galway,2017,1 - 4 years,2,2,4
Rest of Co. Galway,2017,10 - 14 years,0,1,1
Rest of Co. Galway,2017,15 - 19 years,0,3,3
Rest of Co. Galway,2017,20 - 24 years,0,1,1
Rest of Co. Galway,2017,25 - 29 years,1,2,3
Rest of Co. Galway,2017,30 - 34 years,2,3,5
Rest of Co. Galway,2017,35 - 39 years,5,5,10
Rest of Co. Galway,2017,40 - 44 years,3,6,9
Rest of Co. Galway,2017,45 - 49 years,3,6,9
Rest of Co. Galway,2017,5 - 9 years,2,2,4
Rest of Co. Galway,2017,50 - 54 years,6,20,26
Rest of Co. Galway,2017,55 - 59 years,16,13,29
Rest of Co. Galway,2017,60 - 64 years,11,24,35
Rest of Co. Galway,2017,65 - 69 years,20,38,58
Rest of Co. Galway,2017,70 - 74 years,34,64,98
Rest of Co. Galway,2017,75 - 79 years,38,71,109
Rest of Co. Galway,2017,80 - 84 years,73,106,179
Rest of Co. Galway,2017,85 years and over,226,167,393
Rest of Co. Galway,2017,Under 1 year,4,4,8
Rest of Co. Galway,2018,1 - 4 years,0,0,0
Rest of Co. Galway,2018,10 - 14 years,0,0,0
Rest of Co. Galway,2018,15 - 19 years,0,2,2
Rest of Co. Galway,2018,20 - 24 years,1,1,2
Rest of Co. Galway,2018,25 - 29 years,0,3,3
Rest of Co. Galway,2018,30 - 34 years,1,3,4
Rest of Co. Galway,2018,35 - 39 years,3,3,6
Rest of Co. Galway,2018,40 - 44 years,3,11,14
Rest of Co. Galway,2018,45 - 49 years,7,11,18
Rest of Co. Galway,2018,5 - 9 years,0,1,1
Rest of Co. Galway,2018,50 - 54 years,11,17,28
Rest of Co. Galway,2018,55 - 59 years,16,32,48
Rest of Co. Galway,2018,60 - 64 years,17,37,54
Rest of Co. Galway,2018,65 - 69 years,28,55,83
Rest of Co. Galway,2018,70 - 74 years,24,72,96
Rest of Co. Galway,2018,75 - 79 years,42,71,113
Rest of Co. Galway,2018,80 - 84 years,68,84,152
Rest of Co. Galway,2018,85 years and over,213,170,383
Rest of Co. Galway,2018,Under 1 year,3,4,7
Rest of Co. Galway,2019,1 - 4 years,0,0,0
Rest of Co. Galway,2019,10 - 14 years,0,0,0
Rest of Co. Galway,2019,15 - 19 years,0,2,2
Rest of Co. Galway,2019,20 - 24 years,1,1,2
Rest of Co. Galway,2019,25 - 29 years,0,3,3
Rest of Co. Galway,2019,30 - 34 years,1,3,4
Rest of Co. Galway,2019,35 - 39 years,3,3,6
Rest of Co. Galway,2019,40 - 44 years,3,11,14
Rest of Co. Galway,2019,45 - 49 years,7,11,18
Rest of Co. Galway,2019,5 - 9 years,0,1,1
Rest of Co. Galway,2019,50 - 54 years,11,17,28
Rest of Co. Galway,2019,55 - 59 years,16,32,48
Rest of Co. Galway,2019,60 - 64 years,17,37,54
Rest of Co. Galway,2019,65 - 69 years,28,55,83
Rest of Co. Galway,2019,70 - 74 years,24,72,96
Rest of Co. Galway,2019,75 - 79 years,42,71,113
Rest of Co. Galway,2019,80 - 84 years,68,84,152
Rest of Co. Galway,2019,85 years and over,213,170,383
Rest of Co. Galway,2019,Under 1 year,3,4,7
Rest of Co. Galway,2020,1 - 4 years,0,0,0
Rest of Co. Galway,2020,10 - 14 years,0,0,0
Rest of Co. Galway,2020,15 - 19 years,0,2,2
Rest of Co. Galway,2020,20 - 24 years,1,1,2
Rest of Co. Galway,2020,25 - 29 years,0,3,3
Rest of Co. Galway,2020,30 - 34 years,1,3,4
Rest of Co. Galway,2020,35 - 39 years,3,3,6
Rest of Co. Galway,2020,40 - 44 years,3,11,14
Rest of Co. Galway,2020,45 - 49 years,7,11,18
Rest of Co. Galway,2020,5 - 9 years,0,1,1
Rest of Co. Galway,2020,50 - 54 years,11,17,28
Rest of Co. Galway,2020,55 - 59 years,16,32,48
Rest of Co. Galway,2020,60 - 64 years,17,37,54
Rest of Co. Galway,2020,65 - 69 years,28,55,83
Rest of Co. Galway,2020,70 - 74 years,24,72,96
Rest of Co. Galway,2020,75 - 79 years,42,71,113
Rest of Co. Galway,2020,80 - 84 years,68,84,152
Rest of Co. Galway,2020,85 years and over,213,170,383
Rest of Co. Galway,2020,Under 1 year,3,4,7
Rest of Co. Kerry,2007,1 - 4 years,0,0,0
Rest of Co. Kerry,2007,10 - 14 years,1,1,2
Rest of Co. Kerry,2007,15 - 19 years,1,1,2
Rest of Co. Kerry,2007,20 - 24 years,1,5,6
Rest of Co. Kerry,2007,25 - 29 years,2,5,7
Rest of Co. Kerry,2007,30 - 34 years,1,0,1
Rest of Co. Kerry,2007,35 - 39 years,4,0,4
Rest of Co. Kerry,2007,40 - 44 years,3,10,13
Rest of Co. Kerry,2007,45 - 49 years,4,1,5
Rest of Co. Kerry,2007,5 - 9 years,0,0,0
Rest of Co. Kerry,2007,50 - 54 years,9,17,26
Rest of Co. Kerry,2007,55 - 59 years,10,29,39
Rest of Co. Kerry,2007,60 - 64 years,11,30,41
Rest of Co. Kerry,2007,65 - 69 years,18,34,52
Rest of Co. Kerry,2007,70 - 74 years,19,48,67
Rest of Co. Kerry,2007,75 - 79 years,47,65,112
Rest of Co. Kerry,2007,80 - 84 years,67,74,141
Rest of Co. Kerry,2007,85 years and over,124,94,218
Rest of Co. Kerry,2007,Under 1 year,3,3,6
Rest of Co. Kerry,2008,1 - 4 years,0,1,1
Rest of Co. Kerry,2008,10 - 14 years,1,1,2
Rest of Co. Kerry,2008,15 - 19 years,1,2,3
Rest of Co. Kerry,2008,20 - 24 years,1,5,6
Rest of Co. Kerry,2008,25 - 29 years,2,5,7
Rest of Co. Kerry,2008,30 - 34 years,1,1,2
Rest of Co. Kerry,2008,35 - 39 years,2,3,5
Rest of Co. Kerry,2008,40 - 44 years,3,4,7
Rest of Co. Kerry,2008,45 - 49 years,8,12,20
Rest of Co. Kerry,2008,5 - 9 years,1,1,2
Rest of Co. Kerry,2008,50 - 54 years,5,12,17
Rest of Co. Kerry,2008,55 - 59 years,10,19,29
Rest of Co. Kerry,2008,60 - 64 years,16,28,44
Rest of Co. Kerry,2008,65 - 69 years,15,40,55
Rest of Co. Kerry,2008,70 - 74 years,22,39,61
Rest of Co. Kerry,2008,75 - 79 years,46,40,86
Rest of Co. Kerry,2008,80 - 84 years,65,70,135
Rest of Co. Kerry,2008,85 years and over,132,85,217
Rest of Co. Kerry,2008,Under 1 year,1,3,4
Rest of Co. Kerry,2009,1 - 4 years,1,1,2
Rest of Co. Kerry,2009,10 - 14 years,1,1,2
Rest of Co. Kerry,2009,15 - 19 years,1,5,6
Rest of Co. Kerry,2009,20 - 24 years,1,4,5
Rest of Co. Kerry,2009,25 - 29 years,2,2,4
Rest of Co. Kerry,2009,30 - 34 years,2,3,5
Rest of Co. Kerry,2009,35 - 39 years,2,6,8
Rest of Co. Kerry,2009,40 - 44 years,6,10,16
Rest of Co. Kerry,2009,45 - 49 years,3,8,11
Rest of Co. Kerry,2009,5 - 9 years,1,1,2
Rest of Co. Kerry,2009,50 - 54 years,8,15,23
Rest of Co. Kerry,2009,55 - 59 years,15,15,30
Rest of Co. Kerry,2009,60 - 64 years,18,28,46
Rest of Co. Kerry,2009,65 - 69 years,13,42,55
Rest of Co. Kerry,2009,70 - 74 years,23,55,78
Rest of Co. Kerry,2009,75 - 79 years,50,88,138
Rest of Co. Kerry,2009,80 - 84 years,71,93,164
Rest of Co. Kerry,2009,85 years and over,162,117,279
Rest of Co. Kerry,2009,Under 1 year,1,1,2
Rest of Co. Kerry,2010,1 - 4 years,1,1,2
Rest of Co. Kerry,2010,10 - 14 years,1,1,2
Rest of Co. Kerry,2010,15 - 19 years,1,9,10
Rest of Co. Kerry,2010,20 - 24 years,1,3,4
Rest of Co. Kerry,2010,25 - 29 years,2,4,6
Rest of Co. Kerry,2010,30 - 34 years,1,1,2
Rest of Co. Kerry,2010,35 - 39 years,3,3,6
Rest of Co. Kerry,2010,40 - 44 years,8,4,12
Rest of Co. Kerry,2010,45 - 49 years,4,8,12
Rest of Co. Kerry,2010,5 - 9 years,1,1,2
Rest of Co. Kerry,2010,50 - 54 years,10,18,28
Rest of Co. Kerry,2010,55 - 59 years,10,29,39
Rest of Co. Kerry,2010,60 - 64 years,12,35,47
Rest of Co. Kerry,2010,65 - 69 years,27,47,74
Rest of Co. Kerry,2010,70 - 74 years,31,50,81
Rest of Co. Kerry,2010,75 - 79 years,40,63,103
Rest of Co. Kerry,2010,80 - 84 years,57,74,131
Rest of Co. Kerry,2010,85 years and over,169,110,279
Rest of Co. Kerry,2010,Under 1 year,2,3,5
Rest of Co. Kerry,2011,1 - 4 years,0,1,1
Rest of Co. Kerry,2011,10 - 14 years,0,0,0
Rest of Co. Kerry,2011,15 - 19 years,0,2,2
Rest of Co. Kerry,2011,20 - 24 years,2,0,2
Rest of Co. Kerry,2011,25 - 29 years,2,4,6
Rest of Co. Kerry,2011,30 - 34 years,3,3,6
Rest of Co. Kerry,2011,35 - 39 years,2,5,7
Rest of Co. Kerry,2011,40 - 44 years,6,1,7
Rest of Co. Kerry,2011,45 - 49 years,7,10,17
Rest of Co. Kerry,2011,5 - 9 years,1,0,1
Rest of Co. Kerry,2011,50 - 54 years,11,13,24
Rest of Co. Kerry,2011,55 - 59 years,12,16,28
Rest of Co. Kerry,2011,60 - 64 years,27,44,71
Rest of Co. Kerry,2011,65 - 69 years,24,47,71
Rest of Co. Kerry,2011,70 - 74 years,26,52,78
Rest of Co. Kerry,2011,75 - 79 years,35,59,94
Rest of Co. Kerry,2011,80 - 84 years,67,83,150
Rest of Co. Kerry,2011,85 years and over,185,116,301
Rest of Co. Kerry,2011,Under 1 year,1,6,7
Rest of Co. Kerry,2012,1 - 4 years,1,1,2
Rest of Co. Kerry,2012,10 - 14 years,0,1,1
Rest of Co. Kerry,2012,15 - 19 years,0,2,2
Rest of Co. Kerry,2012,20 - 24 years,2,2,4
Rest of Co. Kerry,2012,25 - 29 years,2,3,5
Rest of Co. Kerry,2012,30 - 34 years,3,3,6
Rest of Co. Kerry,2012,35 - 39 years,1,5,6
Rest of Co. Kerry,2012,40 - 44 years,2,6,8
Rest of Co. Kerry,2012,45 - 49 years,9,11,20
Rest of Co. Kerry,2012,5 - 9 years,1,0,1
Rest of Co. Kerry,2012,50 - 54 years,10,11,21
Rest of Co. Kerry,2012,55 - 59 years,17,29,46
Rest of Co. Kerry,2012,60 - 64 years,12,28,40
Rest of Co. Kerry,2012,65 - 69 years,16,40,56
Rest of Co. Kerry,2012,70 - 74 years,21,53,74
Rest of Co. Kerry,2012,75 - 79 years,30,57,87
Rest of Co. Kerry,2012,80 - 84 years,68,91,159
Rest of Co. Kerry,2012,85 years and over,142,103,245
Rest of Co. Kerry,2012,Under 1 year,3,3,6
Rest of Co. Kerry,2013,1 - 4 years,0,1,1
Rest of Co. Kerry,2013,10 - 14 years,0,1,1
Rest of Co. Kerry,2013,15 - 19 years,0,5,5
Rest of Co. Kerry,2013,20 - 24 years,1,1,2
Rest of Co. Kerry,2013,25 - 29 years,1,3,4
Rest of Co. Kerry,2013,30 - 34 years,2,6,8
Rest of Co. Kerry,2013,35 - 39 years,3,4,7
Rest of Co. Kerry,2013,40 - 44 years,5,9,14
Rest of Co. Kerry,2013,45 - 49 years,3,4,7
Rest of Co. Kerry,2013,5 - 9 years,0,0,0
Rest of Co. Kerry,2013,50 - 54 years,12,10,22
Rest of Co. Kerry,2013,55 - 59 years,7,20,27
Rest of Co. Kerry,2013,60 - 64 years,12,22,34
Rest of Co. Kerry,2013,65 - 69 years,15,54,69
Rest of Co. Kerry,2013,70 - 74 years,29,59,88
Rest of Co. Kerry,2013,75 - 79 years,39,71,110
Rest of Co. Kerry,2013,80 - 84 years,63,80,143
Rest of Co. Kerry,2013,85 years and over,186,133,319
Rest of Co. Kerry,2013,Under 1 year,1,2,3
Rest of Co. Kerry,2014,1 - 4 years,0,1,1
Rest of Co. Kerry,2014,10 - 14 years,0,1,1
Rest of Co. Kerry,2014,15 - 19 years,0,5,5
Rest of Co. Kerry,2014,20 - 24 years,1,3,4
Rest of Co. Kerry,2014,25 - 29 years,1,2,3
Rest of Co. Kerry,2014,30 - 34 years,2,3,5
Rest of Co. Kerry,2014,35 - 39 years,3,1,4
Rest of Co. Kerry,2014,40 - 44 years,1,7,8
Rest of Co. Kerry,2014,45 - 49 years,5,11,16
Rest of Co. Kerry,2014,5 - 9 years,1,1,2
Rest of Co. Kerry,2014,50 - 54 years,3,18,21
Rest of Co. Kerry,2014,55 - 59 years,12,25,37
Rest of Co. Kerry,2014,60 - 64 years,18,23,41
Rest of Co. Kerry,2014,65 - 69 years,28,51,79
Rest of Co. Kerry,2014,70 - 74 years,28,42,70
Rest of Co. Kerry,2014,75 - 79 years,36,58,94
Rest of Co. Kerry,2014,80 - 84 years,75,79,154
Rest of Co. Kerry,2014,85 years and over,186,120,306
Rest of Co. Kerry,2014,Under 1 year,4,1,5
Rest of Co. Kerry,2015,1 - 4 years,0,1,1
Rest of Co. Kerry,2015,10 - 14 years,0,1,1
Rest of Co. Kerry,2015,15 - 19 years,0,5,5
Rest of Co. Kerry,2015,20 - 24 years,1,3,4
Rest of Co. Kerry,2015,25 - 29 years,1,2,3
Rest of Co. Kerry,2015,30 - 34 years,2,3,5
Rest of Co. Kerry,2015,35 - 39 years,3,1,4
Rest of Co. Kerry,2015,40 - 44 years,1,7,8
Rest of Co. Kerry,2015,45 - 49 years,5,11,16
Rest of Co. Kerry,2015,5 - 9 years,1,1,2
Rest of Co. Kerry,2015,50 - 54 years,3,18,21
Rest of Co. Kerry,2015,55 - 59 years,12,25,37
Rest of Co. Kerry,2015,60 - 64 years,18,23,41
Rest of Co. Kerry,2015,65 - 69 years,28,51,79
Rest of Co. Kerry,2015,70 - 74 years,28,42,70
Rest of Co. Kerry,2015,75 - 79 years,36,58,94
Rest of Co. Kerry,2015,80 - 84 years,75,79,154
Rest of Co. Kerry,2015,85 years and over,186,120,306
Rest of Co. Kerry,2015,Under 1 year,4,1,5
Rest of Co. Kerry,2016,1 - 4 years,0,1,1
Rest of Co. Kerry,2016,10 - 14 years,0,1,1
Rest of Co. Kerry,2016,15 - 19 years,0,5,5
Rest of Co. Kerry,2016,20 - 24 years,1,3,4
Rest of Co. Kerry,2016,25 - 29 years,1,2,3
Rest of Co. Kerry,2016,30 - 34 years,2,3,5
Rest of Co. Kerry,2016,35 - 39 years,3,1,4
Rest of Co. Kerry,2016,40 - 44 years,1,7,8
Rest of Co. Kerry,2016,45 - 49 years,5,11,16
Rest of Co. Kerry,2016,5 - 9 years,1,1,2
Rest of Co. Kerry,2016,50 - 54 years,3,18,21
Rest of Co. Kerry,2016,55 - 59 years,12,25,37
Rest of Co. Kerry,2016,60 - 64 years,18,23,41
Rest of Co. Kerry,2016,65 - 69 years,28,51,79
Rest of Co. Kerry,2016,70 - 74 years,28,42,70
Rest of Co. Kerry,2016,75 - 79 years,36,58,94
Rest of Co. Kerry,2016,80 - 84 years,75,79,154
Rest of Co. Kerry,2016,85 years and over,186,120,306
Rest of Co. Kerry,2016,Under 1 year,4,1,5
Rest of Co. Kerry,2017,1 - 4 years,0,1,1
Rest of Co. Kerry,2017,10 - 14 years,0,1,1
Rest of Co. Kerry,2017,15 - 19 years,1,5,6
Rest of Co. Kerry,2017,20 - 24 years,1,3,4
Rest of Co. Kerry,2017,25 - 29 years,1,1,2
Rest of Co. Kerry,2017,30 - 34 years,2,3,5
Rest of Co. Kerry,2017,35 - 39 years,2,2,4
Rest of Co. Kerry,2017,40 - 44 years,4,3,7
Rest of Co. Kerry,2017,45 - 49 years,7,4,11
Rest of Co. Kerry,2017,5 - 9 years,1,1,2
Rest of Co. Kerry,2017,50 - 54 years,4,10,14
Rest of Co. Kerry,2017,55 - 59 years,9,17,26
Rest of Co. Kerry,2017,60 - 64 years,12,25,37
Rest of Co. Kerry,2017,65 - 69 years,19,36,55
Rest of Co. Kerry,2017,70 - 74 years,40,54,94
Rest of Co. Kerry,2017,75 - 79 years,33,65,98
Rest of Co. Kerry,2017,80 - 84 years,55,75,130
Rest of Co. Kerry,2017,85 years and over,191,128,319
Rest of Co. Kerry,2017,Under 1 year,3,2,5
Rest of Co. Kerry,2018,1 - 4 years,0,0,0
Rest of Co. Kerry,2018,10 - 14 years,0,1,1
Rest of Co. Kerry,2018,15 - 19 years,1,1,2
Rest of Co. Kerry,2018,20 - 24 years,1,1,2
Rest of Co. Kerry,2018,25 - 29 years,3,0,3
Rest of Co. Kerry,2018,30 - 34 years,1,1,2
Rest of Co. Kerry,2018,35 - 39 years,1,2,3
Rest of Co. Kerry,2018,40 - 44 years,3,6,9
Rest of Co. Kerry,2018,45 - 49 years,2,8,10
Rest of Co. Kerry,2018,5 - 9 years,0,0,0
Rest of Co. Kerry,2018,50 - 54 years,3,16,19
Rest of Co. Kerry,2018,55 - 59 years,11,20,31
Rest of Co. Kerry,2018,60 - 64 years,20,28,48
Rest of Co. Kerry,2018,65 - 69 years,19,43,62
Rest of Co. Kerry,2018,70 - 74 years,34,51,85
Rest of Co. Kerry,2018,75 - 79 years,42,68,110
Rest of Co. Kerry,2018,80 - 84 years,64,66,130
Rest of Co. Kerry,2018,85 years and over,159,137,296
Rest of Co. Kerry,2018,Under 1 year,1,4,5
Rest of Co. Kerry,2019,1 - 4 years,0,0,0
Rest of Co. Kerry,2019,10 - 14 years,0,1,1
Rest of Co. Kerry,2019,15 - 19 years,1,1,2
Rest of Co. Kerry,2019,20 - 24 years,1,1,2
Rest of Co. Kerry,2019,25 - 29 years,3,0,3
Rest of Co. Kerry,2019,30 - 34 years,1,1,2
Rest of Co. Kerry,2019,35 - 39 years,1,2,3
Rest of Co. Kerry,2019,40 - 44 years,3,6,9
Rest of Co. Kerry,2019,45 - 49 years,2,8,10
Rest of Co. Kerry,2019,5 - 9 years,0,0,0
Rest of Co. Kerry,2019,50 - 54 years,3,16,19
Rest of Co. Kerry,2019,55 - 59 years,11,20,31
Rest of Co. Kerry,2019,60 - 64 years,20,28,48
Rest of Co. Kerry,2019,65 - 69 years,19,43,62
Rest of Co. Kerry,2019,70 - 74 years,34,51,85
Rest of Co. Kerry,2019,75 - 79 years,42,68,110
Rest of Co. Kerry,2019,80 - 84 years,64,66,130
Rest of Co. Kerry,2019,85 years and over,159,137,296
Rest of Co. Kerry,2019,Under 1 year,1,4,5
Rest of Co. Kerry,2020,1 - 4 years,0,0,0
Rest of Co. Kerry,2020,10 - 14 years,0,1,1
Rest of Co. Kerry,2020,15 - 19 years,1,1,2
Rest of Co. Kerry,2020,20 - 24 years,1,1,2
Rest of Co. Kerry,2020,25 - 29 years,3,0,3
Rest of Co. Kerry,2020,30 - 34 years,1,1,2
Rest of Co. Kerry,2020,35 - 39 years,1,2,3
Rest of Co. Kerry,2020,40 - 44 years,3,6,9
Rest of Co. Kerry,2020,45 - 49 years,2,8,10
Rest of Co. Kerry,2020,5 - 9 years,0,0,0
Rest of Co. Kerry,2020,50 - 54 years,3,16,19
Rest of Co. Kerry,2020,55 - 59 years,11,20,31
Rest of Co. Kerry,2020,60 - 64 years,20,28,48
Rest of Co. Kerry,2020,65 - 69 years,19,43,62
Rest of Co. Kerry,2020,70 - 74 years,34,51,85
Rest of Co. Kerry,2020,75 - 79 years,42,68,110
Rest of Co. Kerry,2020,80 - 84 years,64,66,130
Rest of Co. Kerry,2020,85 years and over,159,137,296
Rest of Co. Kerry,2020,Under 1 year,1,4,5
Rest of Co. Kildare,2007,1 - 4 years,0,3,3
Rest of Co. Kildare,2007,10 - 14 years,2,2,4
Rest of Co. Kildare,2007,15 - 19 years,1,6,7
Rest of Co. Kildare,2007,20 - 24 years,4,8,12
Rest of Co. Kildare,2007,25 - 29 years,3,8,11
Rest of Co. Kildare,2007,30 - 34 years,1,6,7
Rest of Co. Kildare,2007,35 - 39 years,7,3,10
Rest of Co. Kildare,2007,40 - 44 years,5,8,13
Rest of Co. Kildare,2007,45 - 49 years,7,9,16
Rest of Co. Kildare,2007,5 - 9 years,1,0,1
Rest of Co. Kildare,2007,50 - 54 years,6,16,22
Rest of Co. Kildare,2007,55 - 59 years,7,22,29
Rest of Co. Kildare,2007,60 - 64 years,18,28,46
Rest of Co. Kildare,2007,65 - 69 years,15,37,52
Rest of Co. Kildare,2007,70 - 74 years,29,33,62
Rest of Co. Kildare,2007,75 - 79 years,36,47,83
Rest of Co. Kildare,2007,80 - 84 years,58,43,101
Rest of Co. Kildare,2007,85 years and over,101,58,159
Rest of Co. Kildare,2007,Under 1 year,2,7,9
Rest of Co. Kildare,2008,1 - 4 years,1,1,2
Rest of Co. Kildare,2008,10 - 14 years,2,1,3
Rest of Co. Kildare,2008,15 - 19 years,4,5,9
Rest of Co. Kildare,2008,20 - 24 years,1,3,4
Rest of Co. Kildare,2008,25 - 29 years,3,8,11
Rest of Co. Kildare,2008,30 - 34 years,2,3,5
Rest of Co. Kildare,2008,35 - 39 years,6,11,17
Rest of Co. Kildare,2008,40 - 44 years,3,8,11
Rest of Co. Kildare,2008,45 - 49 years,4,12,16
Rest of Co. Kildare,2008,5 - 9 years,2,2,4
Rest of Co. Kildare,2008,50 - 54 years,8,21,29
Rest of Co. Kildare,2008,55 - 59 years,19,19,38
Rest of Co. Kildare,2008,60 - 64 years,20,36,56
Rest of Co. Kildare,2008,65 - 69 years,25,30,55
Rest of Co. Kildare,2008,70 - 74 years,22,32,54
Rest of Co. Kildare,2008,75 - 79 years,28,59,87
Rest of Co. Kildare,2008,80 - 84 years,42,45,87
Rest of Co. Kildare,2008,85 years and over,111,73,184
Rest of Co. Kildare,2008,Under 1 year,5,10,15
Rest of Co. Kildare,2009,1 - 4 years,1,1,2
Rest of Co. Kildare,2009,10 - 14 years,3,1,4
Rest of Co. Kildare,2009,15 - 19 years,1,4,5
Rest of Co. Kildare,2009,20 - 24 years,1,3,4
Rest of Co. Kildare,2009,25 - 29 years,3,10,13
Rest of Co. Kildare,2009,30 - 34 years,3,4,7
Rest of Co. Kildare,2009,35 - 39 years,2,8,10
Rest of Co. Kildare,2009,40 - 44 years,3,15,18
Rest of Co. Kildare,2009,45 - 49 years,5,12,17
Rest of Co. Kildare,2009,5 - 9 years,2,2,4
Rest of Co. Kildare,2009,50 - 54 years,12,11,23
Rest of Co. Kildare,2009,55 - 59 years,15,24,39
Rest of Co. Kildare,2009,60 - 64 years,25,31,56
Rest of Co. Kildare,2009,65 - 69 years,26,34,60
Rest of Co. Kildare,2009,70 - 74 years,40,33,73
Rest of Co. Kildare,2009,75 - 79 years,44,33,77
Rest of Co. Kildare,2009,80 - 84 years,55,54,109
Rest of Co. Kildare,2009,85 years and over,117,77,194
Rest of Co. Kildare,2009,Under 1 year,5,6,11
Rest of Co. Kildare,2010,1 - 4 years,1,1,2
Rest of Co. Kildare,2010,10 - 14 years,3,2,5
Rest of Co. Kildare,2010,15 - 19 years,1,1,2
Rest of Co. Kildare,2010,20 - 24 years,3,6,9
Rest of Co. Kildare,2010,25 - 29 years,1,5,6
Rest of Co. Kildare,2010,30 - 34 years,6,9,15
Rest of Co. Kildare,2010,35 - 39 years,3,2,5
Rest of Co. Kildare,2010,40 - 44 years,2,7,9
Rest of Co. Kildare,2010,45 - 49 years,8,12,20
Rest of Co. Kildare,2010,5 - 9 years,2,1,3
Rest of Co. Kildare,2010,50 - 54 years,13,15,28
Rest of Co. Kildare,2010,55 - 59 years,14,20,34
Rest of Co. Kildare,2010,60 - 64 years,25,28,53
Rest of Co. Kildare,2010,65 - 69 years,27,47,74
Rest of Co. Kildare,2010,70 - 74 years,20,33,53
Rest of Co. Kildare,2010,75 - 79 years,33,50,83
Rest of Co. Kildare,2010,80 - 84 years,43,58,101
Rest of Co. Kildare,2010,85 years and over,131,62,193
Rest of Co. Kildare,2010,Under 1 year,4,4,8
Rest of Co. Kildare,2011,1 - 4 years,0,0,0
Rest of Co. Kildare,2011,10 - 14 years,1,1,2
Rest of Co. Kildare,2011,15 - 19 years,5,2,7
Rest of Co. Kildare,2011,20 - 24 years,1,4,5
Rest of Co. Kildare,2011,25 - 29 years,1,6,7
Rest of Co. Kildare,2011,30 - 34 years,1,4,5
Rest of Co. Kildare,2011,35 - 39 years,3,11,14
Rest of Co. Kildare,2011,40 - 44 years,6,17,23
Rest of Co. Kildare,2011,45 - 49 years,10,11,21
Rest of Co. Kildare,2011,5 - 9 years,0,1,1
Rest of Co. Kildare,2011,50 - 54 years,5,16,21
Rest of Co. Kildare,2011,55 - 59 years,13,25,38
Rest of Co. Kildare,2011,60 - 64 years,20,28,48
Rest of Co. Kildare,2011,65 - 69 years,31,43,74
Rest of Co. Kildare,2011,70 - 74 years,32,39,71
Rest of Co. Kildare,2011,75 - 79 years,30,52,82
Rest of Co. Kildare,2011,80 - 84 years,50,44,94
Rest of Co. Kildare,2011,85 years and over,131,64,195
Rest of Co. Kildare,2011,Under 1 year,3,5,8
Rest of Co. Kildare,2012,1 - 4 years,1,2,3
Rest of Co. Kildare,2012,10 - 14 years,1,1,2
Rest of Co. Kildare,2012,15 - 19 years,5,1,6
Rest of Co. Kildare,2012,20 - 24 years,4,4,8
Rest of Co. Kildare,2012,25 - 29 years,1,2,3
Rest of Co. Kildare,2012,30 - 34 years,1,7,8
Rest of Co. Kildare,2012,35 - 39 years,3,6,9
Rest of Co. Kildare,2012,40 - 44 years,4,10,14
Rest of Co. Kildare,2012,45 - 49 years,12,8,20
Rest of Co. Kildare,2012,5 - 9 years,0,1,1
Rest of Co. Kildare,2012,50 - 54 years,10,13,23
Rest of Co. Kildare,2012,55 - 59 years,21,21,42
Rest of Co. Kildare,2012,60 - 64 years,21,27,48
Rest of Co. Kildare,2012,65 - 69 years,22,40,62
Rest of Co. Kildare,2012,70 - 74 years,32,45,77
Rest of Co. Kildare,2012,75 - 79 years,35,50,85
Rest of Co. Kildare,2012,80 - 84 years,39,46,85
Rest of Co. Kildare,2012,85 years and over,127,71,198
Rest of Co. Kildare,2012,Under 1 year,5,5,10
Rest of Co. Kildare,2013,1 - 4 years,0,0,0
Rest of Co. Kildare,2013,10 - 14 years,0,0,0
Rest of Co. Kildare,2013,15 - 19 years,0,1,1
Rest of Co. Kildare,2013,20 - 24 years,2,1,3
Rest of Co. Kildare,2013,25 - 29 years,0,6,6
Rest of Co. Kildare,2013,30 - 34 years,1,9,10
Rest of Co. Kildare,2013,35 - 39 years,5,2,7
Rest of Co. Kildare,2013,40 - 44 years,6,12,18
Rest of Co. Kildare,2013,45 - 49 years,4,10,14
Rest of Co. Kildare,2013,5 - 9 years,0,1,1
Rest of Co. Kildare,2013,50 - 54 years,5,14,19
Rest of Co. Kildare,2013,55 - 59 years,12,14,26
Rest of Co. Kildare,2013,60 - 64 years,19,29,48
Rest of Co. Kildare,2013,65 - 69 years,14,35,49
Rest of Co. Kildare,2013,70 - 74 years,26,30,56
Rest of Co. Kildare,2013,75 - 79 years,37,35,72
Rest of Co. Kildare,2013,80 - 84 years,43,41,84
Rest of Co. Kildare,2013,85 years and over,116,69,185
Rest of Co. Kildare,2013,Under 1 year,1,2,3
Rest of Co. Kildare,2014,1 - 4 years,1,0,1
Rest of Co. Kildare,2014,10 - 14 years,0,0,0
Rest of Co. Kildare,2014,15 - 19 years,0,1,1
Rest of Co. Kildare,2014,20 - 24 years,2,4,6
Rest of Co. Kildare,2014,25 - 29 years,1,2,3
Rest of Co. Kildare,2014,30 - 34 years,1,3,4
Rest of Co. Kildare,2014,35 - 39 years,4,3,7
Rest of Co. Kildare,2014,40 - 44 years,5,7,12
Rest of Co. Kildare,2014,45 - 49 years,7,9,16
Rest of Co. Kildare,2014,5 - 9 years,1,1,2
Rest of Co. Kildare,2014,50 - 54 years,9,17,26
Rest of Co. Kildare,2014,55 - 59 years,15,17,32
Rest of Co. Kildare,2014,60 - 64 years,19,28,47
Rest of Co. Kildare,2014,65 - 69 years,24,32,56
Rest of Co. Kildare,2014,70 - 74 years,29,32,61
Rest of Co. Kildare,2014,75 - 79 years,31,48,79
Rest of Co. Kildare,2014,80 - 84 years,37,33,70
Rest of Co. Kildare,2014,85 years and over,123,72,195
Rest of Co. Kildare,2014,Under 1 year,1,2,3
Rest of Co. Kildare,2015,1 - 4 years,1,0,1
Rest of Co. Kildare,2015,10 - 14 years,0,0,0
Rest of Co. Kildare,2015,15 - 19 years,0,1,1
Rest of Co. Kildare,2015,20 - 24 years,2,4,6
Rest of Co. Kildare,2015,25 - 29 years,1,2,3
Rest of Co. Kildare,2015,30 - 34 years,1,3,4
Rest of Co. Kildare,2015,35 - 39 years,4,3,7
Rest of Co. Kildare,2015,40 - 44 years,5,7,12
Rest of Co. Kildare,2015,45 - 49 years,7,9,16
Rest of Co. Kildare,2015,5 - 9 years,1,1,2
Rest of Co. Kildare,2015,50 - 54 years,9,17,26
Rest of Co. Kildare,2015,55 - 59 years,15,17,32
Rest of Co. Kildare,2015,60 - 64 years,19,28,47
Rest of Co. Kildare,2015,65 - 69 years,24,32,56
Rest of Co. Kildare,2015,70 - 74 years,29,32,61
Rest of Co. Kildare,2015,75 - 79 years,31,48,79
Rest of Co. Kildare,2015,80 - 84 years,37,33,70
Rest of Co. Kildare,2015,85 years and over,123,72,195
Rest of Co. Kildare,2015,Under 1 year,1,2,3
Rest of Co. Kildare,2016,1 - 4 years,1,0,1
Rest of Co. Kildare,2016,10 - 14 years,0,0,0
Rest of Co. Kildare,2016,15 - 19 years,0,1,1
Rest of Co. Kildare,2016,20 - 24 years,2,4,6
Rest of Co. Kildare,2016,25 - 29 years,1,2,3
Rest of Co. Kildare,2016,30 - 34 years,1,3,4
Rest of Co. Kildare,2016,35 - 39 years,4,3,7
Rest of Co. Kildare,2016,40 - 44 years,5,7,12
Rest of Co. Kildare,2016,45 - 49 years,7,9,16
Rest of Co. Kildare,2016,5 - 9 years,1,1,2
Rest of Co. Kildare,2016,50 - 54 years,9,17,26
Rest of Co. Kildare,2016,55 - 59 years,15,17,32
Rest of Co. Kildare,2016,60 - 64 years,19,28,47
Rest of Co. Kildare,2016,65 - 69 years,24,32,56
Rest of Co. Kildare,2016,70 - 74 years,29,32,61
Rest of Co. Kildare,2016,75 - 79 years,31,48,79
Rest of Co. Kildare,2016,80 - 84 years,37,33,70
Rest of Co. Kildare,2016,85 years and over,123,72,195
Rest of Co. Kildare,2016,Under 1 year,1,2,3
Rest of Co. Kildare,2017,1 - 4 years,2,0,2
Rest of Co. Kildare,2017,10 - 14 years,0,0,0
Rest of Co. Kildare,2017,15 - 19 years,1,3,4
Rest of Co. Kildare,2017,20 - 24 years,1,2,3
Rest of Co. Kildare,2017,25 - 29 years,1,2,3
Rest of Co. Kildare,2017,30 - 34 years,2,4,6
Rest of Co. Kildare,2017,35 - 39 years,1,8,9
Rest of Co. Kildare,2017,40 - 44 years,2,6,8
Rest of Co. Kildare,2017,45 - 49 years,7,6,13
Rest of Co. Kildare,2017,5 - 9 years,1,1,2
Rest of Co. Kildare,2017,50 - 54 years,6,20,26
Rest of Co. Kildare,2017,55 - 59 years,8,13,21
Rest of Co. Kildare,2017,60 - 64 years,20,21,41
Rest of Co. Kildare,2017,65 - 69 years,19,35,54
Rest of Co. Kildare,2017,70 - 74 years,29,51,80
Rest of Co. Kildare,2017,75 - 79 years,35,48,83
Rest of Co. Kildare,2017,80 - 84 years,51,49,100
Rest of Co. Kildare,2017,85 years and over,122,80,202
Rest of Co. Kildare,2017,Under 1 year,4,3,7
Rest of Co. Kildare,2018,1 - 4 years,2,0,2
Rest of Co. Kildare,2018,10 - 14 years,0,1,1
Rest of Co. Kildare,2018,15 - 19 years,0,2,2
Rest of Co. Kildare,2018,20 - 24 years,1,6,7
Rest of Co. Kildare,2018,25 - 29 years,0,6,6
Rest of Co. Kildare,2018,30 - 34 years,5,4,9
Rest of Co. Kildare,2018,35 - 39 years,6,4,10
Rest of Co. Kildare,2018,40 - 44 years,7,7,14
Rest of Co. Kildare,2018,45 - 49 years,8,14,22
Rest of Co. Kildare,2018,5 - 9 years,1,0,1
Rest of Co. Kildare,2018,50 - 54 years,9,8,17
Rest of Co. Kildare,2018,55 - 59 years,13,18,31
Rest of Co. Kildare,2018,60 - 64 years,20,26,46
Rest of Co. Kildare,2018,65 - 69 years,14,34,48
Rest of Co. Kildare,2018,70 - 74 years,31,43,74
Rest of Co. Kildare,2018,75 - 79 years,32,50,82
Rest of Co. Kildare,2018,80 - 84 years,37,57,94
Rest of Co. Kildare,2018,85 years and over,106,82,188
Rest of Co. Kildare,2018,Under 1 year,1,3,4
Rest of Co. Kildare,2019,1 - 4 years,2,0,2
Rest of Co. Kildare,2019,10 - 14 years,0,1,1
Rest of Co. Kildare,2019,15 - 19 years,0,2,2
Rest of Co. Kildare,2019,20 - 24 years,1,6,7
Rest of Co. Kildare,2019,25 - 29 years,0,6,6
Rest of Co. Kildare,2019,30 - 34 years,5,4,9
Rest of Co. Kildare,2019,35 - 39 years,6,4,10
Rest of Co. Kildare,2019,40 - 44 years,7,7,14
Rest of Co. Kildare,2019,45 - 49 years,8,14,22
Rest of Co. Kildare,2019,5 - 9 years,1,0,1
Rest of Co. Kildare,2019,50 - 54 years,9,8,17
Rest of Co. Kildare,2019,55 - 59 years,13,18,31
Rest of Co. Kildare,2019,60 - 64 years,20,26,46
Rest of Co. Kildare,2019,65 - 69 years,14,34,48
Rest of Co. Kildare,2019,70 - 74 years,31,43,74
Rest of Co. Kildare,2019,75 - 79 years,32,50,82
Rest of Co. Kildare,2019,80 - 84 years,37,57,94
Rest of Co. Kildare,2019,85 years and over,106,82,188
Rest of Co. Kildare,2019,Under 1 year,1,3,4
Rest of Co. Kildare,2020,1 - 4 years,2,0,2
Rest of Co. Kildare,2020,10 - 14 years,0,1,1
Rest of Co. Kildare,2020,15 - 19 years,0,2,2
Rest of Co. Kildare,2020,20 - 24 years,1,6,7
Rest of Co. Kildare,2020,25 - 29 years,0,6,6
Rest of Co. Kildare,2020,30 - 34 years,5,4,9
Rest of Co. Kildare,2020,35 - 39 years,6,4,10
Rest of Co. Kildare,2020,40 - 44 years,7,7,14
Rest of Co. Kildare,2020,45 - 49 years,8,14,22
Rest of Co. Kildare,2020,5 - 9 years,1,0,1
Rest of Co. Kildare,2020,50 - 54 years,9,8,17
Rest of Co. Kildare,2020,55 - 59 years,13,18,31
Rest of Co. Kildare,2020,60 - 64 years,20,26,46
Rest of Co. Kildare,2020,65 - 69 years,14,34,48
Rest of Co. Kildare,2020,70 - 74 years,31,43,74
Rest of Co. Kildare,2020,75 - 79 years,32,50,82
Rest of Co. Kildare,2020,80 - 84 years,37,57,94
Rest of Co. Kildare,2020,85 years and over,106,82,188
Rest of Co. Kildare,2020,Under 1 year,1,3,4
Rest of Co. Kilkenny,2007,1 - 4 years,3,0,3
Rest of Co. Kilkenny,2007,10 - 14 years,0,2,2
Rest of Co. Kilkenny,2007,15 - 19 years,2,5,7
Rest of Co. Kilkenny,2007,20 - 24 years,0,0,0
Rest of Co. Kilkenny,2007,25 - 29 years,0,0,0
Rest of Co. Kilkenny,2007,30 - 34 years,2,3,5
Rest of Co. Kilkenny,2007,35 - 39 years,0,4,4
Rest of Co. Kilkenny,2007,40 - 44 years,3,1,4
Rest of Co. Kilkenny,2007,45 - 49 years,5,9,14
Rest of Co. Kilkenny,2007,5 - 9 years,0,0,0
Rest of Co. Kilkenny,2007,50 - 54 years,3,7,10
Rest of Co. Kilkenny,2007,55 - 59 years,6,14,20
Rest of Co. Kilkenny,2007,60 - 64 years,6,22,28
Rest of Co. Kilkenny,2007,65 - 69 years,13,16,29
Rest of Co. Kilkenny,2007,70 - 74 years,20,34,54
Rest of Co. Kilkenny,2007,75 - 79 years,30,44,74
Rest of Co. Kilkenny,2007,80 - 84 years,44,36,80
Rest of Co. Kilkenny,2007,85 years and over,81,63,144
Rest of Co. Kilkenny,2007,Under 1 year,1,3,4
Rest of Co. Kilkenny,2008,1 - 4 years,3,1,4
Rest of Co. Kilkenny,2008,10 - 14 years,1,1,2
Rest of Co. Kilkenny,2008,15 - 19 years,2,1,3
Rest of Co. Kilkenny,2008,20 - 24 years,1,2,3
Rest of Co. Kilkenny,2008,25 - 29 years,1,1,2
Rest of Co. Kilkenny,2008,30 - 34 years,2,2,4
Rest of Co. Kilkenny,2008,35 - 39 years,2,1,3
Rest of Co. Kilkenny,2008,40 - 44 years,3,7,10
Rest of Co. Kilkenny,2008,45 - 49 years,4,4,8
Rest of Co. Kilkenny,2008,5 - 9 years,0,1,1
Rest of Co. Kilkenny,2008,50 - 54 years,9,7,16
Rest of Co. Kilkenny,2008,55 - 59 years,7,9,16
Rest of Co. Kilkenny,2008,60 - 64 years,8,16,24
Rest of Co. Kilkenny,2008,65 - 69 years,14,22,36
Rest of Co. Kilkenny,2008,70 - 74 years,11,40,51
Rest of Co. Kilkenny,2008,75 - 79 years,40,37,77
Rest of Co. Kilkenny,2008,80 - 84 years,37,51,88
Rest of Co. Kilkenny,2008,85 years and over,88,57,145
Rest of Co. Kilkenny,2008,Under 1 year,1,2,3
Rest of Co. Kilkenny,2009,1 - 4 years,3,1,4
Rest of Co. Kilkenny,2009,10 - 14 years,1,1,2
Rest of Co. Kilkenny,2009,15 - 19 years,1,1,2
Rest of Co. Kilkenny,2009,20 - 24 years,1,1,2
Rest of Co. Kilkenny,2009,25 - 29 years,1,1,2
Rest of Co. Kilkenny,2009,30 - 34 years,2,2,4
Rest of Co. Kilkenny,2009,35 - 39 years,2,4,6
Rest of Co. Kilkenny,2009,40 - 44 years,3,6,9
Rest of Co. Kilkenny,2009,45 - 49 years,2,5,7
Rest of Co. Kilkenny,2009,5 - 9 years,0,1,1
Rest of Co. Kilkenny,2009,50 - 54 years,3,8,11
Rest of Co. Kilkenny,2009,55 - 59 years,4,14,18
Rest of Co. Kilkenny,2009,60 - 64 years,9,19,28
Rest of Co. Kilkenny,2009,65 - 69 years,7,20,27
Rest of Co. Kilkenny,2009,70 - 74 years,17,24,41
Rest of Co. Kilkenny,2009,75 - 79 years,34,30,64
Rest of Co. Kilkenny,2009,80 - 84 years,31,45,76
Rest of Co. Kilkenny,2009,85 years and over,95,54,149
Rest of Co. Kilkenny,2009,Under 1 year,3,2,5
Rest of Co. Kilkenny,2010,1 - 4 years,1,3,4
Rest of Co. Kilkenny,2010,10 - 14 years,1,1,2
Rest of Co. Kilkenny,2010,15 - 19 years,1,2,3
Rest of Co. Kilkenny,2010,20 - 24 years,1,2,3
Rest of Co. Kilkenny,2010,25 - 29 years,2,3,5
Rest of Co. Kilkenny,2010,30 - 34 years,2,2,4
Rest of Co. Kilkenny,2010,35 - 39 years,2,1,3
Rest of Co. Kilkenny,2010,40 - 44 years,3,9,12
Rest of Co. Kilkenny,2010,45 - 49 years,2,2,4
Rest of Co. Kilkenny,2010,5 - 9 years,0,1,1
Rest of Co. Kilkenny,2010,50 - 54 years,6,4,10
Rest of Co. Kilkenny,2010,55 - 59 years,5,11,16
Rest of Co. Kilkenny,2010,60 - 64 years,11,13,24
Rest of Co. Kilkenny,2010,65 - 69 years,16,25,41
Rest of Co. Kilkenny,2010,70 - 74 years,14,32,46
Rest of Co. Kilkenny,2010,75 - 79 years,20,37,57
Rest of Co. Kilkenny,2010,80 - 84 years,43,48,91
Rest of Co. Kilkenny,2010,85 years and over,110,67,177
Rest of Co. Kilkenny,2010,Under 1 year,2,6,8
Rest of Co. Kilkenny,2011,1 - 4 years,0,1,1
Rest of Co. Kilkenny,2011,10 - 14 years,0,1,1
Rest of Co. Kilkenny,2011,15 - 19 years,0,2,2
Rest of Co. Kilkenny,2011,20 - 24 years,0,1,1
Rest of Co. Kilkenny,2011,25 - 29 years,0,2,2
Rest of Co. Kilkenny,2011,30 - 34 years,2,4,6
Rest of Co. Kilkenny,2011,35 - 39 years,2,3,5
Rest of Co. Kilkenny,2011,40 - 44 years,5,3,8
Rest of Co. Kilkenny,2011,45 - 49 years,4,8,12
Rest of Co. Kilkenny,2011,5 - 9 years,1,0,1
Rest of Co. Kilkenny,2011,50 - 54 years,2,5,7
Rest of Co. Kilkenny,2011,55 - 59 years,8,12,20
Rest of Co. Kilkenny,2011,60 - 64 years,8,15,23
Rest of Co. Kilkenny,2011,65 - 69 years,13,25,38
Rest of Co. Kilkenny,2011,70 - 74 years,17,30,47
Rest of Co. Kilkenny,2011,75 - 79 years,26,31,57
Rest of Co. Kilkenny,2011,80 - 84 years,41,43,84
Rest of Co. Kilkenny,2011,85 years and over,103,67,170
Rest of Co. Kilkenny,2011,Under 1 year,1,3,4
Rest of Co. Kilkenny,2012,1 - 4 years,1,1,2
Rest of Co. Kilkenny,2012,10 - 14 years,0,1,1
Rest of Co. Kilkenny,2012,15 - 19 years,0,1,1
Rest of Co. Kilkenny,2012,20 - 24 years,0,1,1
Rest of Co. Kilkenny,2012,25 - 29 years,2,4,6
Rest of Co. Kilkenny,2012,30 - 34 years,1,2,3
Rest of Co. Kilkenny,2012,35 - 39 years,1,2,3
Rest of Co. Kilkenny,2012,40 - 44 years,2,1,3
Rest of Co. Kilkenny,2012,45 - 49 years,1,8,9
Rest of Co. Kilkenny,2012,5 - 9 years,1,0,1
Rest of Co. Kilkenny,2012,50 - 54 years,7,12,19
Rest of Co. Kilkenny,2012,55 - 59 years,6,10,16
Rest of Co. Kilkenny,2012,60 - 64 years,9,13,22
Rest of Co. Kilkenny,2012,65 - 69 years,22,22,44
Rest of Co. Kilkenny,2012,70 - 74 years,12,23,35
Rest of Co. Kilkenny,2012,75 - 79 years,30,29,59
Rest of Co. Kilkenny,2012,80 - 84 years,36,37,73
Rest of Co. Kilkenny,2012,85 years and over,95,72,167
Rest of Co. Kilkenny,2012,Under 1 year,2,1,3
Rest of Co. Kilkenny,2013,1 - 4 years,0,0,0
Rest of Co. Kilkenny,2013,10 - 14 years,0,0,0
Rest of Co. Kilkenny,2013,15 - 19 years,0,1,1
Rest of Co. Kilkenny,2013,20 - 24 years,1,0,1
Rest of Co. Kilkenny,2013,25 - 29 years,1,2,3
Rest of Co. Kilkenny,2013,30 - 34 years,0,1,1
Rest of Co. Kilkenny,2013,35 - 39 years,0,2,2
Rest of Co. Kilkenny,2013,40 - 44 years,2,5,7
Rest of Co. Kilkenny,2013,45 - 49 years,4,6,10
Rest of Co. Kilkenny,2013,5 - 9 years,0,0,0
Rest of Co. Kilkenny,2013,50 - 54 years,5,10,15
Rest of Co. Kilkenny,2013,55 - 59 years,7,17,24
Rest of Co. Kilkenny,2013,60 - 64 years,12,24,36
Rest of Co. Kilkenny,2013,65 - 69 years,19,26,45
Rest of Co. Kilkenny,2013,70 - 74 years,17,28,45
Rest of Co. Kilkenny,2013,75 - 79 years,30,34,64
Rest of Co. Kilkenny,2013,80 - 84 years,36,45,81
Rest of Co. Kilkenny,2013,85 years and over,91,73,164
Rest of Co. Kilkenny,2013,Under 1 year,3,4,7
Rest of Co. Kilkenny,2014,1 - 4 years,1,0,1
Rest of Co. Kilkenny,2014,10 - 14 years,0,0,0
Rest of Co. Kilkenny,2014,15 - 19 years,0,1,1
Rest of Co. Kilkenny,2014,20 - 24 years,1,2,3
Rest of Co. Kilkenny,2014,25 - 29 years,1,2,3
Rest of Co. Kilkenny,2014,30 - 34 years,1,1,2
Rest of Co. Kilkenny,2014,35 - 39 years,2,3,5
Rest of Co. Kilkenny,2014,40 - 44 years,1,4,5
Rest of Co. Kilkenny,2014,45 - 49 years,2,2,4
Rest of Co. Kilkenny,2014,5 - 9 years,1,0,1
Rest of Co. Kilkenny,2014,50 - 54 years,4,1,5
Rest of Co. Kilkenny,2014,55 - 59 years,3,5,8
Rest of Co. Kilkenny,2014,60 - 64 years,11,20,31
Rest of Co. Kilkenny,2014,65 - 69 years,15,20,35
Rest of Co. Kilkenny,2014,70 - 74 years,12,28,40
Rest of Co. Kilkenny,2014,75 - 79 years,29,29,58
Rest of Co. Kilkenny,2014,80 - 84 years,30,43,73
Rest of Co. Kilkenny,2014,85 years and over,98,65,163
Rest of Co. Kilkenny,2014,Under 1 year,2,1,3
Rest of Co. Kilkenny,2015,1 - 4 years,1,0,1
Rest of Co. Kilkenny,2015,10 - 14 years,0,0,0
Rest of Co. Kilkenny,2015,15 - 19 years,0,1,1
Rest of Co. Kilkenny,2015,20 - 24 years,1,2,3
Rest of Co. Kilkenny,2015,25 - 29 years,1,2,3
Rest of Co. Kilkenny,2015,30 - 34 years,1,1,2
Rest of Co. Kilkenny,2015,35 - 39 years,2,3,5
Rest of Co. Kilkenny,2015,40 - 44 years,1,4,5
Rest of Co. Kilkenny,2015,45 - 49 years,2,2,4
Rest of Co. Kilkenny,2015,5 - 9 years,1,0,1
Rest of Co. Kilkenny,2015,50 - 54 years,4,1,5
Rest of Co. Kilkenny,2015,55 - 59 years,3,5,8
Rest of Co. Kilkenny,2015,60 - 64 years,11,20,31
Rest of Co. Kilkenny,2015,65 - 69 years,15,20,35
Rest of Co. Kilkenny,2015,70 - 74 years,12,28,40
Rest of Co. Kilkenny,2015,75 - 79 years,29,29,58
Rest of Co. Kilkenny,2015,80 - 84 years,30,43,73
Rest of Co. Kilkenny,2015,85 years and over,98,65,163
Rest of Co. Kilkenny,2015,Under 1 year,2,1,3
Rest of Co. Kilkenny,2016,1 - 4 years,1,0,1
Rest of Co. Kilkenny,2016,10 - 14 years,0,0,0
Rest of Co. Kilkenny,2016,15 - 19 years,0,1,1
Rest of Co. Kilkenny,2016,20 - 24 years,1,2,3
Rest of Co. Kilkenny,2016,25 - 29 years,1,2,3
Rest of Co. Kilkenny,2016,30 - 34 years,1,1,2
Rest of Co. Kilkenny,2016,35 - 39 years,2,3,5
Rest of Co. Kilkenny,2016,40 - 44 years,1,4,5
Rest of Co. Kilkenny,2016,45 - 49 years,2,2,4
Rest of Co. Kilkenny,2016,5 - 9 years,1,0,1
Rest of Co. Kilkenny,2016,50 - 54 years,4,1,5
Rest of Co. Kilkenny,2016,55 - 59 years,3,5,8
Rest of Co. Kilkenny,2016,60 - 64 years,11,20,31
Rest of Co. Kilkenny,2016,65 - 69 years,15,20,35
Rest of Co. Kilkenny,2016,70 - 74 years,12,28,40
Rest of Co. Kilkenny,2016,75 - 79 years,29,29,58
Rest of Co. Kilkenny,2016,80 - 84 years,30,43,73
Rest of Co. Kilkenny,2016,85 years and over,98,65,163
Rest of Co. Kilkenny,2016,Under 1 year,2,1,3
Rest of Co. Kilkenny,2017,1 - 4 years,1,2,3
Rest of Co. Kilkenny,2017,10 - 14 years,0,0,0
Rest of Co. Kilkenny,2017,15 - 19 years,0,1,1
Rest of Co. Kilkenny,2017,20 - 24 years,1,2,3
Rest of Co. Kilkenny,2017,25 - 29 years,1,2,3
Rest of Co. Kilkenny,2017,30 - 34 years,1,1,2
Rest of Co. Kilkenny,2017,35 - 39 years,2,4,6
Rest of Co. Kilkenny,2017,40 - 44 years,3,6,9
Rest of Co. Kilkenny,2017,45 - 49 years,3,3,6
Rest of Co. Kilkenny,2017,5 - 9 years,1,0,1
Rest of Co. Kilkenny,2017,50 - 54 years,7,9,16
Rest of Co. Kilkenny,2017,55 - 59 years,7,20,27
Rest of Co. Kilkenny,2017,60 - 64 years,9,9,18
Rest of Co. Kilkenny,2017,65 - 69 years,21,23,44
Rest of Co. Kilkenny,2017,70 - 74 years,27,37,64
Rest of Co. Kilkenny,2017,75 - 79 years,26,43,69
Rest of Co. Kilkenny,2017,80 - 84 years,40,44,84
Rest of Co. Kilkenny,2017,85 years and over,97,71,168
Rest of Co. Kilkenny,2017,Under 1 year,2,2,4
Rest of Co. Kilkenny,2018,1 - 4 years,0,0,0
Rest of Co. Kilkenny,2018,10 - 14 years,0,0,0
Rest of Co. Kilkenny,2018,15 - 19 years,1,1,2
Rest of Co. Kilkenny,2018,20 - 24 years,1,5,6
Rest of Co. Kilkenny,2018,25 - 29 years,0,3,3
Rest of Co. Kilkenny,2018,30 - 34 years,1,3,4
Rest of Co. Kilkenny,2018,35 - 39 years,2,1,3
Rest of Co. Kilkenny,2018,40 - 44 years,3,6,9
Rest of Co. Kilkenny,2018,45 - 49 years,2,6,8
Rest of Co. Kilkenny,2018,5 - 9 years,0,0,0
Rest of Co. Kilkenny,2018,50 - 54 years,3,7,10
Rest of Co. Kilkenny,2018,55 - 59 years,3,13,16
Rest of Co. Kilkenny,2018,60 - 64 years,17,11,28
Rest of Co. Kilkenny,2018,65 - 69 years,25,28,53
Rest of Co. Kilkenny,2018,70 - 74 years,17,35,52
Rest of Co. Kilkenny,2018,75 - 79 years,37,39,76
Rest of Co. Kilkenny,2018,80 - 84 years,47,53,100
Rest of Co. Kilkenny,2018,85 years and over,114,89,203
Rest of Co. Kilkenny,2018,Under 1 year,1,1,2
Rest of Co. Kilkenny,2019,1 - 4 years,0,0,0
Rest of Co. Kilkenny,2019,10 - 14 years,0,0,0
Rest of Co. Kilkenny,2019,15 - 19 years,1,1,2
Rest of Co. Kilkenny,2019,20 - 24 years,1,5,6
Rest of Co. Kilkenny,2019,25 - 29 years,0,3,3
Rest of Co. Kilkenny,2019,30 - 34 years,1,3,4
Rest of Co. Kilkenny,2019,35 - 39 years,2,1,3
Rest of Co. Kilkenny,2019,40 - 44 years,3,6,9
Rest of Co. Kilkenny,2019,45 - 49 years,2,6,8
Rest of Co. Kilkenny,2019,5 - 9 years,0,0,0
Rest of Co. Kilkenny,2019,50 - 54 years,3,7,10
Rest of Co. Kilkenny,2019,55 - 59 years,3,13,16
Rest of Co. Kilkenny,2019,60 - 64 years,17,11,28
Rest of Co. Kilkenny,2019,65 - 69 years,25,28,53
Rest of Co. Kilkenny,2019,70 - 74 years,17,35,52
Rest of Co. Kilkenny,2019,75 - 79 years,37,39,76
Rest of Co. Kilkenny,2019,80 - 84 years,47,53,100
Rest of Co. Kilkenny,2019,85 years and over,114,89,203
Rest of Co. Kilkenny,2019,Under 1 year,1,1,2
Rest of Co. Kilkenny,2020,1 - 4 years,0,0,0
Rest of Co. Kilkenny,2020,10 - 14 years,0,0,0
Rest of Co. Kilkenny,2020,15 - 19 years,1,1,2
Rest of Co. Kilkenny,2020,20 - 24 years,1,5,6
Rest of Co. Kilkenny,2020,25 - 29 years,0,3,3
Rest of Co. Kilkenny,2020,30 - 34 years,1,3,4
Rest of Co. Kilkenny,2020,35 - 39 years,2,1,3
Rest of Co. Kilkenny,2020,40 - 44 years,3,6,9
Rest of Co. Kilkenny,2020,45 - 49 years,2,6,8
Rest of Co. Kilkenny,2020,5 - 9 years,0,0,0
Rest of Co. Kilkenny,2020,50 - 54 years,3,7,10
Rest of Co. Kilkenny,2020,55 - 59 years,3,13,16
Rest of Co. Kilkenny,2020,60 - 64 years,17,11,28
Rest of Co. Kilkenny,2020,65 - 69 years,25,28,53
Rest of Co. Kilkenny,2020,70 - 74 years,17,35,52
Rest of Co. Kilkenny,2020,75 - 79 years,37,39,76
Rest of Co. Kilkenny,2020,80 - 84 years,47,53,100
Rest of Co. Kilkenny,2020,85 years and over,114,89,203
Rest of Co. Kilkenny,2020,Under 1 year,1,1,2
Rest of Co. Longford,2007,1 - 4 years,0,0,0
Rest of Co. Longford,2007,10 - 14 years,0,1,1
Rest of Co. Longford,2007,15 - 19 years,1,0,1
Rest of Co. Longford,2007,20 - 24 years,0,1,1
Rest of Co. Longford,2007,25 - 29 years,0,1,1
Rest of Co. Longford,2007,30 - 34 years,0,3,3
Rest of Co. Longford,2007,35 - 39 years,1,1,2
Rest of Co. Longford,2007,40 - 44 years,0,2,2
Rest of Co. Longford,2007,45 - 49 years,0,3,3
Rest of Co. Longford,2007,5 - 9 years,0,0,0
Rest of Co. Longford,2007,50 - 54 years,2,7,9
Rest of Co. Longford,2007,55 - 59 years,3,5,8
Rest of Co. Longford,2007,60 - 64 years,7,8,15
Rest of Co. Longford,2007,65 - 69 years,6,12,18
Rest of Co. Longford,2007,70 - 74 years,15,21,36
Rest of Co. Longford,2007,75 - 79 years,12,15,27
Rest of Co. Longford,2007,80 - 84 years,24,24,48
Rest of Co. Longford,2007,85 years and over,53,31,84
Rest of Co. Longford,2007,Under 1 year,1,2,3
Rest of Co. Longford,2008,1 - 4 years,0,0,0
Rest of Co. Longford,2008,10 - 14 years,0,1,1
Rest of Co. Longford,2008,15 - 19 years,1,0,1
Rest of Co. Longford,2008,20 - 24 years,0,3,3
Rest of Co. Longford,2008,25 - 29 years,0,1,1
Rest of Co. Longford,2008,30 - 34 years,2,2,4
Rest of Co. Longford,2008,35 - 39 years,1,1,2
Rest of Co. Longford,2008,40 - 44 years,2,2,4
Rest of Co. Longford,2008,45 - 49 years,1,1,2
Rest of Co. Longford,2008,5 - 9 years,0,0,0
Rest of Co. Longford,2008,50 - 54 years,6,3,9
Rest of Co. Longford,2008,55 - 59 years,5,5,10
Rest of Co. Longford,2008,60 - 64 years,6,6,12
Rest of Co. Longford,2008,65 - 69 years,4,16,20
Rest of Co. Longford,2008,70 - 74 years,4,15,19
Rest of Co. Longford,2008,75 - 79 years,9,19,28
Rest of Co. Longford,2008,80 - 84 years,32,17,49
Rest of Co. Longford,2008,85 years and over,43,23,66
Rest of Co. Longford,2008,Under 1 year,1,3,4
Rest of Co. Longford,2009,1 - 4 years,0,0,0
Rest of Co. Longford,2009,10 - 14 years,0,1,1
Rest of Co. Longford,2009,15 - 19 years,1,0,1
Rest of Co. Longford,2009,20 - 24 years,0,1,1
Rest of Co. Longford,2009,25 - 29 years,0,1,1
Rest of Co. Longford,2009,30 - 34 years,2,1,3
Rest of Co. Longford,2009,35 - 39 years,1,1,2
Rest of Co. Longford,2009,40 - 44 years,5,1,6
Rest of Co. Longford,2009,45 - 49 years,3,1,4
Rest of Co. Longford,2009,5 - 9 years,0,0,0
Rest of Co. Longford,2009,50 - 54 years,6,7,13
Rest of Co. Longford,2009,55 - 59 years,3,5,8
Rest of Co. Longford,2009,60 - 64 years,4,8,12
Rest of Co. Longford,2009,65 - 69 years,4,11,15
Rest of Co. Longford,2009,70 - 74 years,2,11,13
Rest of Co. Longford,2009,75 - 79 years,15,19,34
Rest of Co. Longford,2009,80 - 84 years,29,26,55
Rest of Co. Longford,2009,85 years and over,61,27,88
Rest of Co. Longford,2009,Under 1 year,1,3,4
Rest of Co. Longford,2010,1 - 4 years,0,0,0
Rest of Co. Longford,2010,10 - 14 years,0,1,1
Rest of Co. Longford,2010,15 - 19 years,1,1,2
Rest of Co. Longford,2010,20 - 24 years,0,2,2
Rest of Co. Longford,2010,25 - 29 years,0,1,1
Rest of Co. Longford,2010,30 - 34 years,1,2,3
Rest of Co. Longford,2010,35 - 39 years,1,1,2
Rest of Co. Longford,2010,40 - 44 years,1,1,2
Rest of Co. Longford,2010,45 - 49 years,3,2,5
Rest of Co. Longford,2010,5 - 9 years,0,0,0
Rest of Co. Longford,2010,50 - 54 years,3,1,4
Rest of Co. Longford,2010,55 - 59 years,6,4,10
Rest of Co. Longford,2010,60 - 64 years,5,6,11
Rest of Co. Longford,2010,65 - 69 years,5,7,12
Rest of Co. Longford,2010,70 - 74 years,7,13,20
Rest of Co. Longford,2010,75 - 79 years,10,20,30
Rest of Co. Longford,2010,80 - 84 years,22,18,40
Rest of Co. Longford,2010,85 years and over,55,28,83
Rest of Co. Longford,2010,Under 1 year,2,1,3
Rest of Co. Longford,2011,1 - 4 years,0,0,0
Rest of Co. Longford,2011,10 - 14 years,0,1,1
Rest of Co. Longford,2011,15 - 19 years,0,0,0
Rest of Co. Longford,2011,20 - 24 years,0,0,0
Rest of Co. Longford,2011,25 - 29 years,1,0,1
Rest of Co. Longford,2011,30 - 34 years,0,1,1
Rest of Co. Longford,2011,35 - 39 years,1,0,1
Rest of Co. Longford,2011,40 - 44 years,2,2,4
Rest of Co. Longford,2011,45 - 49 years,2,4,6
Rest of Co. Longford,2011,5 - 9 years,0,0,0
Rest of Co. Longford,2011,50 - 54 years,0,5,5
Rest of Co. Longford,2011,55 - 59 years,8,6,14
Rest of Co. Longford,2011,60 - 64 years,3,5,8
Rest of Co. Longford,2011,65 - 69 years,8,12,20
Rest of Co. Longford,2011,70 - 74 years,5,5,10
Rest of Co. Longford,2011,75 - 79 years,13,17,30
Rest of Co. Longford,2011,80 - 84 years,24,13,37
Rest of Co. Longford,2011,85 years and over,40,28,68
Rest of Co. Longford,2011,Under 1 year,1,0,1
Rest of Co. Longford,2012,1 - 4 years,0,0,0
Rest of Co. Longford,2012,10 - 14 years,0,1,1
Rest of Co. Longford,2012,15 - 19 years,0,0,0
Rest of Co. Longford,2012,20 - 24 years,0,0,0
Rest of Co. Longford,2012,25 - 29 years,2,0,2
Rest of Co. Longford,2012,30 - 34 years,0,1,1
Rest of Co. Longford,2012,35 - 39 years,1,3,4
Rest of Co. Longford,2012,40 - 44 years,1,1,2
Rest of Co. Longford,2012,45 - 49 years,1,3,4
Rest of Co. Longford,2012,5 - 9 years,0,0,0
Rest of Co. Longford,2012,50 - 54 years,1,4,5
Rest of Co. Longford,2012,55 - 59 years,3,9,12
Rest of Co. Longford,2012,60 - 64 years,7,8,15
Rest of Co. Longford,2012,65 - 69 years,7,11,18
Rest of Co. Longford,2012,70 - 74 years,5,18,23
Rest of Co. Longford,2012,75 - 79 years,12,22,34
Rest of Co. Longford,2012,80 - 84 years,14,21,35
Rest of Co. Longford,2012,85 years and over,43,35,78
Rest of Co. Longford,2012,Under 1 year,1,0,1
Rest of Co. Longford,2013,1 - 4 years,0,0,0
Rest of Co. Longford,2013,10 - 14 years,0,0,0
Rest of Co. Longford,2013,15 - 19 years,0,0,0
Rest of Co. Longford,2013,20 - 24 years,0,0,0
Rest of Co. Longford,2013,25 - 29 years,0,1,1
Rest of Co. Longford,2013,30 - 34 years,0,0,0
Rest of Co. Longford,2013,35 - 39 years,0,4,4
Rest of Co. Longford,2013,40 - 44 years,1,2,3
Rest of Co. Longford,2013,45 - 49 years,1,3,4
Rest of Co. Longford,2013,5 - 9 years,0,0,0
Rest of Co. Longford,2013,50 - 54 years,1,3,4
Rest of Co. Longford,2013,55 - 59 years,2,5,7
Rest of Co. Longford,2013,60 - 64 years,4,9,13
Rest of Co. Longford,2013,65 - 69 years,7,11,18
Rest of Co. Longford,2013,70 - 74 years,5,4,9
Rest of Co. Longford,2013,75 - 79 years,18,22,40
Rest of Co. Longford,2013,80 - 84 years,14,28,42
Rest of Co. Longford,2013,85 years and over,36,30,66
Rest of Co. Longford,2013,Under 1 year,0,1,1
Rest of Co. Longford,2014,1 - 4 years,0,0,0
Rest of Co. Longford,2014,10 - 14 years,1,0,1
Rest of Co. Longford,2014,15 - 19 years,0,0,0
Rest of Co. Longford,2014,20 - 24 years,0,2,2
Rest of Co. Longford,2014,25 - 29 years,0,1,1
Rest of Co. Longford,2014,30 - 34 years,1,0,1
Rest of Co. Longford,2014,35 - 39 years,1,4,5
Rest of Co. Longford,2014,40 - 44 years,1,2,3
Rest of Co. Longford,2014,45 - 49 years,3,1,4
Rest of Co. Longford,2014,5 - 9 years,0,0,0
Rest of Co. Longford,2014,50 - 54 years,4,2,6
Rest of Co. Longford,2014,55 - 59 years,3,4,7
Rest of Co. Longford,2014,60 - 64 years,5,4,9
Rest of Co. Longford,2014,65 - 69 years,6,9,15
Rest of Co. Longford,2014,70 - 74 years,3,10,13
Rest of Co. Longford,2014,75 - 79 years,9,15,24
Rest of Co. Longford,2014,80 - 84 years,13,15,28
Rest of Co. Longford,2014,85 years and over,42,23,65
Rest of Co. Longford,2014,Under 1 year,3,1,4
Rest of Co. Longford,2015,1 - 4 years,0,0,0
Rest of Co. Longford,2015,10 - 14 years,1,0,1
Rest of Co. Longford,2015,15 - 19 years,0,0,0
Rest of Co. Longford,2015,20 - 24 years,0,2,2
Rest of Co. Longford,2015,25 - 29 years,0,1,1
Rest of Co. Longford,2015,30 - 34 years,1,0,1
Rest of Co. Longford,2015,35 - 39 years,1,4,5
Rest of Co. Longford,2015,40 - 44 years,1,2,3
Rest of Co. Longford,2015,45 - 49 years,3,1,4
Rest of Co. Longford,2015,5 - 9 years,0,0,0
Rest of Co. Longford,2015,50 - 54 years,4,2,6
Rest of Co. Longford,2015,55 - 59 years,3,4,7
Rest of Co. Longford,2015,60 - 64 years,5,4,9
Rest of Co. Longford,2015,65 - 69 years,6,9,15
Rest of Co. Longford,2015,70 - 74 years,3,10,13
Rest of Co. Longford,2015,75 - 79 years,9,15,24
Rest of Co. Longford,2015,80 - 84 years,13,15,28
Rest of Co. Longford,2015,85 years and over,42,23,65
Rest of Co. Longford,2015,Under 1 year,3,1,4
Rest of Co. Longford,2016,1 - 4 years,0,0,0
Rest of Co. Longford,2016,10 - 14 years,1,0,1
Rest of Co. Longford,2016,15 - 19 years,0,0,0
Rest of Co. Longford,2016,20 - 24 years,0,2,2
Rest of Co. Longford,2016,25 - 29 years,0,1,1
Rest of Co. Longford,2016,30 - 34 years,1,0,1
Rest of Co. Longford,2016,35 - 39 years,1,4,5
Rest of Co. Longford,2016,40 - 44 years,1,2,3
Rest of Co. Longford,2016,45 - 49 years,3,1,4
Rest of Co. Longford,2016,5 - 9 years,0,0,0
Rest of Co. Longford,2016,50 - 54 years,4,2,6
Rest of Co. Longford,2016,55 - 59 years,3,4,7
Rest of Co. Longford,2016,60 - 64 years,5,4,9
Rest of Co. Longford,2016,65 - 69 years,6,9,15
Rest of Co. Longford,2016,70 - 74 years,3,10,13
Rest of Co. Longford,2016,75 - 79 years,9,15,24
Rest of Co. Longford,2016,80 - 84 years,13,15,28
Rest of Co. Longford,2016,85 years and over,42,23,65
Rest of Co. Longford,2016,Under 1 year,3,1,4
Rest of Co. Longford,2017,1 - 4 years,0,0,0
Rest of Co. Longford,2017,10 - 14 years,1,0,1
Rest of Co. Longford,2017,15 - 19 years,0,1,1
Rest of Co. Longford,2017,20 - 24 years,0,2,2
Rest of Co. Longford,2017,25 - 29 years,1,1,2
Rest of Co. Longford,2017,30 - 34 years,1,1,2
Rest of Co. Longford,2017,35 - 39 years,1,4,5
Rest of Co. Longford,2017,40 - 44 years,1,3,4
Rest of Co. Longford,2017,45 - 49 years,3,1,4
Rest of Co. Longford,2017,5 - 9 years,0,0,0
Rest of Co. Longford,2017,50 - 54 years,2,2,4
Rest of Co. Longford,2017,55 - 59 years,4,3,7
Rest of Co. Longford,2017,60 - 64 years,6,11,17
Rest of Co. Longford,2017,65 - 69 years,7,11,18
Rest of Co. Longford,2017,70 - 74 years,8,12,20
Rest of Co. Longford,2017,75 - 79 years,17,3,20
Rest of Co. Longford,2017,80 - 84 years,16,17,33
Rest of Co. Longford,2017,85 years and over,45,29,74
Rest of Co. Longford,2017,Under 1 year,2,1,3
Rest of Co. Longford,2018,1 - 4 years,0,0,0
Rest of Co. Longford,2018,10 - 14 years,0,1,1
Rest of Co. Longford,2018,15 - 19 years,0,1,1
Rest of Co. Longford,2018,20 - 24 years,0,0,0
Rest of Co. Longford,2018,25 - 29 years,2,1,3
Rest of Co. Longford,2018,30 - 34 years,2,0,2
Rest of Co. Longford,2018,35 - 39 years,0,0,0
Rest of Co. Longford,2018,40 - 44 years,1,0,1
Rest of Co. Longford,2018,45 - 49 years,3,0,3
Rest of Co. Longford,2018,5 - 9 years,0,0,0
Rest of Co. Longford,2018,50 - 54 years,3,3,6
Rest of Co. Longford,2018,55 - 59 years,1,4,5
Rest of Co. Longford,2018,60 - 64 years,4,8,12
Rest of Co. Longford,2018,65 - 69 years,2,12,14
Rest of Co. Longford,2018,70 - 74 years,7,7,14
Rest of Co. Longford,2018,75 - 79 years,9,14,23
Rest of Co. Longford,2018,80 - 84 years,17,20,37
Rest of Co. Longford,2018,85 years and over,35,33,68
Rest of Co. Longford,2018,Under 1 year,0,0,0
Rest of Co. Longford,2019,1 - 4 years,0,0,0
Rest of Co. Longford,2019,10 - 14 years,0,1,1
Rest of Co. Longford,2019,15 - 19 years,0,1,1
Rest of Co. Longford,2019,20 - 24 years,0,0,0
Rest of Co. Longford,2019,25 - 29 years,2,1,3
Rest of Co. Longford,2019,30 - 34 years,2,0,2
Rest of Co. Longford,2019,35 - 39 years,0,0,0
Rest of Co. Longford,2019,40 - 44 years,1,0,1
Rest of Co. Longford,2019,45 - 49 years,3,0,3
Rest of Co. Longford,2019,5 - 9 years,0,0,0
Rest of Co. Longford,2019,50 - 54 years,3,3,6
Rest of Co. Longford,2019,55 - 59 years,1,4,5
Rest of Co. Longford,2019,60 - 64 years,4,8,12
Rest of Co. Longford,2019,65 - 69 years,2,12,14
Rest of Co. Longford,2019,70 - 74 years,7,7,14
Rest of Co. Longford,2019,75 - 79 years,9,14,23
Rest of Co. Longford,2019,80 - 84 years,17,20,37
Rest of Co. Longford,2019,85 years and over,35,33,68
Rest of Co. Longford,2019,Under 1 year,0,0,0
Rest of Co. Longford,2020,1 - 4 years,0,0,0
Rest of Co. Longford,2020,10 - 14 years,0,1,1
Rest of Co. Longford,2020,15 - 19 years,0,1,1
Rest of Co. Longford,2020,20 - 24 years,0,0,0
Rest of Co. Longford,2020,25 - 29 years,2,1,3
Rest of Co. Longford,2020,30 - 34 years,2,0,2
Rest of Co. Longford,2020,35 - 39 years,0,0,0
Rest of Co. Longford,2020,40 - 44 years,1,0,1
Rest of Co. Longford,2020,45 - 49 years,3,0,3
Rest of Co. Longford,2020,5 - 9 years,0,0,0
Rest of Co. Longford,2020,50 - 54 years,3,3,6
Rest of Co. Longford,2020,55 - 59 years,1,4,5
Rest of Co. Longford,2020,60 - 64 years,4,8,12
Rest of Co. Longford,2020,65 - 69 years,2,12,14
Rest of Co. Longford,2020,70 - 74 years,7,7,14
Rest of Co. Longford,2020,75 - 79 years,9,14,23
Rest of Co. Longford,2020,80 - 84 years,17,20,37
Rest of Co. Longford,2020,85 years and over,35,33,68
Rest of Co. Longford,2020,Under 1 year,0,0,0
Rest of Co. Louth,2007,1 - 4 years,0,0,0
Rest of Co. Louth,2007,10 - 14 years,2,0,2
Rest of Co. Louth,2007,15 - 19 years,0,1,1
Rest of Co. Louth,2007,20 - 24 years,1,3,4
Rest of Co. Louth,2007,25 - 29 years,0,1,1
Rest of Co. Louth,2007,30 - 34 years,0,1,1
Rest of Co. Louth,2007,35 - 39 years,2,3,5
Rest of Co. Louth,2007,40 - 44 years,1,5,6
Rest of Co. Louth,2007,45 - 49 years,0,5,5
Rest of Co. Louth,2007,5 - 9 years,0,0,0
Rest of Co. Louth,2007,50 - 54 years,5,5,10
Rest of Co. Louth,2007,55 - 59 years,5,7,12
Rest of Co. Louth,2007,60 - 64 years,5,5,10
Rest of Co. Louth,2007,65 - 69 years,7,8,15
Rest of Co. Louth,2007,70 - 74 years,6,16,22
Rest of Co. Louth,2007,75 - 79 years,15,21,36
Rest of Co. Louth,2007,80 - 84 years,29,23,52
Rest of Co. Louth,2007,85 years and over,49,27,76
Rest of Co. Louth,2007,Under 1 year,1,0,1
Rest of Co. Louth,2008,1 - 4 years,0,0,0
Rest of Co. Louth,2008,10 - 14 years,2,0,2
Rest of Co. Louth,2008,15 - 19 years,0,1,1
Rest of Co. Louth,2008,20 - 24 years,1,2,3
Rest of Co. Louth,2008,25 - 29 years,0,1,1
Rest of Co. Louth,2008,30 - 34 years,0,1,1
Rest of Co. Louth,2008,35 - 39 years,2,3,5
Rest of Co. Louth,2008,40 - 44 years,1,2,3
Rest of Co. Louth,2008,45 - 49 years,1,2,3
Rest of Co. Louth,2008,5 - 9 years,0,0,0
Rest of Co. Louth,2008,50 - 54 years,2,4,6
Rest of Co. Louth,2008,55 - 59 years,3,8,11
Rest of Co. Louth,2008,60 - 64 years,1,8,9
Rest of Co. Louth,2008,65 - 69 years,4,13,17
Rest of Co. Louth,2008,70 - 74 years,10,10,20
Rest of Co. Louth,2008,75 - 79 years,13,22,35
Rest of Co. Louth,2008,80 - 84 years,26,15,41
Rest of Co. Louth,2008,85 years and over,45,27,72
Rest of Co. Louth,2008,Under 1 year,1,1,2
Rest of Co. Louth,2009,1 - 4 years,0,2,2
Rest of Co. Louth,2009,10 - 14 years,2,0,2
Rest of Co. Louth,2009,15 - 19 years,0,1,1
Rest of Co. Louth,2009,20 - 24 years,1,2,3
Rest of Co. Louth,2009,25 - 29 years,0,1,1
Rest of Co. Louth,2009,30 - 34 years,0,3,3
Rest of Co. Louth,2009,35 - 39 years,1,2,3
Rest of Co. Louth,2009,40 - 44 years,2,3,5
Rest of Co. Louth,2009,45 - 49 years,4,1,5
Rest of Co. Louth,2009,5 - 9 years,0,0,0
Rest of Co. Louth,2009,50 - 54 years,5,5,10
Rest of Co. Louth,2009,55 - 59 years,2,18,20
Rest of Co. Louth,2009,60 - 64 years,4,11,15
Rest of Co. Louth,2009,65 - 69 years,3,13,16
Rest of Co. Louth,2009,70 - 74 years,8,16,24
Rest of Co. Louth,2009,75 - 79 years,14,18,32
Rest of Co. Louth,2009,80 - 84 years,30,21,51
Rest of Co. Louth,2009,85 years and over,58,34,92
Rest of Co. Louth,2009,Under 1 year,1,2,3
Rest of Co. Louth,2010,1 - 4 years,0,2,2
Rest of Co. Louth,2010,10 - 14 years,2,0,2
Rest of Co. Louth,2010,15 - 19 years,1,1,2
Rest of Co. Louth,2010,20 - 24 years,1,4,5
Rest of Co. Louth,2010,25 - 29 years,0,3,3
Rest of Co. Louth,2010,30 - 34 years,0,1,1
Rest of Co. Louth,2010,35 - 39 years,1,1,2
Rest of Co. Louth,2010,40 - 44 years,1,4,5
Rest of Co. Louth,2010,45 - 49 years,2,5,7
Rest of Co. Louth,2010,5 - 9 years,0,2,2
Rest of Co. Louth,2010,50 - 54 years,2,3,5
Rest of Co. Louth,2010,55 - 59 years,4,10,14
Rest of Co. Louth,2010,60 - 64 years,9,6,15
Rest of Co. Louth,2010,65 - 69 years,19,9,28
Rest of Co. Louth,2010,70 - 74 years,10,12,22
Rest of Co. Louth,2010,75 - 79 years,12,18,30
Rest of Co. Louth,2010,80 - 84 years,16,32,48
Rest of Co. Louth,2010,85 years and over,74,41,115
Rest of Co. Louth,2010,Under 1 year,1,1,2
Rest of Co. Louth,2011,1 - 4 years,1,0,1
Rest of Co. Louth,2011,10 - 14 years,0,0,0
Rest of Co. Louth,2011,15 - 19 years,0,0,0
Rest of Co. Louth,2011,20 - 24 years,0,2,2
Rest of Co. Louth,2011,25 - 29 years,1,2,3
Rest of Co. Louth,2011,30 - 34 years,2,1,3
Rest of Co. Louth,2011,35 - 39 years,3,4,7
Rest of Co. Louth,2011,40 - 44 years,1,3,4
Rest of Co. Louth,2011,45 - 49 years,1,5,6
Rest of Co. Louth,2011,5 - 9 years,0,0,0
Rest of Co. Louth,2011,50 - 54 years,7,2,9
Rest of Co. Louth,2011,55 - 59 years,6,4,10
Rest of Co. Louth,2011,60 - 64 years,12,14,26
Rest of Co. Louth,2011,65 - 69 years,11,10,21
Rest of Co. Louth,2011,70 - 74 years,11,16,27
Rest of Co. Louth,2011,75 - 79 years,21,16,37
Rest of Co. Louth,2011,80 - 84 years,26,30,56
Rest of Co. Louth,2011,85 years and over,82,35,117
Rest of Co. Louth,2011,Under 1 year,2,1,3
Rest of Co. Louth,2012,1 - 4 years,1,0,1
Rest of Co. Louth,2012,10 - 14 years,0,0,0
Rest of Co. Louth,2012,15 - 19 years,0,0,0
Rest of Co. Louth,2012,20 - 24 years,0,2,2
Rest of Co. Louth,2012,25 - 29 years,1,1,2
Rest of Co. Louth,2012,30 - 34 years,2,1,3
Rest of Co. Louth,2012,35 - 39 years,2,3,5
Rest of Co. Louth,2012,40 - 44 years,1,1,2
Rest of Co. Louth,2012,45 - 49 years,3,4,7
Rest of Co. Louth,2012,5 - 9 years,1,1,2
Rest of Co. Louth,2012,50 - 54 years,4,10,14
Rest of Co. Louth,2012,55 - 59 years,3,9,12
Rest of Co. Louth,2012,60 - 64 years,2,7,9
Rest of Co. Louth,2012,65 - 69 years,10,15,25
Rest of Co. Louth,2012,70 - 74 years,7,15,22
Rest of Co. Louth,2012,75 - 79 years,15,35,50
Rest of Co. Louth,2012,80 - 84 years,24,23,47
Rest of Co. Louth,2012,85 years and over,66,34,100
Rest of Co. Louth,2012,Under 1 year,2,1,3
Rest of Co. Louth,2013,1 - 4 years,0,0,0
Rest of Co. Louth,2013,10 - 14 years,0,0,0
Rest of Co. Louth,2013,15 - 19 years,0,1,1
Rest of Co. Louth,2013,20 - 24 years,0,1,1
Rest of Co. Louth,2013,25 - 29 years,1,0,1
Rest of Co. Louth,2013,30 - 34 years,1,1,2
Rest of Co. Louth,2013,35 - 39 years,1,3,4
Rest of Co. Louth,2013,40 - 44 years,0,2,2
Rest of Co. Louth,2013,45 - 49 years,0,4,4
Rest of Co. Louth,2013,5 - 9 years,0,0,0
Rest of Co. Louth,2013,50 - 54 years,5,4,9
Rest of Co. Louth,2013,55 - 59 years,6,6,12
Rest of Co. Louth,2013,60 - 64 years,2,15,17
Rest of Co. Louth,2013,65 - 69 years,7,15,22
Rest of Co. Louth,2013,70 - 74 years,5,25,30
Rest of Co. Louth,2013,75 - 79 years,13,20,33
Rest of Co. Louth,2013,80 - 84 years,18,17,35
Rest of Co. Louth,2013,85 years and over,62,23,85
Rest of Co. Louth,2013,Under 1 year,0,0,0
Rest of Co. Louth,2014,1 - 4 years,0,0,0
Rest of Co. Louth,2014,10 - 14 years,1,0,1
Rest of Co. Louth,2014,15 - 19 years,0,1,1
Rest of Co. Louth,2014,20 - 24 years,1,2,3
Rest of Co. Louth,2014,25 - 29 years,1,0,1
Rest of Co. Louth,2014,30 - 34 years,1,3,4
Rest of Co. Louth,2014,35 - 39 years,2,3,5
Rest of Co. Louth,2014,40 - 44 years,2,1,3
Rest of Co. Louth,2014,45 - 49 years,1,4,5
Rest of Co. Louth,2014,5 - 9 years,1,0,1
Rest of Co. Louth,2014,50 - 54 years,5,4,9
Rest of Co. Louth,2014,55 - 59 years,2,8,10
Rest of Co. Louth,2014,60 - 64 years,4,7,11
Rest of Co. Louth,2014,65 - 69 years,7,13,20
Rest of Co. Louth,2014,70 - 74 years,7,15,22
Rest of Co. Louth,2014,75 - 79 years,22,14,36
Rest of Co. Louth,2014,80 - 84 years,15,25,40
Rest of Co. Louth,2014,85 years and over,52,24,76
Rest of Co. Louth,2014,Under 1 year,1,5,6
Rest of Co. Louth,2015,1 - 4 years,0,0,0
Rest of Co. Louth,2015,10 - 14 years,1,0,1
Rest of Co. Louth,2015,15 - 19 years,0,1,1
Rest of Co. Louth,2015,20 - 24 years,1,2,3
Rest of Co. Louth,2015,25 - 29 years,1,0,1
Rest of Co. Louth,2015,30 - 34 years,1,3,4
Rest of Co. Louth,2015,35 - 39 years,2,3,5
Rest of Co. Louth,2015,40 - 44 years,2,1,3
Rest of Co. Louth,2015,45 - 49 years,1,4,5
Rest of Co. Louth,2015,5 - 9 years,1,0,1
Rest of Co. Louth,2015,50 - 54 years,5,4,9
Rest of Co. Louth,2015,55 - 59 years,2,8,10
Rest of Co. Louth,2015,60 - 64 years,4,7,11
Rest of Co. Louth,2015,65 - 69 years,7,13,20
Rest of Co. Louth,2015,70 - 74 years,7,15,22
Rest of Co. Louth,2015,75 - 79 years,22,14,36
Rest of Co. Louth,2015,80 - 84 years,15,25,40
Rest of Co. Louth,2015,85 years and over,52,24,76
Rest of Co. Louth,2015,Under 1 year,1,5,6
Rest of Co. Louth,2016,1 - 4 years,0,0,0
Rest of Co. Louth,2016,10 - 14 years,1,0,1
Rest of Co. Louth,2016,15 - 19 years,0,1,1
Rest of Co. Louth,2016,20 - 24 years,1,2,3
Rest of Co. Louth,2016,25 - 29 years,1,0,1
Rest of Co. Louth,2016,30 - 34 years,1,3,4
Rest of Co. Louth,2016,35 - 39 years,2,3,5
Rest of Co. Louth,2016,40 - 44 years,2,1,3
Rest of Co. Louth,2016,45 - 49 years,1,4,5
Rest of Co. Louth,2016,5 - 9 years,1,0,1
Rest of Co. Louth,2016,50 - 54 years,5,4,9
Rest of Co. Louth,2016,55 - 59 years,2,8,10
Rest of Co. Louth,2016,60 - 64 years,4,7,11
Rest of Co. Louth,2016,65 - 69 years,7,13,20
Rest of Co. Louth,2016,70 - 74 years,7,15,22
Rest of Co. Louth,2016,75 - 79 years,22,14,36
Rest of Co. Louth,2016,80 - 84 years,15,25,40
Rest of Co. Louth,2016,85 years and over,52,24,76
Rest of Co. Louth,2016,Under 1 year,1,5,6
Rest of Co. Louth,2017,1 - 4 years,0,0,0
Rest of Co. Louth,2017,10 - 14 years,1,1,2
Rest of Co. Louth,2017,15 - 19 years,0,1,1
Rest of Co. Louth,2017,20 - 24 years,1,1,2
Rest of Co. Louth,2017,25 - 29 years,1,1,2
Rest of Co. Louth,2017,30 - 34 years,1,1,2
Rest of Co. Louth,2017,35 - 39 years,2,2,4
Rest of Co. Louth,2017,40 - 44 years,2,1,3
Rest of Co. Louth,2017,45 - 49 years,5,3,8
Rest of Co. Louth,2017,5 - 9 years,1,0,1
Rest of Co. Louth,2017,50 - 54 years,3,7,10
Rest of Co. Louth,2017,55 - 59 years,6,6,12
Rest of Co. Louth,2017,60 - 64 years,3,7,10
Rest of Co. Louth,2017,65 - 69 years,9,9,18
Rest of Co. Louth,2017,70 - 74 years,14,23,37
Rest of Co. Louth,2017,75 - 79 years,14,21,35
Rest of Co. Louth,2017,80 - 84 years,24,31,55
Rest of Co. Louth,2017,85 years and over,69,35,104
Rest of Co. Louth,2017,Under 1 year,1,5,6
Rest of Co. Louth,2018,1 - 4 years,2,0,2
Rest of Co. Louth,2018,10 - 14 years,0,0,0
Rest of Co. Louth,2018,15 - 19 years,0,0,0
Rest of Co. Louth,2018,20 - 24 years,1,0,1
Rest of Co. Louth,2018,25 - 29 years,0,0,0
Rest of Co. Louth,2018,30 - 34 years,2,0,2
Rest of Co. Louth,2018,35 - 39 years,0,3,3
Rest of Co. Louth,2018,40 - 44 years,2,1,3
Rest of Co. Louth,2018,45 - 49 years,4,2,6
Rest of Co. Louth,2018,5 - 9 years,0,0,0
Rest of Co. Louth,2018,50 - 54 years,1,5,6
Rest of Co. Louth,2018,55 - 59 years,8,3,11
Rest of Co. Louth,2018,60 - 64 years,4,14,18
Rest of Co. Louth,2018,65 - 69 years,12,17,29
Rest of Co. Louth,2018,70 - 74 years,11,25,36
Rest of Co. Louth,2018,75 - 79 years,17,17,34
Rest of Co. Louth,2018,80 - 84 years,29,15,44
Rest of Co. Louth,2018,85 years and over,51,29,80
Rest of Co. Louth,2018,Under 1 year,2,2,4
Rest of Co. Louth,2019,1 - 4 years,2,0,2
Rest of Co. Louth,2019,10 - 14 years,0,0,0
Rest of Co. Louth,2019,15 - 19 years,0,0,0
Rest of Co. Louth,2019,20 - 24 years,1,0,1
Rest of Co. Louth,2019,25 - 29 years,0,0,0
Rest of Co. Louth,2019,30 - 34 years,2,0,2
Rest of Co. Louth,2019,35 - 39 years,0,3,3
Rest of Co. Louth,2019,40 - 44 years,2,1,3
Rest of Co. Louth,2019,45 - 49 years,4,2,6
Rest of Co. Louth,2019,5 - 9 years,0,0,0
Rest of Co. Louth,2019,50 - 54 years,1,5,6
Rest of Co. Louth,2019,55 - 59 years,8,3,11
Rest of Co. Louth,2019,60 - 64 years,4,14,18
Rest of Co. Louth,2019,65 - 69 years,12,17,29
Rest of Co. Louth,2019,70 - 74 years,11,25,36
Rest of Co. Louth,2019,75 - 79 years,17,17,34
Rest of Co. Louth,2019,80 - 84 years,29,15,44
Rest of Co. Louth,2019,85 years and over,51,29,80
Rest of Co. Louth,2019,Under 1 year,2,2,4
Rest of Co. Louth,2020,1 - 4 years,2,0,2
Rest of Co. Louth,2020,10 - 14 years,0,0,0
Rest of Co. Louth,2020,15 - 19 years,0,0,0
Rest of Co. Louth,2020,20 - 24 years,1,0,1
Rest of Co. Louth,2020,25 - 29 years,0,0,0
Rest of Co. Louth,2020,30 - 34 years,2,0,2
Rest of Co. Louth,2020,35 - 39 years,0,3,3
Rest of Co. Louth,2020,40 - 44 years,2,1,3
Rest of Co. Louth,2020,45 - 49 years,4,2,6
Rest of Co. Louth,2020,5 - 9 years,0,0,0
Rest of Co. Louth,2020,50 - 54 years,1,5,6
Rest of Co. Louth,2020,55 - 59 years,8,3,11
Rest of Co. Louth,2020,60 - 64 years,4,14,18
Rest of Co. Louth,2020,65 - 69 years,12,17,29
Rest of Co. Louth,2020,70 - 74 years,11,25,36
Rest of Co. Louth,2020,75 - 79 years,17,17,34
Rest of Co. Louth,2020,80 - 84 years,29,15,44
Rest of Co. Louth,2020,85 years and over,51,29,80
Rest of Co. Louth,2020,Under 1 year,2,2,4
Rest of Co. Mayo,2007,1 - 4 years,0,2,2
Rest of Co. Mayo,2007,10 - 14 years,0,0,0
Rest of Co. Mayo,2007,15 - 19 years,2,2,4
Rest of Co. Mayo,2007,20 - 24 years,1,3,4
Rest of Co. Mayo,2007,25 - 29 years,0,4,4
Rest of Co. Mayo,2007,30 - 34 years,2,3,5
Rest of Co. Mayo,2007,35 - 39 years,0,3,3
Rest of Co. Mayo,2007,40 - 44 years,3,3,6
Rest of Co. Mayo,2007,45 - 49 years,5,8,13
Rest of Co. Mayo,2007,5 - 9 years,0,0,0
Rest of Co. Mayo,2007,50 - 54 years,4,10,14
Rest of Co. Mayo,2007,55 - 59 years,8,29,37
Rest of Co. Mayo,2007,60 - 64 years,8,29,37
Rest of Co. Mayo,2007,65 - 69 years,15,24,39
Rest of Co. Mayo,2007,70 - 74 years,23,41,64
Rest of Co. Mayo,2007,75 - 79 years,45,71,116
Rest of Co. Mayo,2007,80 - 84 years,63,78,141
Rest of Co. Mayo,2007,85 years and over,158,92,250
Rest of Co. Mayo,2007,Under 1 year,2,3,5
Rest of Co. Mayo,2008,1 - 4 years,1,1,2
Rest of Co. Mayo,2008,10 - 14 years,1,1,2
Rest of Co. Mayo,2008,15 - 19 years,1,1,2
Rest of Co. Mayo,2008,20 - 24 years,1,2,3
Rest of Co. Mayo,2008,25 - 29 years,2,1,3
Rest of Co. Mayo,2008,30 - 34 years,2,1,3
Rest of Co. Mayo,2008,35 - 39 years,1,3,4
Rest of Co. Mayo,2008,40 - 44 years,4,6,10
Rest of Co. Mayo,2008,45 - 49 years,8,5,13
Rest of Co. Mayo,2008,5 - 9 years,0,0,0
Rest of Co. Mayo,2008,50 - 54 years,7,18,25
Rest of Co. Mayo,2008,55 - 59 years,13,18,31
Rest of Co. Mayo,2008,60 - 64 years,14,20,34
Rest of Co. Mayo,2008,65 - 69 years,16,47,63
Rest of Co. Mayo,2008,70 - 74 years,18,49,67
Rest of Co. Mayo,2008,75 - 79 years,51,59,110
Rest of Co. Mayo,2008,80 - 84 years,55,83,138
Rest of Co. Mayo,2008,85 years and over,153,85,238
Rest of Co. Mayo,2008,Under 1 year,2,2,4
Rest of Co. Mayo,2009,1 - 4 years,1,1,2
Rest of Co. Mayo,2009,10 - 14 years,1,1,2
Rest of Co. Mayo,2009,15 - 19 years,1,5,6
Rest of Co. Mayo,2009,20 - 24 years,1,2,3
Rest of Co. Mayo,2009,25 - 29 years,2,2,4
Rest of Co. Mayo,2009,30 - 34 years,2,2,4
Rest of Co. Mayo,2009,35 - 39 years,1,7,8
Rest of Co. Mayo,2009,40 - 44 years,2,6,8
Rest of Co. Mayo,2009,45 - 49 years,4,11,15
Rest of Co. Mayo,2009,5 - 9 years,0,0,0
Rest of Co. Mayo,2009,50 - 54 years,9,13,22
Rest of Co. Mayo,2009,55 - 59 years,5,24,29
Rest of Co. Mayo,2009,60 - 64 years,11,41,52
Rest of Co. Mayo,2009,65 - 69 years,17,38,55
Rest of Co. Mayo,2009,70 - 74 years,32,46,78
Rest of Co. Mayo,2009,75 - 79 years,27,73,100
Rest of Co. Mayo,2009,80 - 84 years,75,77,152
Rest of Co. Mayo,2009,85 years and over,178,112,290
Rest of Co. Mayo,2009,Under 1 year,1,1,2
Rest of Co. Mayo,2010,1 - 4 years,1,1,2
Rest of Co. Mayo,2010,10 - 14 years,1,1,2
Rest of Co. Mayo,2010,15 - 19 years,4,2,6
Rest of Co. Mayo,2010,20 - 24 years,1,3,4
Rest of Co. Mayo,2010,25 - 29 years,1,3,4
Rest of Co. Mayo,2010,30 - 34 years,1,3,4
Rest of Co. Mayo,2010,35 - 39 years,1,3,4
Rest of Co. Mayo,2010,40 - 44 years,4,7,11
Rest of Co. Mayo,2010,45 - 49 years,4,9,13
Rest of Co. Mayo,2010,5 - 9 years,0,1,1
Rest of Co. Mayo,2010,50 - 54 years,9,19,28
Rest of Co. Mayo,2010,55 - 59 years,12,18,30
Rest of Co. Mayo,2010,60 - 64 years,15,33,48
Rest of Co. Mayo,2010,65 - 69 years,28,47,75
Rest of Co. Mayo,2010,70 - 74 years,33,44,77
Rest of Co. Mayo,2010,75 - 79 years,42,76,118
Rest of Co. Mayo,2010,80 - 84 years,74,66,140
Rest of Co. Mayo,2010,85 years and over,203,139,342
Rest of Co. Mayo,2010,Under 1 year,1,3,4
Rest of Co. Mayo,2011,1 - 4 years,0,1,1
Rest of Co. Mayo,2011,10 - 14 years,0,0,0
Rest of Co. Mayo,2011,15 - 19 years,2,3,5
Rest of Co. Mayo,2011,20 - 24 years,1,4,5
Rest of Co. Mayo,2011,25 - 29 years,1,5,6
Rest of Co. Mayo,2011,30 - 34 years,1,3,4
Rest of Co. Mayo,2011,35 - 39 years,1,8,9
Rest of Co. Mayo,2011,40 - 44 years,3,4,7
Rest of Co. Mayo,2011,45 - 49 years,8,6,14
Rest of Co. Mayo,2011,5 - 9 years,0,0,0
Rest of Co. Mayo,2011,50 - 54 years,7,9,16
Rest of Co. Mayo,2011,55 - 59 years,13,22,35
Rest of Co. Mayo,2011,60 - 64 years,12,37,49
Rest of Co. Mayo,2011,65 - 69 years,13,36,49
Rest of Co. Mayo,2011,70 - 74 years,15,40,55
Rest of Co. Mayo,2011,75 - 79 years,43,75,118
Rest of Co. Mayo,2011,80 - 84 years,62,74,136
Rest of Co. Mayo,2011,85 years and over,233,117,350
Rest of Co. Mayo,2011,Under 1 year,1,3,4
Rest of Co. Mayo,2012,1 - 4 years,1,1,2
Rest of Co. Mayo,2012,10 - 14 years,0,0,0
Rest of Co. Mayo,2012,15 - 19 years,2,1,3
Rest of Co. Mayo,2012,20 - 24 years,1,5,6
Rest of Co. Mayo,2012,25 - 29 years,1,1,2
Rest of Co. Mayo,2012,30 - 34 years,3,6,9
Rest of Co. Mayo,2012,35 - 39 years,5,6,11
Rest of Co. Mayo,2012,40 - 44 years,6,7,13
Rest of Co. Mayo,2012,45 - 49 years,3,5,8
Rest of Co. Mayo,2012,5 - 9 years,0,0,0
Rest of Co. Mayo,2012,50 - 54 years,10,12,22
Rest of Co. Mayo,2012,55 - 59 years,8,17,25
Rest of Co. Mayo,2012,60 - 64 years,16,21,37
Rest of Co. Mayo,2012,65 - 69 years,23,33,56
Rest of Co. Mayo,2012,70 - 74 years,36,44,80
Rest of Co. Mayo,2012,75 - 79 years,40,57,97
Rest of Co. Mayo,2012,80 - 84 years,74,93,167
Rest of Co. Mayo,2012,85 years and over,187,124,311
Rest of Co. Mayo,2012,Under 1 year,2,3,5
Rest of Co. Mayo,2013,1 - 4 years,0,1,1
Rest of Co. Mayo,2013,10 - 14 years,0,1,1
Rest of Co. Mayo,2013,15 - 19 years,0,1,1
Rest of Co. Mayo,2013,20 - 24 years,2,1,3
Rest of Co. Mayo,2013,25 - 29 years,3,4,7
Rest of Co. Mayo,2013,30 - 34 years,1,1,2
Rest of Co. Mayo,2013,35 - 39 years,0,5,5
Rest of Co. Mayo,2013,40 - 44 years,1,1,2
Rest of Co. Mayo,2013,45 - 49 years,2,4,6
Rest of Co. Mayo,2013,5 - 9 years,0,0,0
Rest of Co. Mayo,2013,50 - 54 years,9,13,22
Rest of Co. Mayo,2013,55 - 59 years,14,23,37
Rest of Co. Mayo,2013,60 - 64 years,27,34,61
Rest of Co. Mayo,2013,65 - 69 years,24,44,68
Rest of Co. Mayo,2013,70 - 74 years,36,46,82
Rest of Co. Mayo,2013,75 - 79 years,44,64,108
Rest of Co. Mayo,2013,80 - 84 years,57,90,147
Rest of Co. Mayo,2013,85 years and over,221,143,364
Rest of Co. Mayo,2013,Under 1 year,2,1,3
Rest of Co. Mayo,2014,1 - 4 years,0,1,1
Rest of Co. Mayo,2014,10 - 14 years,0,1,1
Rest of Co. Mayo,2014,15 - 19 years,0,1,1
Rest of Co. Mayo,2014,20 - 24 years,1,2,3
Rest of Co. Mayo,2014,25 - 29 years,3,5,8
Rest of Co. Mayo,2014,30 - 34 years,2,1,3
Rest of Co. Mayo,2014,35 - 39 years,1,5,6
Rest of Co. Mayo,2014,40 - 44 years,1,6,7
Rest of Co. Mayo,2014,45 - 49 years,5,5,10
Rest of Co. Mayo,2014,5 - 9 years,0,1,1
Rest of Co. Mayo,2014,50 - 54 years,7,14,21
Rest of Co. Mayo,2014,55 - 59 years,8,16,24
Rest of Co. Mayo,2014,60 - 64 years,15,31,46
Rest of Co. Mayo,2014,65 - 69 years,16,34,50
Rest of Co. Mayo,2014,70 - 74 years,23,57,80
Rest of Co. Mayo,2014,75 - 79 years,42,68,110
Rest of Co. Mayo,2014,80 - 84 years,70,79,149
Rest of Co. Mayo,2014,85 years and over,201,128,329
Rest of Co. Mayo,2014,Under 1 year,5,3,8
Rest of Co. Mayo,2015,1 - 4 years,0,1,1
Rest of Co. Mayo,2015,10 - 14 years,0,1,1
Rest of Co. Mayo,2015,15 - 19 years,0,1,1
Rest of Co. Mayo,2015,20 - 24 years,1,2,3
Rest of Co. Mayo,2015,25 - 29 years,3,5,8
Rest of Co. Mayo,2015,30 - 34 years,2,1,3
Rest of Co. Mayo,2015,35 - 39 years,1,5,6
Rest of Co. Mayo,2015,40 - 44 years,1,6,7
Rest of Co. Mayo,2015,45 - 49 years,5,5,10
Rest of Co. Mayo,2015,5 - 9 years,0,1,1
Rest of Co. Mayo,2015,50 - 54 years,7,14,21
Rest of Co. Mayo,2015,55 - 59 years,8,16,24
Rest of Co. Mayo,2015,60 - 64 years,15,31,46
Rest of Co. Mayo,2015,65 - 69 years,16,34,50
Rest of Co. Mayo,2015,70 - 74 years,23,57,80
Rest of Co. Mayo,2015,75 - 79 years,42,68,110
Rest of Co. Mayo,2015,80 - 84 years,70,79,149
Rest of Co. Mayo,2015,85 years and over,201,128,329
Rest of Co. Mayo,2015,Under 1 year,5,3,8
Rest of Co. Mayo,2016,1 - 4 years,0,1,1
Rest of Co. Mayo,2016,10 - 14 years,0,1,1
Rest of Co. Mayo,2016,15 - 19 years,0,1,1
Rest of Co. Mayo,2016,20 - 24 years,1,2,3
Rest of Co. Mayo,2016,25 - 29 years,3,5,8
Rest of Co. Mayo,2016,30 - 34 years,2,1,3
Rest of Co. Mayo,2016,35 - 39 years,1,5,6
Rest of Co. Mayo,2016,40 - 44 years,1,6,7
Rest of Co. Mayo,2016,45 - 49 years,5,5,10
Rest of Co. Mayo,2016,5 - 9 years,0,1,1
Rest of Co. Mayo,2016,50 - 54 years,7,14,21
Rest of Co. Mayo,2016,55 - 59 years,8,16,24
Rest of Co. Mayo,2016,60 - 64 years,15,31,46
Rest of Co. Mayo,2016,65 - 69 years,16,34,50
Rest of Co. Mayo,2016,70 - 74 years,23,57,80
Rest of Co. Mayo,2016,75 - 79 years,42,68,110
Rest of Co. Mayo,2016,80 - 84 years,70,79,149
Rest of Co. Mayo,2016,85 years and over,201,128,329
Rest of Co. Mayo,2016,Under 1 year,5,3,8
Rest of Co. Mayo,2017,1 - 4 years,0,1,1
Rest of Co. Mayo,2017,10 - 14 years,1,1,2
Rest of Co. Mayo,2017,15 - 19 years,0,1,1
Rest of Co. Mayo,2017,20 - 24 years,1,3,4
Rest of Co. Mayo,2017,25 - 29 years,3,6,9
Rest of Co. Mayo,2017,30 - 34 years,1,2,3
Rest of Co. Mayo,2017,35 - 39 years,3,4,7
Rest of Co. Mayo,2017,40 - 44 years,5,5,10
Rest of Co. Mayo,2017,45 - 49 years,5,3,8
Rest of Co. Mayo,2017,5 - 9 years,0,1,1
Rest of Co. Mayo,2017,50 - 54 years,7,10,17
Rest of Co. Mayo,2017,55 - 59 years,12,12,24
Rest of Co. Mayo,2017,60 - 64 years,19,27,46
Rest of Co. Mayo,2017,65 - 69 years,20,36,56
Rest of Co. Mayo,2017,70 - 74 years,26,58,84
Rest of Co. Mayo,2017,75 - 79 years,49,65,114
Rest of Co. Mayo,2017,80 - 84 years,63,78,141
Rest of Co. Mayo,2017,85 years and over,198,132,330
Rest of Co. Mayo,2017,Under 1 year,5,1,6
Rest of Co. Mayo,2018,1 - 4 years,0,0,0
Rest of Co. Mayo,2018,10 - 14 years,0,1,1
Rest of Co. Mayo,2018,15 - 19 years,0,0,0
Rest of Co. Mayo,2018,20 - 24 years,0,1,1
Rest of Co. Mayo,2018,25 - 29 years,1,3,4
Rest of Co. Mayo,2018,30 - 34 years,1,0,1
Rest of Co. Mayo,2018,35 - 39 years,0,2,2
Rest of Co. Mayo,2018,40 - 44 years,3,2,5
Rest of Co. Mayo,2018,45 - 49 years,6,5,11
Rest of Co. Mayo,2018,5 - 9 years,0,1,1
Rest of Co. Mayo,2018,50 - 54 years,11,7,18
Rest of Co. Mayo,2018,55 - 59 years,10,19,29
Rest of Co. Mayo,2018,60 - 64 years,14,29,43
Rest of Co. Mayo,2018,65 - 69 years,24,40,64
Rest of Co. Mayo,2018,70 - 74 years,30,65,95
Rest of Co. Mayo,2018,75 - 79 years,34,71,105
Rest of Co. Mayo,2018,80 - 84 years,54,83,137
Rest of Co. Mayo,2018,85 years and over,194,135,329
Rest of Co. Mayo,2018,Under 1 year,1,1,2
Rest of Co. Mayo,2019,1 - 4 years,0,0,0
Rest of Co. Mayo,2019,10 - 14 years,0,1,1
Rest of Co. Mayo,2019,15 - 19 years,0,0,0
Rest of Co. Mayo,2019,20 - 24 years,0,1,1
Rest of Co. Mayo,2019,25 - 29 years,1,3,4
Rest of Co. Mayo,2019,30 - 34 years,1,0,1
Rest of Co. Mayo,2019,35 - 39 years,0,2,2
Rest of Co. Mayo,2019,40 - 44 years,3,2,5
Rest of Co. Mayo,2019,45 - 49 years,6,5,11
Rest of Co. Mayo,2019,5 - 9 years,0,1,1
Rest of Co. Mayo,2019,50 - 54 years,11,7,18
Rest of Co. Mayo,2019,55 - 59 years,10,19,29
Rest of Co. Mayo,2019,60 - 64 years,14,29,43
Rest of Co. Mayo,2019,65 - 69 years,24,40,64
Rest of Co. Mayo,2019,70 - 74 years,30,65,95
Rest of Co. Mayo,2019,75 - 79 years,34,71,105
Rest of Co. Mayo,2019,80 - 84 years,54,83,137
Rest of Co. Mayo,2019,85 years and over,194,135,329
Rest of Co. Mayo,2019,Under 1 year,1,1,2
Rest of Co. Mayo,2020,1 - 4 years,0,0,0
Rest of Co. Mayo,2020,10 - 14 years,0,1,1
Rest of Co. Mayo,2020,15 - 19 years,0,0,0
Rest of Co. Mayo,2020,20 - 24 years,0,1,1
Rest of Co. Mayo,2020,25 - 29 years,1,3,4
Rest of Co. Mayo,2020,30 - 34 years,1,0,1
Rest of Co. Mayo,2020,35 - 39 years,0,2,2
Rest of Co. Mayo,2020,40 - 44 years,3,2,5
Rest of Co. Mayo,2020,45 - 49 years,6,5,11
Rest of Co. Mayo,2020,5 - 9 years,0,1,1
Rest of Co. Mayo,2020,50 - 54 years,11,7,18
Rest of Co. Mayo,2020,55 - 59 years,10,19,29
Rest of Co. Mayo,2020,60 - 64 years,14,29,43
Rest of Co. Mayo,2020,65 - 69 years,24,40,64
Rest of Co. Mayo,2020,70 - 74 years,30,65,95
Rest of Co. Mayo,2020,75 - 79 years,34,71,105
Rest of Co. Mayo,2020,80 - 84 years,54,83,137
Rest of Co. Mayo,2020,85 years and over,194,135,329
Rest of Co. Mayo,2020,Under 1 year,1,1,2
Rest of Co. Meath,2007,1 - 4 years,2,0,2
Rest of Co. Meath,2007,10 - 14 years,0,1,1
Rest of Co. Meath,2007,15 - 19 years,1,4,5
Rest of Co. Meath,2007,20 - 24 years,0,4,4
Rest of Co. Meath,2007,25 - 29 years,1,2,3
Rest of Co. Meath,2007,30 - 34 years,2,4,6
Rest of Co. Meath,2007,35 - 39 years,1,4,5
Rest of Co. Meath,2007,40 - 44 years,5,4,9
Rest of Co. Meath,2007,45 - 49 years,5,9,14
Rest of Co. Meath,2007,5 - 9 years,0,0,0
Rest of Co. Meath,2007,50 - 54 years,3,10,13
Rest of Co. Meath,2007,55 - 59 years,9,14,23
Rest of Co. Meath,2007,60 - 64 years,9,23,32
Rest of Co. Meath,2007,65 - 69 years,13,21,34
Rest of Co. Meath,2007,70 - 74 years,17,30,47
Rest of Co. Meath,2007,75 - 79 years,24,36,60
Rest of Co. Meath,2007,80 - 84 years,34,52,86
Rest of Co. Meath,2007,85 years and over,101,46,147
Rest of Co. Meath,2007,Under 1 year,5,7,12
Rest of Co. Meath,2008,1 - 4 years,2,2,4
Rest of Co. Meath,2008,10 - 14 years,0,1,1
Rest of Co. Meath,2008,15 - 19 years,3,4,7
Rest of Co. Meath,2008,20 - 24 years,0,2,2
Rest of Co. Meath,2008,25 - 29 years,1,6,7
Rest of Co. Meath,2008,30 - 34 years,2,5,7
Rest of Co. Meath,2008,35 - 39 years,1,4,5
Rest of Co. Meath,2008,40 - 44 years,4,2,6
Rest of Co. Meath,2008,45 - 49 years,6,6,12
Rest of Co. Meath,2008,5 - 9 years,0,0,0
Rest of Co. Meath,2008,50 - 54 years,7,15,22
Rest of Co. Meath,2008,55 - 59 years,3,19,22
Rest of Co. Meath,2008,60 - 64 years,13,27,40
Rest of Co. Meath,2008,65 - 69 years,9,21,30
Rest of Co. Meath,2008,70 - 74 years,21,35,56
Rest of Co. Meath,2008,75 - 79 years,27,33,60
Rest of Co. Meath,2008,80 - 84 years,43,38,81
Rest of Co. Meath,2008,85 years and over,91,63,154
Rest of Co. Meath,2008,Under 1 year,4,5,9
Rest of Co. Meath,2009,1 - 4 years,2,2,4
Rest of Co. Meath,2009,10 - 14 years,0,1,1
Rest of Co. Meath,2009,15 - 19 years,1,3,4
Rest of Co. Meath,2009,20 - 24 years,4,1,5
Rest of Co. Meath,2009,25 - 29 years,1,2,3
Rest of Co. Meath,2009,30 - 34 years,2,5,7
Rest of Co. Meath,2009,35 - 39 years,5,9,14
Rest of Co. Meath,2009,40 - 44 years,6,4,10
Rest of Co. Meath,2009,45 - 49 years,3,11,14
Rest of Co. Meath,2009,5 - 9 years,1,0,1
Rest of Co. Meath,2009,50 - 54 years,5,15,20
Rest of Co. Meath,2009,55 - 59 years,9,18,27
Rest of Co. Meath,2009,60 - 64 years,14,23,37
Rest of Co. Meath,2009,65 - 69 years,8,30,38
Rest of Co. Meath,2009,70 - 74 years,22,43,65
Rest of Co. Meath,2009,75 - 79 years,34,45,79
Rest of Co. Meath,2009,80 - 84 years,53,61,114
Rest of Co. Meath,2009,85 years and over,128,70,198
Rest of Co. Meath,2009,Under 1 year,2,5,7
Rest of Co. Meath,2010,1 - 4 years,1,2,3
Rest of Co. Meath,2010,10 - 14 years,0,1,1
Rest of Co. Meath,2010,15 - 19 years,1,3,4
Rest of Co. Meath,2010,20 - 24 years,1,2,3
Rest of Co. Meath,2010,25 - 29 years,1,2,3
Rest of Co. Meath,2010,30 - 34 years,1,2,3
Rest of Co. Meath,2010,35 - 39 years,2,5,7
Rest of Co. Meath,2010,40 - 44 years,1,6,7
Rest of Co. Meath,2010,45 - 49 years,6,4,10
Rest of Co. Meath,2010,5 - 9 years,1,0,1
Rest of Co. Meath,2010,50 - 54 years,15,2,17
Rest of Co. Meath,2010,55 - 59 years,7,14,21
Rest of Co. Meath,2010,60 - 64 years,18,15,33
Rest of Co. Meath,2010,65 - 69 years,16,34,50
Rest of Co. Meath,2010,70 - 74 years,14,35,49
Rest of Co. Meath,2010,75 - 79 years,44,44,88
Rest of Co. Meath,2010,80 - 84 years,48,51,99
Rest of Co. Meath,2010,85 years and over,92,72,164
Rest of Co. Meath,2010,Under 1 year,7,3,10
Rest of Co. Meath,2011,1 - 4 years,0,1,1
Rest of Co. Meath,2011,10 - 14 years,2,0,2
Rest of Co. Meath,2011,15 - 19 years,0,2,2
Rest of Co. Meath,2011,20 - 24 years,1,6,7
Rest of Co. Meath,2011,25 - 29 years,1,2,3
Rest of Co. Meath,2011,30 - 34 years,2,5,7
Rest of Co. Meath,2011,35 - 39 years,1,7,8
Rest of Co. Meath,2011,40 - 44 years,6,4,10
Rest of Co. Meath,2011,45 - 49 years,5,8,13
Rest of Co. Meath,2011,5 - 9 years,0,0,0
Rest of Co. Meath,2011,50 - 54 years,6,11,17
Rest of Co. Meath,2011,55 - 59 years,5,18,23
Rest of Co. Meath,2011,60 - 64 years,22,35,57
Rest of Co. Meath,2011,65 - 69 years,26,37,63
Rest of Co. Meath,2011,70 - 74 years,20,36,56
Rest of Co. Meath,2011,75 - 79 years,45,41,86
Rest of Co. Meath,2011,80 - 84 years,57,57,114
Rest of Co. Meath,2011,85 years and over,127,69,196
Rest of Co. Meath,2011,Under 1 year,4,9,13
Rest of Co. Meath,2012,1 - 4 years,0,2,2
Rest of Co. Meath,2012,10 - 14 years,2,0,2
Rest of Co. Meath,2012,15 - 19 years,1,2,3
Rest of Co. Meath,2012,20 - 24 years,1,2,3
Rest of Co. Meath,2012,25 - 29 years,1,2,3
Rest of Co. Meath,2012,30 - 34 years,2,6,8
Rest of Co. Meath,2012,35 - 39 years,3,7,10
Rest of Co. Meath,2012,40 - 44 years,4,4,8
Rest of Co. Meath,2012,45 - 49 years,4,5,9
Rest of Co. Meath,2012,5 - 9 years,1,0,1
Rest of Co. Meath,2012,50 - 54 years,9,10,19
Rest of Co. Meath,2012,55 - 59 years,12,20,32
Rest of Co. Meath,2012,60 - 64 years,19,27,46
Rest of Co. Meath,2012,65 - 69 years,21,26,47
Rest of Co. Meath,2012,70 - 74 years,18,29,47
Rest of Co. Meath,2012,75 - 79 years,39,45,84
Rest of Co. Meath,2012,80 - 84 years,49,50,99
Rest of Co. Meath,2012,85 years and over,119,67,186
Rest of Co. Meath,2012,Under 1 year,3,3,6
Rest of Co. Meath,2013,1 - 4 years,0,0,0
Rest of Co. Meath,2013,10 - 14 years,0,1,1
Rest of Co. Meath,2013,15 - 19 years,1,1,2
Rest of Co. Meath,2013,20 - 24 years,1,2,3
Rest of Co. Meath,2013,25 - 29 years,3,0,3
Rest of Co. Meath,2013,30 - 34 years,2,7,9
Rest of Co. Meath,2013,35 - 39 years,3,7,10
Rest of Co. Meath,2013,40 - 44 years,4,0,4
Rest of Co. Meath,2013,45 - 49 years,4,10,14
Rest of Co. Meath,2013,5 - 9 years,0,0,0
Rest of Co. Meath,2013,50 - 54 years,14,13,27
Rest of Co. Meath,2013,55 - 59 years,8,16,24
Rest of Co. Meath,2013,60 - 64 years,17,32,49
Rest of Co. Meath,2013,65 - 69 years,24,29,53
Rest of Co. Meath,2013,70 - 74 years,17,31,48
Rest of Co. Meath,2013,75 - 79 years,35,46,81
Rest of Co. Meath,2013,80 - 84 years,68,50,118
Rest of Co. Meath,2013,85 years and over,113,82,195
Rest of Co. Meath,2013,Under 1 year,0,1,1
Rest of Co. Meath,2014,1 - 4 years,1,0,1
Rest of Co. Meath,2014,10 - 14 years,1,1,2
Rest of Co. Meath,2014,15 - 19 years,1,1,2
Rest of Co. Meath,2014,20 - 24 years,1,3,4
Rest of Co. Meath,2014,25 - 29 years,2,6,8
Rest of Co. Meath,2014,30 - 34 years,3,3,6
Rest of Co. Meath,2014,35 - 39 years,1,5,6
Rest of Co. Meath,2014,40 - 44 years,2,6,8
Rest of Co. Meath,2014,45 - 49 years,5,8,13
Rest of Co. Meath,2014,5 - 9 years,1,0,1
Rest of Co. Meath,2014,50 - 54 years,9,8,17
Rest of Co. Meath,2014,55 - 59 years,10,19,29
Rest of Co. Meath,2014,60 - 64 years,13,26,39
Rest of Co. Meath,2014,65 - 69 years,23,40,63
Rest of Co. Meath,2014,70 - 74 years,28,33,61
Rest of Co. Meath,2014,75 - 79 years,39,45,84
Rest of Co. Meath,2014,80 - 84 years,56,46,102
Rest of Co. Meath,2014,85 years and over,146,83,229
Rest of Co. Meath,2014,Under 1 year,2,3,5
Rest of Co. Meath,2015,1 - 4 years,1,0,1
Rest of Co. Meath,2015,10 - 14 years,1,1,2
Rest of Co. Meath,2015,15 - 19 years,1,1,2
Rest of Co. Meath,2015,20 - 24 years,1,3,4
Rest of Co. Meath,2015,25 - 29 years,2,6,8
Rest of Co. Meath,2015,30 - 34 years,3,3,6
Rest of Co. Meath,2015,35 - 39 years,1,5,6
Rest of Co. Meath,2015,40 - 44 years,2,6,8
Rest of Co. Meath,2015,45 - 49 years,5,8,13
Rest of Co. Meath,2015,5 - 9 years,1,0,1
Rest of Co. Meath,2015,50 - 54 years,9,8,17
Rest of Co. Meath,2015,55 - 59 years,10,19,29
Rest of Co. Meath,2015,60 - 64 years,13,26,39
Rest of Co. Meath,2015,65 - 69 years,23,40,63
Rest of Co. Meath,2015,70 - 74 years,28,33,61
Rest of Co. Meath,2015,75 - 79 years,39,45,84
Rest of Co. Meath,2015,80 - 84 years,56,46,102
Rest of Co. Meath,2015,85 years and over,146,83,229
Rest of Co. Meath,2015,Under 1 year,2,3,5
Rest of Co. Meath,2016,1 - 4 years,1,0,1
Rest of Co. Meath,2016,10 - 14 years,1,1,2
Rest of Co. Meath,2016,15 - 19 years,1,1,2
Rest of Co. Meath,2016,20 - 24 years,1,3,4
Rest of Co. Meath,2016,25 - 29 years,2,6,8
Rest of Co. Meath,2016,30 - 34 years,3,3,6
Rest of Co. Meath,2016,35 - 39 years,1,5,6
Rest of Co. Meath,2016,40 - 44 years,2,6,8
Rest of Co. Meath,2016,45 - 49 years,5,8,13
Rest of Co. Meath,2016,5 - 9 years,1,0,1
Rest of Co. Meath,2016,50 - 54 years,9,8,17
Rest of Co. Meath,2016,55 - 59 years,10,19,29
Rest of Co. Meath,2016,60 - 64 years,13,26,39
Rest of Co. Meath,2016,65 - 69 years,23,40,63
Rest of Co. Meath,2016,70 - 74 years,28,33,61
Rest of Co. Meath,2016,75 - 79 years,39,45,84
Rest of Co. Meath,2016,80 - 84 years,56,46,102
Rest of Co. Meath,2016,85 years and over,146,83,229
Rest of Co. Meath,2016,Under 1 year,2,3,5
Rest of Co. Meath,2017,1 - 4 years,1,1,2
Rest of Co. Meath,2017,10 - 14 years,1,1,2
Rest of Co. Meath,2017,15 - 19 years,1,1,2
Rest of Co. Meath,2017,20 - 24 years,1,2,3
Rest of Co. Meath,2017,25 - 29 years,1,3,4
Rest of Co. Meath,2017,30 - 34 years,1,3,4
Rest of Co. Meath,2017,35 - 39 years,2,5,7
Rest of Co. Meath,2017,40 - 44 years,1,9,10
Rest of Co. Meath,2017,45 - 49 years,9,6,15
Rest of Co. Meath,2017,5 - 9 years,1,1,2
Rest of Co. Meath,2017,50 - 54 years,9,12,21
Rest of Co. Meath,2017,55 - 59 years,8,18,26
Rest of Co. Meath,2017,60 - 64 years,15,21,36
Rest of Co. Meath,2017,65 - 69 years,27,31,58
Rest of Co. Meath,2017,70 - 74 years,28,49,77
Rest of Co. Meath,2017,75 - 79 years,42,54,96
Rest of Co. Meath,2017,80 - 84 years,41,71,112
Rest of Co. Meath,2017,85 years and over,145,94,239
Rest of Co. Meath,2017,Under 1 year,2,3,5
Rest of Co. Meath,2018,1 - 4 years,0,1,1
Rest of Co. Meath,2018,10 - 14 years,0,0,0
Rest of Co. Meath,2018,15 - 19 years,0,2,2
Rest of Co. Meath,2018,20 - 24 years,1,1,2
Rest of Co. Meath,2018,25 - 29 years,1,1,2
Rest of Co. Meath,2018,30 - 34 years,1,2,3
Rest of Co. Meath,2018,35 - 39 years,7,1,8
Rest of Co. Meath,2018,40 - 44 years,4,7,11
Rest of Co. Meath,2018,45 - 49 years,3,9,12
Rest of Co. Meath,2018,5 - 9 years,0,0,0
Rest of Co. Meath,2018,50 - 54 years,10,13,23
Rest of Co. Meath,2018,55 - 59 years,15,23,38
Rest of Co. Meath,2018,60 - 64 years,14,20,34
Rest of Co. Meath,2018,65 - 69 years,27,28,55
Rest of Co. Meath,2018,70 - 74 years,31,48,79
Rest of Co. Meath,2018,75 - 79 years,32,66,98
Rest of Co. Meath,2018,80 - 84 years,59,69,128
Rest of Co. Meath,2018,85 years and over,130,124,254
Rest of Co. Meath,2018,Under 1 year,4,6,10
Rest of Co. Meath,2019,1 - 4 years,0,1,1
Rest of Co. Meath,2019,10 - 14 years,0,0,0
Rest of Co. Meath,2019,15 - 19 years,0,2,2
Rest of Co. Meath,2019,20 - 24 years,1,1,2
Rest of Co. Meath,2019,25 - 29 years,1,1,2
Rest of Co. Meath,2019,30 - 34 years,1,2,3
Rest of Co. Meath,2019,35 - 39 years,7,1,8
Rest of Co. Meath,2019,40 - 44 years,4,7,11
Rest of Co. Meath,2019,45 - 49 years,3,9,12
Rest of Co. Meath,2019,5 - 9 years,0,0,0
Rest of Co. Meath,2019,50 - 54 years,10,13,23
Rest of Co. Meath,2019,55 - 59 years,15,23,38
Rest of Co. Meath,2019,60 - 64 years,14,20,34
Rest of Co. Meath,2019,65 - 69 years,27,28,55
Rest of Co. Meath,2019,70 - 74 years,31,48,79
Rest of Co. Meath,2019,75 - 79 years,32,66,98
Rest of Co. Meath,2019,80 - 84 years,59,69,128
Rest of Co. Meath,2019,85 years and over,130,124,254
Rest of Co. Meath,2019,Under 1 year,4,6,10
Rest of Co. Meath,2020,1 - 4 years,0,1,1
Rest of Co. Meath,2020,10 - 14 years,0,0,0
Rest of Co. Meath,2020,15 - 19 years,0,2,2
Rest of Co. Meath,2020,20 - 24 years,1,1,2
Rest of Co. Meath,2020,25 - 29 years,1,1,2
Rest of Co. Meath,2020,30 - 34 years,1,2,3
Rest of Co. Meath,2020,35 - 39 years,7,1,8
Rest of Co. Meath,2020,40 - 44 years,4,7,11
Rest of Co. Meath,2020,45 - 49 years,3,9,12
Rest of Co. Meath,2020,5 - 9 years,0,0,0
Rest of Co. Meath,2020,50 - 54 years,10,13,23
Rest of Co. Meath,2020,55 - 59 years,15,23,38
Rest of Co. Meath,2020,60 - 64 years,14,20,34
Rest of Co. Meath,2020,65 - 69 years,27,28,55
Rest of Co. Meath,2020,70 - 74 years,31,48,79
Rest of Co. Meath,2020,75 - 79 years,32,66,98
Rest of Co. Meath,2020,80 - 84 years,59,69,128
Rest of Co. Meath,2020,85 years and over,130,124,254
Rest of Co. Meath,2020,Under 1 year,4,6,10
Rest of Co. Monaghan,2007,1 - 4 years,1,1,2
Rest of Co. Monaghan,2007,10 - 14 years,0,0,0
Rest of Co. Monaghan,2007,15 - 19 years,0,1,1
Rest of Co. Monaghan,2007,20 - 24 years,0,0,0
Rest of Co. Monaghan,2007,25 - 29 years,0,0,0
Rest of Co. Monaghan,2007,30 - 34 years,0,2,2
Rest of Co. Monaghan,2007,35 - 39 years,1,1,2
Rest of Co. Monaghan,2007,40 - 44 years,1,2,3
Rest of Co. Monaghan,2007,45 - 49 years,1,1,2
Rest of Co. Monaghan,2007,5 - 9 years,0,0,0
Rest of Co. Monaghan,2007,50 - 54 years,2,1,3
Rest of Co. Monaghan,2007,55 - 59 years,3,6,9
Rest of Co. Monaghan,2007,60 - 64 years,2,10,12
Rest of Co. Monaghan,2007,65 - 69 years,10,11,21
Rest of Co. Monaghan,2007,70 - 74 years,10,15,25
Rest of Co. Monaghan,2007,75 - 79 years,11,19,30
Rest of Co. Monaghan,2007,80 - 84 years,16,22,38
Rest of Co. Monaghan,2007,85 years and over,61,28,89
Rest of Co. Monaghan,2007,Under 1 year,0,0,0
Rest of Co. Monaghan,2008,1 - 4 years,1,1,2
Rest of Co. Monaghan,2008,10 - 14 years,0,0,0
Rest of Co. Monaghan,2008,15 - 19 years,0,1,1
Rest of Co. Monaghan,2008,20 - 24 years,0,1,1
Rest of Co. Monaghan,2008,25 - 29 years,1,0,1
Rest of Co. Monaghan,2008,30 - 34 years,0,2,2
Rest of Co. Monaghan,2008,35 - 39 years,1,1,2
Rest of Co. Monaghan,2008,40 - 44 years,1,2,3
Rest of Co. Monaghan,2008,45 - 49 years,2,1,3
Rest of Co. Monaghan,2008,5 - 9 years,0,0,0
Rest of Co. Monaghan,2008,50 - 54 years,2,2,4
Rest of Co. Monaghan,2008,55 - 59 years,1,4,5
Rest of Co. Monaghan,2008,60 - 64 years,2,10,12
Rest of Co. Monaghan,2008,65 - 69 years,6,8,14
Rest of Co. Monaghan,2008,70 - 74 years,6,12,18
Rest of Co. Monaghan,2008,75 - 79 years,10,20,30
Rest of Co. Monaghan,2008,80 - 84 years,21,22,43
Rest of Co. Monaghan,2008,85 years and over,30,23,53
Rest of Co. Monaghan,2008,Under 1 year,1,1,2
Rest of Co. Monaghan,2009,1 - 4 years,1,1,2
Rest of Co. Monaghan,2009,10 - 14 years,0,0,0
Rest of Co. Monaghan,2009,15 - 19 years,1,1,2
Rest of Co. Monaghan,2009,20 - 24 years,0,1,1
Rest of Co. Monaghan,2009,25 - 29 years,2,2,4
Rest of Co. Monaghan,2009,30 - 34 years,2,1,3
Rest of Co. Monaghan,2009,35 - 39 years,2,1,3
Rest of Co. Monaghan,2009,40 - 44 years,2,4,6
Rest of Co. Monaghan,2009,45 - 49 years,2,6,8
Rest of Co. Monaghan,2009,5 - 9 years,0,0,0
Rest of Co. Monaghan,2009,50 - 54 years,4,4,8
Rest of Co. Monaghan,2009,55 - 59 years,2,10,12
Rest of Co. Monaghan,2009,60 - 64 years,6,13,19
Rest of Co. Monaghan,2009,65 - 69 years,9,12,21
Rest of Co. Monaghan,2009,70 - 74 years,10,21,31
Rest of Co. Monaghan,2009,75 - 79 years,25,24,49
Rest of Co. Monaghan,2009,80 - 84 years,24,28,52
Rest of Co. Monaghan,2009,85 years and over,59,31,90
Rest of Co. Monaghan,2009,Under 1 year,1,1,2
Rest of Co. Monaghan,2010,1 - 4 years,1,1,2
Rest of Co. Monaghan,2010,10 - 14 years,0,0,0
Rest of Co. Monaghan,2010,15 - 19 years,1,1,2
Rest of Co. Monaghan,2010,20 - 24 years,0,1,1
Rest of Co. Monaghan,2010,25 - 29 years,2,2,4
Rest of Co. Monaghan,2010,30 - 34 years,2,3,5
Rest of Co. Monaghan,2010,35 - 39 years,1,1,2
Rest of Co. Monaghan,2010,40 - 44 years,2,3,5
Rest of Co. Monaghan,2010,45 - 49 years,3,6,9
Rest of Co. Monaghan,2010,5 - 9 years,0,0,0
Rest of Co. Monaghan,2010,50 - 54 years,4,4,8
Rest of Co. Monaghan,2010,55 - 59 years,2,7,9
Rest of Co. Monaghan,2010,60 - 64 years,5,6,11
Rest of Co. Monaghan,2010,65 - 69 years,8,10,18
Rest of Co. Monaghan,2010,70 - 74 years,9,7,16
Rest of Co. Monaghan,2010,75 - 79 years,17,28,45
Rest of Co. Monaghan,2010,80 - 84 years,30,32,62
Rest of Co. Monaghan,2010,85 years and over,47,31,78
Rest of Co. Monaghan,2010,Under 1 year,3,1,4
Rest of Co. Monaghan,2011,1 - 4 years,0,0,0
Rest of Co. Monaghan,2011,10 - 14 years,1,0,1
Rest of Co. Monaghan,2011,15 - 19 years,2,1,3
Rest of Co. Monaghan,2011,20 - 24 years,1,1,2
Rest of Co. Monaghan,2011,25 - 29 years,0,1,1
Rest of Co. Monaghan,2011,30 - 34 years,0,3,3
Rest of Co. Monaghan,2011,35 - 39 years,2,3,5
Rest of Co. Monaghan,2011,40 - 44 years,0,0,0
Rest of Co. Monaghan,2011,45 - 49 years,3,3,6
Rest of Co. Monaghan,2011,5 - 9 years,0,0,0
Rest of Co. Monaghan,2011,50 - 54 years,2,1,3
Rest of Co. Monaghan,2011,55 - 59 years,1,10,11
Rest of Co. Monaghan,2011,60 - 64 years,4,13,17
Rest of Co. Monaghan,2011,65 - 69 years,14,12,26
Rest of Co. Monaghan,2011,70 - 74 years,11,12,23
Rest of Co. Monaghan,2011,75 - 79 years,12,26,38
Rest of Co. Monaghan,2011,80 - 84 years,29,26,55
Rest of Co. Monaghan,2011,85 years and over,60,51,111
Rest of Co. Monaghan,2011,Under 1 year,1,1,2
Rest of Co. Monaghan,2012,1 - 4 years,1,0,1
Rest of Co. Monaghan,2012,10 - 14 years,1,2,3
Rest of Co. Monaghan,2012,15 - 19 years,2,2,4
Rest of Co. Monaghan,2012,20 - 24 years,1,1,2
Rest of Co. Monaghan,2012,25 - 29 years,1,1,2
Rest of Co. Monaghan,2012,30 - 34 years,0,2,2
Rest of Co. Monaghan,2012,35 - 39 years,3,2,5
Rest of Co. Monaghan,2012,40 - 44 years,3,2,5
Rest of Co. Monaghan,2012,45 - 49 years,4,4,8
Rest of Co. Monaghan,2012,5 - 9 years,1,0,1
Rest of Co. Monaghan,2012,50 - 54 years,2,6,8
Rest of Co. Monaghan,2012,55 - 59 years,7,5,12
Rest of Co. Monaghan,2012,60 - 64 years,3,11,14
Rest of Co. Monaghan,2012,65 - 69 years,9,16,25
Rest of Co. Monaghan,2012,70 - 74 years,10,16,26
Rest of Co. Monaghan,2012,75 - 79 years,14,13,27
Rest of Co. Monaghan,2012,80 - 84 years,26,21,47
Rest of Co. Monaghan,2012,85 years and over,62,39,101
Rest of Co. Monaghan,2012,Under 1 year,1,1,2
Rest of Co. Monaghan,2013,1 - 4 years,0,0,0
Rest of Co. Monaghan,2013,10 - 14 years,1,0,1
Rest of Co. Monaghan,2013,15 - 19 years,0,1,1
Rest of Co. Monaghan,2013,20 - 24 years,0,3,3
Rest of Co. Monaghan,2013,25 - 29 years,0,1,1
Rest of Co. Monaghan,2013,30 - 34 years,2,1,3
Rest of Co. Monaghan,2013,35 - 39 years,1,1,2
Rest of Co. Monaghan,2013,40 - 44 years,1,3,4
Rest of Co. Monaghan,2013,45 - 49 years,2,3,5
Rest of Co. Monaghan,2013,5 - 9 years,0,0,0
Rest of Co. Monaghan,2013,50 - 54 years,4,3,7
Rest of Co. Monaghan,2013,55 - 59 years,1,4,5
Rest of Co. Monaghan,2013,60 - 64 years,8,7,15
Rest of Co. Monaghan,2013,65 - 69 years,10,16,26
Rest of Co. Monaghan,2013,70 - 74 years,8,14,22
Rest of Co. Monaghan,2013,75 - 79 years,16,13,29
Rest of Co. Monaghan,2013,80 - 84 years,24,22,46
Rest of Co. Monaghan,2013,85 years and over,57,43,100
Rest of Co. Monaghan,2013,Under 1 year,1,5,6
Rest of Co. Monaghan,2014,1 - 4 years,0,1,1
Rest of Co. Monaghan,2014,10 - 14 years,1,0,1
Rest of Co. Monaghan,2014,15 - 19 years,0,1,1
Rest of Co. Monaghan,2014,20 - 24 years,0,3,3
Rest of Co. Monaghan,2014,25 - 29 years,0,2,2
Rest of Co. Monaghan,2014,30 - 34 years,2,2,4
Rest of Co. Monaghan,2014,35 - 39 years,1,1,2
Rest of Co. Monaghan,2014,40 - 44 years,1,3,4
Rest of Co. Monaghan,2014,45 - 49 years,2,1,3
Rest of Co. Monaghan,2014,5 - 9 years,0,0,0
Rest of Co. Monaghan,2014,50 - 54 years,3,4,7
Rest of Co. Monaghan,2014,55 - 59 years,4,8,12
Rest of Co. Monaghan,2014,60 - 64 years,2,3,5
Rest of Co. Monaghan,2014,65 - 69 years,8,10,18
Rest of Co. Monaghan,2014,70 - 74 years,12,22,34
Rest of Co. Monaghan,2014,75 - 79 years,10,18,28
Rest of Co. Monaghan,2014,80 - 84 years,24,23,47
Rest of Co. Monaghan,2014,85 years and over,48,47,95
Rest of Co. Monaghan,2014,Under 1 year,1,2,3
Rest of Co. Monaghan,2015,1 - 4 years,0,1,1
Rest of Co. Monaghan,2015,10 - 14 years,1,0,1
Rest of Co. Monaghan,2015,15 - 19 years,0,1,1
Rest of Co. Monaghan,2015,20 - 24 years,0,3,3
Rest of Co. Monaghan,2015,25 - 29 years,0,2,2
Rest of Co. Monaghan,2015,30 - 34 years,2,2,4
Rest of Co. Monaghan,2015,35 - 39 years,1,1,2
Rest of Co. Monaghan,2015,40 - 44 years,1,3,4
Rest of Co. Monaghan,2015,45 - 49 years,2,1,3
Rest of Co. Monaghan,2015,5 - 9 years,0,0,0
Rest of Co. Monaghan,2015,50 - 54 years,3,4,7
Rest of Co. Monaghan,2015,55 - 59 years,4,8,12
Rest of Co. Monaghan,2015,60 - 64 years,2,3,5
Rest of Co. Monaghan,2015,65 - 69 years,8,10,18
Rest of Co. Monaghan,2015,70 - 74 years,12,22,34
Rest of Co. Monaghan,2015,75 - 79 years,10,18,28
Rest of Co. Monaghan,2015,80 - 84 years,24,23,47
Rest of Co. Monaghan,2015,85 years and over,48,47,95
Rest of Co. Monaghan,2015,Under 1 year,1,2,3
Rest of Co. Monaghan,2016,1 - 4 years,0,1,1
Rest of Co. Monaghan,2016,10 - 14 years,1,0,1
Rest of Co. Monaghan,2016,15 - 19 years,0,1,1
Rest of Co. Monaghan,2016,20 - 24 years,0,3,3
Rest of Co. Monaghan,2016,25 - 29 years,0,2,2
Rest of Co. Monaghan,2016,30 - 34 years,2,2,4
Rest of Co. Monaghan,2016,35 - 39 years,1,1,2
Rest of Co. Monaghan,2016,40 - 44 years,1,3,4
Rest of Co. Monaghan,2016,45 - 49 years,2,1,3
Rest of Co. Monaghan,2016,5 - 9 years,0,0,0
Rest of Co. Monaghan,2016,50 - 54 years,3,4,7
Rest of Co. Monaghan,2016,55 - 59 years,4,8,12
Rest of Co. Monaghan,2016,60 - 64 years,2,3,5
Rest of Co. Monaghan,2016,65 - 69 years,8,10,18
Rest of Co. Monaghan,2016,70 - 74 years,12,22,34
Rest of Co. Monaghan,2016,75 - 79 years,10,18,28
Rest of Co. Monaghan,2016,80 - 84 years,24,23,47
Rest of Co. Monaghan,2016,85 years and over,48,47,95
Rest of Co. Monaghan,2016,Under 1 year,1,2,3
Rest of Co. Monaghan,2017,1 - 4 years,0,1,1
Rest of Co. Monaghan,2017,10 - 14 years,1,0,1
Rest of Co. Monaghan,2017,15 - 19 years,1,1,2
Rest of Co. Monaghan,2017,20 - 24 years,0,1,1
Rest of Co. Monaghan,2017,25 - 29 years,1,2,3
Rest of Co. Monaghan,2017,30 - 34 years,2,1,3
Rest of Co. Monaghan,2017,35 - 39 years,1,1,2
Rest of Co. Monaghan,2017,40 - 44 years,1,4,5
Rest of Co. Monaghan,2017,45 - 49 years,3,1,4
Rest of Co. Monaghan,2017,5 - 9 years,2,0,2
Rest of Co. Monaghan,2017,50 - 54 years,6,3,9
Rest of Co. Monaghan,2017,55 - 59 years,4,2,6
Rest of Co. Monaghan,2017,60 - 64 years,3,11,14
Rest of Co. Monaghan,2017,65 - 69 years,4,11,15
Rest of Co. Monaghan,2017,70 - 74 years,11,9,20
Rest of Co. Monaghan,2017,75 - 79 years,10,20,30
Rest of Co. Monaghan,2017,80 - 84 years,22,25,47
Rest of Co. Monaghan,2017,85 years and over,62,29,91
Rest of Co. Monaghan,2017,Under 1 year,1,2,3
Rest of Co. Monaghan,2018,1 - 4 years,0,0,0
Rest of Co. Monaghan,2018,10 - 14 years,0,0,0
Rest of Co. Monaghan,2018,15 - 19 years,1,1,2
Rest of Co. Monaghan,2018,20 - 24 years,0,1,1
Rest of Co. Monaghan,2018,25 - 29 years,0,0,0
Rest of Co. Monaghan,2018,30 - 34 years,0,1,1
Rest of Co. Monaghan,2018,35 - 39 years,0,1,1
Rest of Co. Monaghan,2018,40 - 44 years,1,0,1
Rest of Co. Monaghan,2018,45 - 49 years,0,3,3
Rest of Co. Monaghan,2018,5 - 9 years,0,0,0
Rest of Co. Monaghan,2018,50 - 54 years,4,4,8
Rest of Co. Monaghan,2018,55 - 59 years,5,5,10
Rest of Co. Monaghan,2018,60 - 64 years,2,6,8
Rest of Co. Monaghan,2018,65 - 69 years,6,10,16
Rest of Co. Monaghan,2018,70 - 74 years,12,15,27
Rest of Co. Monaghan,2018,75 - 79 years,12,21,33
Rest of Co. Monaghan,2018,80 - 84 years,14,27,41
Rest of Co. Monaghan,2018,85 years and over,53,46,99
Rest of Co. Monaghan,2018,Under 1 year,0,1,1
Rest of Co. Monaghan,2019,1 - 4 years,0,0,0
Rest of Co. Monaghan,2019,10 - 14 years,0,0,0
Rest of Co. Monaghan,2019,15 - 19 years,1,1,2
Rest of Co. Monaghan,2019,20 - 24 years,0,1,1
Rest of Co. Monaghan,2019,25 - 29 years,0,0,0
Rest of Co. Monaghan,2019,30 - 34 years,0,1,1
Rest of Co. Monaghan,2019,35 - 39 years,0,1,1
Rest of Co. Monaghan,2019,40 - 44 years,1,0,1
Rest of Co. Monaghan,2019,45 - 49 years,0,3,3
Rest of Co. Monaghan,2019,5 - 9 years,0,0,0
Rest of Co. Monaghan,2019,50 - 54 years,4,4,8
Rest of Co. Monaghan,2019,55 - 59 years,5,5,10
Rest of Co. Monaghan,2019,60 - 64 years,2,6,8
Rest of Co. Monaghan,2019,65 - 69 years,6,10,16
Rest of Co. Monaghan,2019,70 - 74 years,12,15,27
Rest of Co. Monaghan,2019,75 - 79 years,12,21,33
Rest of Co. Monaghan,2019,80 - 84 years,14,27,41
Rest of Co. Monaghan,2019,85 years and over,53,46,99
Rest of Co. Monaghan,2019,Under 1 year,0,1,1
Rest of Co. Monaghan,2020,1 - 4 years,0,0,0
Rest of Co. Monaghan,2020,10 - 14 years,0,0,0
Rest of Co. Monaghan,2020,15 - 19 years,1,1,2
Rest of Co. Monaghan,2020,20 - 24 years,0,1,1
Rest of Co. Monaghan,2020,25 - 29 years,0,0,0
Rest of Co. Monaghan,2020,30 - 34 years,0,1,1
Rest of Co. Monaghan,2020,35 - 39 years,0,1,1
Rest of Co. Monaghan,2020,40 - 44 years,1,0,1
Rest of Co. Monaghan,2020,45 - 49 years,0,3,3
Rest of Co. Monaghan,2020,5 - 9 years,0,0,0
Rest of Co. Monaghan,2020,50 - 54 years,4,4,8
Rest of Co. Monaghan,2020,55 - 59 years,5,5,10
Rest of Co. Monaghan,2020,60 - 64 years,2,6,8
Rest of Co. Monaghan,2020,65 - 69 years,6,10,16
Rest of Co. Monaghan,2020,70 - 74 years,12,15,27
Rest of Co. Monaghan,2020,75 - 79 years,12,21,33
Rest of Co. Monaghan,2020,80 - 84 years,14,27,41
Rest of Co. Monaghan,2020,85 years and over,53,46,99
Rest of Co. Monaghan,2020,Under 1 year,0,1,1
Rest of Co. Offaly,2007,1 - 4 years,0,0,0
Rest of Co. Offaly,2007,10 - 14 years,0,0,0
Rest of Co. Offaly,2007,15 - 19 years,0,0,0
Rest of Co. Offaly,2007,20 - 24 years,1,2,3
Rest of Co. Offaly,2007,25 - 29 years,0,2,2
Rest of Co. Offaly,2007,30 - 34 years,0,1,1
Rest of Co. Offaly,2007,35 - 39 years,1,0,1
Rest of Co. Offaly,2007,40 - 44 years,5,2,7
Rest of Co. Offaly,2007,45 - 49 years,1,4,5
Rest of Co. Offaly,2007,5 - 9 years,0,0,0
Rest of Co. Offaly,2007,50 - 54 years,3,2,5
Rest of Co. Offaly,2007,55 - 59 years,7,6,13
Rest of Co. Offaly,2007,60 - 64 years,3,13,16
Rest of Co. Offaly,2007,65 - 69 years,6,8,14
Rest of Co. Offaly,2007,70 - 74 years,10,17,27
Rest of Co. Offaly,2007,75 - 79 years,18,17,35
Rest of Co. Offaly,2007,80 - 84 years,26,23,49
Rest of Co. Offaly,2007,85 years and over,47,23,70
Rest of Co. Offaly,2007,Under 1 year,0,1,1
Rest of Co. Offaly,2008,1 - 4 years,0,0,0
Rest of Co. Offaly,2008,10 - 14 years,0,1,1
Rest of Co. Offaly,2008,15 - 19 years,1,2,3
Rest of Co. Offaly,2008,20 - 24 years,1,3,4
Rest of Co. Offaly,2008,25 - 29 years,1,1,2
Rest of Co. Offaly,2008,30 - 34 years,0,2,2
Rest of Co. Offaly,2008,35 - 39 years,2,1,3
Rest of Co. Offaly,2008,40 - 44 years,1,2,3
Rest of Co. Offaly,2008,45 - 49 years,1,4,5
Rest of Co. Offaly,2008,5 - 9 years,0,1,1
Rest of Co. Offaly,2008,50 - 54 years,1,2,3
Rest of Co. Offaly,2008,55 - 59 years,2,4,6
Rest of Co. Offaly,2008,60 - 64 years,9,6,15
Rest of Co. Offaly,2008,65 - 69 years,3,12,15
Rest of Co. Offaly,2008,70 - 74 years,10,12,22
Rest of Co. Offaly,2008,75 - 79 years,18,19,37
Rest of Co. Offaly,2008,80 - 84 years,19,29,48
Rest of Co. Offaly,2008,85 years and over,44,30,74
Rest of Co. Offaly,2008,Under 1 year,0,1,1
Rest of Co. Offaly,2009,1 - 4 years,0,1,1
Rest of Co. Offaly,2009,10 - 14 years,1,1,2
Rest of Co. Offaly,2009,15 - 19 years,1,2,3
Rest of Co. Offaly,2009,20 - 24 years,2,3,5
Rest of Co. Offaly,2009,25 - 29 years,1,3,4
Rest of Co. Offaly,2009,30 - 34 years,0,5,5
Rest of Co. Offaly,2009,35 - 39 years,3,3,6
Rest of Co. Offaly,2009,40 - 44 years,3,1,4
Rest of Co. Offaly,2009,45 - 49 years,4,1,5
Rest of Co. Offaly,2009,5 - 9 years,0,1,1
Rest of Co. Offaly,2009,50 - 54 years,3,1,4
Rest of Co. Offaly,2009,55 - 59 years,9,9,18
Rest of Co. Offaly,2009,60 - 64 years,6,15,21
Rest of Co. Offaly,2009,65 - 69 years,9,17,26
Rest of Co. Offaly,2009,70 - 74 years,10,13,23
Rest of Co. Offaly,2009,75 - 79 years,24,26,50
Rest of Co. Offaly,2009,80 - 84 years,32,25,57
Rest of Co. Offaly,2009,85 years and over,55,44,99
Rest of Co. Offaly,2009,Under 1 year,2,4,6
Rest of Co. Offaly,2010,1 - 4 years,0,1,1
Rest of Co. Offaly,2010,10 - 14 years,1,1,2
Rest of Co. Offaly,2010,15 - 19 years,1,1,2
Rest of Co. Offaly,2010,20 - 24 years,2,3,5
Rest of Co. Offaly,2010,25 - 29 years,1,1,2
Rest of Co. Offaly,2010,30 - 34 years,0,1,1
Rest of Co. Offaly,2010,35 - 39 years,1,3,4
Rest of Co. Offaly,2010,40 - 44 years,3,5,8
Rest of Co. Offaly,2010,45 - 49 years,1,1,2
Rest of Co. Offaly,2010,5 - 9 years,0,1,1
Rest of Co. Offaly,2010,50 - 54 years,2,7,9
Rest of Co. Offaly,2010,55 - 59 years,7,10,17
Rest of Co. Offaly,2010,60 - 64 years,4,11,15
Rest of Co. Offaly,2010,65 - 69 years,8,14,22
Rest of Co. Offaly,2010,70 - 74 years,11,14,25
Rest of Co. Offaly,2010,75 - 79 years,26,23,49
Rest of Co. Offaly,2010,80 - 84 years,29,29,58
Rest of Co. Offaly,2010,85 years and over,60,41,101
Rest of Co. Offaly,2010,Under 1 year,3,4,7
Rest of Co. Offaly,2011,1 - 4 years,1,0,1
Rest of Co. Offaly,2011,10 - 14 years,0,0,0
Rest of Co. Offaly,2011,15 - 19 years,0,1,1
Rest of Co. Offaly,2011,20 - 24 years,0,2,2
Rest of Co. Offaly,2011,25 - 29 years,0,1,1
Rest of Co. Offaly,2011,30 - 34 years,3,3,6
Rest of Co. Offaly,2011,35 - 39 years,0,3,3
Rest of Co. Offaly,2011,40 - 44 years,7,6,13
Rest of Co. Offaly,2011,45 - 49 years,0,3,3
Rest of Co. Offaly,2011,5 - 9 years,0,0,0
Rest of Co. Offaly,2011,50 - 54 years,4,6,10
Rest of Co. Offaly,2011,55 - 59 years,5,3,8
Rest of Co. Offaly,2011,60 - 64 years,5,11,16
Rest of Co. Offaly,2011,65 - 69 years,12,18,30
Rest of Co. Offaly,2011,70 - 74 years,8,20,28
Rest of Co. Offaly,2011,75 - 79 years,22,20,42
Rest of Co. Offaly,2011,80 - 84 years,26,41,67
Rest of Co. Offaly,2011,85 years and over,72,43,115
Rest of Co. Offaly,2011,Under 1 year,1,3,4
Rest of Co. Offaly,2012,1 - 4 years,1,0,1
Rest of Co. Offaly,2012,10 - 14 years,0,0,0
Rest of Co. Offaly,2012,15 - 19 years,1,2,3
Rest of Co. Offaly,2012,20 - 24 years,1,2,3
Rest of Co. Offaly,2012,25 - 29 years,0,2,2
Rest of Co. Offaly,2012,30 - 34 years,1,2,3
Rest of Co. Offaly,2012,35 - 39 years,2,6,8
Rest of Co. Offaly,2012,40 - 44 years,7,1,8
Rest of Co. Offaly,2012,45 - 49 years,3,4,7
Rest of Co. Offaly,2012,5 - 9 years,1,0,1
Rest of Co. Offaly,2012,50 - 54 years,3,6,9
Rest of Co. Offaly,2012,55 - 59 years,4,9,13
Rest of Co. Offaly,2012,60 - 64 years,11,11,22
Rest of Co. Offaly,2012,65 - 69 years,9,13,22
Rest of Co. Offaly,2012,70 - 74 years,8,22,30
Rest of Co. Offaly,2012,75 - 79 years,24,23,47
Rest of Co. Offaly,2012,80 - 84 years,22,16,38
Rest of Co. Offaly,2012,85 years and over,51,46,97
Rest of Co. Offaly,2012,Under 1 year,1,1,2
Rest of Co. Offaly,2013,1 - 4 years,0,0,0
Rest of Co. Offaly,2013,10 - 14 years,0,0,0
Rest of Co. Offaly,2013,15 - 19 years,0,2,2
Rest of Co. Offaly,2013,20 - 24 years,0,0,0
Rest of Co. Offaly,2013,25 - 29 years,1,3,4
Rest of Co. Offaly,2013,30 - 34 years,0,1,1
Rest of Co. Offaly,2013,35 - 39 years,0,0,0
Rest of Co. Offaly,2013,40 - 44 years,1,2,3
Rest of Co. Offaly,2013,45 - 49 years,3,0,3
Rest of Co. Offaly,2013,5 - 9 years,1,0,1
Rest of Co. Offaly,2013,50 - 54 years,1,2,3
Rest of Co. Offaly,2013,55 - 59 years,4,3,7
Rest of Co. Offaly,2013,60 - 64 years,4,12,16
Rest of Co. Offaly,2013,65 - 69 years,12,11,23
Rest of Co. Offaly,2013,70 - 74 years,11,29,40
Rest of Co. Offaly,2013,75 - 79 years,16,27,43
Rest of Co. Offaly,2013,80 - 84 years,30,22,52
Rest of Co. Offaly,2013,85 years and over,70,56,126
Rest of Co. Offaly,2013,Under 1 year,2,2,4
Rest of Co. Offaly,2014,1 - 4 years,0,0,0
Rest of Co. Offaly,2014,10 - 14 years,0,2,2
Rest of Co. Offaly,2014,15 - 19 years,0,1,1
Rest of Co. Offaly,2014,20 - 24 years,1,0,1
Rest of Co. Offaly,2014,25 - 29 years,1,2,3
Rest of Co. Offaly,2014,30 - 34 years,1,3,4
Rest of Co. Offaly,2014,35 - 39 years,2,1,3
Rest of Co. Offaly,2014,40 - 44 years,2,2,4
Rest of Co. Offaly,2014,45 - 49 years,2,1,3
Rest of Co. Offaly,2014,5 - 9 years,1,2,3
Rest of Co. Offaly,2014,50 - 54 years,3,3,6
Rest of Co. Offaly,2014,55 - 59 years,9,7,16
Rest of Co. Offaly,2014,60 - 64 years,3,7,10
Rest of Co. Offaly,2014,65 - 69 years,8,12,20
Rest of Co. Offaly,2014,70 - 74 years,17,17,34
Rest of Co. Offaly,2014,75 - 79 years,11,20,31
Rest of Co. Offaly,2014,80 - 84 years,18,26,44
Rest of Co. Offaly,2014,85 years and over,65,41,106
Rest of Co. Offaly,2014,Under 1 year,2,1,3
Rest of Co. Offaly,2015,1 - 4 years,0,0,0
Rest of Co. Offaly,2015,10 - 14 years,0,2,2
Rest of Co. Offaly,2015,15 - 19 years,0,1,1
Rest of Co. Offaly,2015,20 - 24 years,1,0,1
Rest of Co. Offaly,2015,25 - 29 years,1,2,3
Rest of Co. Offaly,2015,30 - 34 years,1,3,4
Rest of Co. Offaly,2015,35 - 39 years,2,1,3
Rest of Co. Offaly,2015,40 - 44 years,2,2,4
Rest of Co. Offaly,2015,45 - 49 years,2,1,3
Rest of Co. Offaly,2015,5 - 9 years,1,2,3
Rest of Co. Offaly,2015,50 - 54 years,3,3,6
Rest of Co. Offaly,2015,55 - 59 years,9,7,16
Rest of Co. Offaly,2015,60 - 64 years,3,7,10
Rest of Co. Offaly,2015,65 - 69 years,8,12,20
Rest of Co. Offaly,2015,70 - 74 years,17,17,34
Rest of Co. Offaly,2015,75 - 79 years,11,20,31
Rest of Co. Offaly,2015,80 - 84 years,18,26,44
Rest of Co. Offaly,2015,85 years and over,65,41,106
Rest of Co. Offaly,2015,Under 1 year,2,1,3
Rest of Co. Offaly,2016,1 - 4 years,0,0,0
Rest of Co. Offaly,2016,10 - 14 years,0,2,2
Rest of Co. Offaly,2016,15 - 19 years,0,1,1
Rest of Co. Offaly,2016,20 - 24 years,1,0,1
Rest of Co. Offaly,2016,25 - 29 years,1,2,3
Rest of Co. Offaly,2016,30 - 34 years,1,3,4
Rest of Co. Offaly,2016,35 - 39 years,2,1,3
Rest of Co. Offaly,2016,40 - 44 years,2,2,4
Rest of Co. Offaly,2016,45 - 49 years,2,1,3
Rest of Co. Offaly,2016,5 - 9 years,1,2,3
Rest of Co. Offaly,2016,50 - 54 years,3,3,6
Rest of Co. Offaly,2016,55 - 59 years,9,7,16
Rest of Co. Offaly,2016,60 - 64 years,3,7,10
Rest of Co. Offaly,2016,65 - 69 years,8,12,20
Rest of Co. Offaly,2016,70 - 74 years,17,17,34
Rest of Co. Offaly,2016,75 - 79 years,11,20,31
Rest of Co. Offaly,2016,80 - 84 years,18,26,44
Rest of Co. Offaly,2016,85 years and over,65,41,106
Rest of Co. Offaly,2016,Under 1 year,2,1,3
Rest of Co. Offaly,2017,1 - 4 years,0,0,0
Rest of Co. Offaly,2017,10 - 14 years,0,2,2
Rest of Co. Offaly,2017,15 - 19 years,0,1,1
Rest of Co. Offaly,2017,20 - 24 years,1,3,4
Rest of Co. Offaly,2017,25 - 29 years,1,2,3
Rest of Co. Offaly,2017,30 - 34 years,1,3,4
Rest of Co. Offaly,2017,35 - 39 years,2,1,3
Rest of Co. Offaly,2017,40 - 44 years,3,4,7
Rest of Co. Offaly,2017,45 - 49 years,2,2,4
Rest of Co. Offaly,2017,5 - 9 years,1,2,3
Rest of Co. Offaly,2017,50 - 54 years,5,3,8
Rest of Co. Offaly,2017,55 - 59 years,2,7,9
Rest of Co. Offaly,2017,60 - 64 years,4,8,12
Rest of Co. Offaly,2017,65 - 69 years,10,12,22
Rest of Co. Offaly,2017,70 - 74 years,13,19,32
Rest of Co. Offaly,2017,75 - 79 years,16,19,35
Rest of Co. Offaly,2017,80 - 84 years,29,27,56
Rest of Co. Offaly,2017,85 years and over,55,41,96
Rest of Co. Offaly,2017,Under 1 year,2,1,3
Rest of Co. Offaly,2018,1 - 4 years,0,0,0
Rest of Co. Offaly,2018,10 - 14 years,0,0,0
Rest of Co. Offaly,2018,15 - 19 years,0,0,0
Rest of Co. Offaly,2018,20 - 24 years,1,0,1
Rest of Co. Offaly,2018,25 - 29 years,0,0,0
Rest of Co. Offaly,2018,30 - 34 years,1,1,2
Rest of Co. Offaly,2018,35 - 39 years,0,1,1
Rest of Co. Offaly,2018,40 - 44 years,0,1,1
Rest of Co. Offaly,2018,45 - 49 years,6,0,6
Rest of Co. Offaly,2018,5 - 9 years,0,0,0
Rest of Co. Offaly,2018,50 - 54 years,3,3,6
Rest of Co. Offaly,2018,55 - 59 years,1,2,3
Rest of Co. Offaly,2018,60 - 64 years,5,5,10
Rest of Co. Offaly,2018,65 - 69 years,16,15,31
Rest of Co. Offaly,2018,70 - 74 years,9,18,27
Rest of Co. Offaly,2018,75 - 79 years,18,23,41
Rest of Co. Offaly,2018,80 - 84 years,18,22,40
Rest of Co. Offaly,2018,85 years and over,61,52,113
Rest of Co. Offaly,2018,Under 1 year,1,2,3
Rest of Co. Offaly,2019,1 - 4 years,0,0,0
Rest of Co. Offaly,2019,10 - 14 years,0,0,0
Rest of Co. Offaly,2019,15 - 19 years,0,0,0
Rest of Co. Offaly,2019,20 - 24 years,1,0,1
Rest of Co. Offaly,2019,25 - 29 years,0,0,0
Rest of Co. Offaly,2019,30 - 34 years,1,1,2
Rest of Co. Offaly,2019,35 - 39 years,0,1,1
Rest of Co. Offaly,2019,40 - 44 years,0,1,1
Rest of Co. Offaly,2019,45 - 49 years,6,0,6
Rest of Co. Offaly,2019,5 - 9 years,0,0,0
Rest of Co. Offaly,2019,50 - 54 years,3,3,6
Rest of Co. Offaly,2019,55 - 59 years,1,2,3
Rest of Co. Offaly,2019,60 - 64 years,5,5,10
Rest of Co. Offaly,2019,65 - 69 years,16,15,31
Rest of Co. Offaly,2019,70 - 74 years,9,18,27
Rest of Co. Offaly,2019,75 - 79 years,18,23,41
Rest of Co. Offaly,2019,80 - 84 years,18,22,40
Rest of Co. Offaly,2019,85 years and over,61,52,113
Rest of Co. Offaly,2019,Under 1 year,1,2,3
Rest of Co. Offaly,2020,1 - 4 years,0,0,0
Rest of Co. Offaly,2020,10 - 14 years,0,0,0
Rest of Co. Offaly,2020,15 - 19 years,0,0,0
Rest of Co. Offaly,2020,20 - 24 years,1,0,1
Rest of Co. Offaly,2020,25 - 29 years,0,0,0
Rest of Co. Offaly,2020,30 - 34 years,1,1,2
Rest of Co. Offaly,2020,35 - 39 years,0,1,1
Rest of Co. Offaly,2020,40 - 44 years,0,1,1
Rest of Co. Offaly,2020,45 - 49 years,6,0,6
Rest of Co. Offaly,2020,5 - 9 years,0,0,0
Rest of Co. Offaly,2020,50 - 54 years,3,3,6
Rest of Co. Offaly,2020,55 - 59 years,1,2,3
Rest of Co. Offaly,2020,60 - 64 years,5,5,10
Rest of Co. Offaly,2020,65 - 69 years,16,15,31
Rest of Co. Offaly,2020,70 - 74 years,9,18,27
Rest of Co. Offaly,2020,75 - 79 years,18,23,41
Rest of Co. Offaly,2020,80 - 84 years,18,22,40
Rest of Co. Offaly,2020,85 years and over,61,52,113
Rest of Co. Offaly,2020,Under 1 year,1,2,3
Rest of Co. Sligo,2007,1 - 4 years,0,0,0
Rest of Co. Sligo,2007,10 - 14 years,0,0,0
Rest of Co. Sligo,2007,15 - 19 years,0,1,1
Rest of Co. Sligo,2007,20 - 24 years,1,2,3
Rest of Co. Sligo,2007,25 - 29 years,0,0,0
Rest of Co. Sligo,2007,30 - 34 years,1,2,3
Rest of Co. Sligo,2007,35 - 39 years,0,1,1
Rest of Co. Sligo,2007,40 - 44 years,1,5,6
Rest of Co. Sligo,2007,45 - 49 years,2,5,7
Rest of Co. Sligo,2007,5 - 9 years,0,0,0
Rest of Co. Sligo,2007,50 - 54 years,5,2,7
Rest of Co. Sligo,2007,55 - 59 years,5,7,12
Rest of Co. Sligo,2007,60 - 64 years,8,9,17
Rest of Co. Sligo,2007,65 - 69 years,5,15,20
Rest of Co. Sligo,2007,70 - 74 years,20,24,44
Rest of Co. Sligo,2007,75 - 79 years,21,30,51
Rest of Co. Sligo,2007,80 - 84 years,35,38,73
Rest of Co. Sligo,2007,85 years and over,76,59,135
Rest of Co. Sligo,2007,Under 1 year,2,1,3
Rest of Co. Sligo,2008,1 - 4 years,0,1,1
Rest of Co. Sligo,2008,10 - 14 years,2,0,2
Rest of Co. Sligo,2008,15 - 19 years,1,1,2
Rest of Co. Sligo,2008,20 - 24 years,1,2,3
Rest of Co. Sligo,2008,25 - 29 years,0,1,1
Rest of Co. Sligo,2008,30 - 34 years,1,1,2
Rest of Co. Sligo,2008,35 - 39 years,1,2,3
Rest of Co. Sligo,2008,40 - 44 years,1,1,2
Rest of Co. Sligo,2008,45 - 49 years,2,2,4
Rest of Co. Sligo,2008,5 - 9 years,0,0,0
Rest of Co. Sligo,2008,50 - 54 years,3,3,6
Rest of Co. Sligo,2008,55 - 59 years,6,6,12
Rest of Co. Sligo,2008,60 - 64 years,5,12,17
Rest of Co. Sligo,2008,65 - 69 years,10,13,23
Rest of Co. Sligo,2008,70 - 74 years,10,21,31
Rest of Co. Sligo,2008,75 - 79 years,18,26,44
Rest of Co. Sligo,2008,80 - 84 years,41,39,80
Rest of Co. Sligo,2008,85 years and over,79,48,127
Rest of Co. Sligo,2008,Under 1 year,1,4,5
Rest of Co. Sligo,2009,1 - 4 years,0,1,1
Rest of Co. Sligo,2009,10 - 14 years,2,0,2
Rest of Co. Sligo,2009,15 - 19 years,1,1,2
Rest of Co. Sligo,2009,20 - 24 years,1,1,2
Rest of Co. Sligo,2009,25 - 29 years,1,1,2
Rest of Co. Sligo,2009,30 - 34 years,1,1,2
Rest of Co. Sligo,2009,35 - 39 years,1,4,5
Rest of Co. Sligo,2009,40 - 44 years,1,1,2
Rest of Co. Sligo,2009,45 - 49 years,4,3,7
Rest of Co. Sligo,2009,5 - 9 years,1,0,1
Rest of Co. Sligo,2009,50 - 54 years,7,6,13
Rest of Co. Sligo,2009,55 - 59 years,5,8,13
Rest of Co. Sligo,2009,60 - 64 years,7,15,22
Rest of Co. Sligo,2009,65 - 69 years,7,16,23
Rest of Co. Sligo,2009,70 - 74 years,15,17,32
Rest of Co. Sligo,2009,75 - 79 years,10,26,36
Rest of Co. Sligo,2009,80 - 84 years,27,36,63
Rest of Co. Sligo,2009,85 years and over,83,27,110
Rest of Co. Sligo,2009,Under 1 year,1,1,2
Rest of Co. Sligo,2010,1 - 4 years,0,1,1
Rest of Co. Sligo,2010,10 - 14 years,2,0,2
Rest of Co. Sligo,2010,15 - 19 years,1,1,2
Rest of Co. Sligo,2010,20 - 24 years,1,1,2
Rest of Co. Sligo,2010,25 - 29 years,1,1,2
Rest of Co. Sligo,2010,30 - 34 years,1,2,3
Rest of Co. Sligo,2010,35 - 39 years,1,1,2
Rest of Co. Sligo,2010,40 - 44 years,3,1,4
Rest of Co. Sligo,2010,45 - 49 years,1,4,5
Rest of Co. Sligo,2010,5 - 9 years,1,0,1
Rest of Co. Sligo,2010,50 - 54 years,6,4,10
Rest of Co. Sligo,2010,55 - 59 years,4,11,15
Rest of Co. Sligo,2010,60 - 64 years,5,6,11
Rest of Co. Sligo,2010,65 - 69 years,7,17,24
Rest of Co. Sligo,2010,70 - 74 years,10,13,23
Rest of Co. Sligo,2010,75 - 79 years,8,26,34
Rest of Co. Sligo,2010,80 - 84 years,27,25,52
Rest of Co. Sligo,2010,85 years and over,71,52,123
Rest of Co. Sligo,2010,Under 1 year,1,1,2
Rest of Co. Sligo,2011,1 - 4 years,0,0,0
Rest of Co. Sligo,2011,10 - 14 years,0,1,1
Rest of Co. Sligo,2011,15 - 19 years,1,0,1
Rest of Co. Sligo,2011,20 - 24 years,1,1,2
Rest of Co. Sligo,2011,25 - 29 years,0,0,0
Rest of Co. Sligo,2011,30 - 34 years,1,1,2
Rest of Co. Sligo,2011,35 - 39 years,0,0,0
Rest of Co. Sligo,2011,40 - 44 years,3,2,5
Rest of Co. Sligo,2011,45 - 49 years,1,7,8
Rest of Co. Sligo,2011,5 - 9 years,0,0,0
Rest of Co. Sligo,2011,50 - 54 years,6,4,10
Rest of Co. Sligo,2011,55 - 59 years,6,10,16
Rest of Co. Sligo,2011,60 - 64 years,6,17,23
Rest of Co. Sligo,2011,65 - 69 years,5,15,20
Rest of Co. Sligo,2011,70 - 74 years,8,21,29
Rest of Co. Sligo,2011,75 - 79 years,19,30,49
Rest of Co. Sligo,2011,80 - 84 years,32,40,72
Rest of Co. Sligo,2011,85 years and over,62,44,106
Rest of Co. Sligo,2011,Under 1 year,3,1,4
Rest of Co. Sligo,2012,1 - 4 years,0,0,0
Rest of Co. Sligo,2012,10 - 14 years,0,1,1
Rest of Co. Sligo,2012,15 - 19 years,1,0,1
Rest of Co. Sligo,2012,20 - 24 years,1,2,3
Rest of Co. Sligo,2012,25 - 29 years,0,1,1
Rest of Co. Sligo,2012,30 - 34 years,1,4,5
Rest of Co. Sligo,2012,35 - 39 years,2,0,2
Rest of Co. Sligo,2012,40 - 44 years,1,2,3
Rest of Co. Sligo,2012,45 - 49 years,3,2,5
Rest of Co. Sligo,2012,5 - 9 years,0,0,0
Rest of Co. Sligo,2012,50 - 54 years,2,2,4
Rest of Co. Sligo,2012,55 - 59 years,8,9,17
Rest of Co. Sligo,2012,60 - 64 years,4,7,11
Rest of Co. Sligo,2012,65 - 69 years,14,20,34
Rest of Co. Sligo,2012,70 - 74 years,10,20,30
Rest of Co. Sligo,2012,75 - 79 years,22,22,44
Rest of Co. Sligo,2012,80 - 84 years,24,30,54
Rest of Co. Sligo,2012,85 years and over,82,47,129
Rest of Co. Sligo,2012,Under 1 year,1,2,3
Rest of Co. Sligo,2013,1 - 4 years,1,1,2
Rest of Co. Sligo,2013,10 - 14 years,0,1,1
Rest of Co. Sligo,2013,15 - 19 years,0,0,0
Rest of Co. Sligo,2013,20 - 24 years,0,2,2
Rest of Co. Sligo,2013,25 - 29 years,0,0,0
Rest of Co. Sligo,2013,30 - 34 years,0,2,2
Rest of Co. Sligo,2013,35 - 39 years,0,0,0
Rest of Co. Sligo,2013,40 - 44 years,1,1,2
Rest of Co. Sligo,2013,45 - 49 years,2,4,6
Rest of Co. Sligo,2013,5 - 9 years,0,0,0
Rest of Co. Sligo,2013,50 - 54 years,3,6,9
Rest of Co. Sligo,2013,55 - 59 years,6,8,14
Rest of Co. Sligo,2013,60 - 64 years,9,10,19
Rest of Co. Sligo,2013,65 - 69 years,10,22,32
Rest of Co. Sligo,2013,70 - 74 years,8,26,34
Rest of Co. Sligo,2013,75 - 79 years,23,29,52
Rest of Co. Sligo,2013,80 - 84 years,25,26,51
Rest of Co. Sligo,2013,85 years and over,78,52,130
Rest of Co. Sligo,2013,Under 1 year,2,1,3
Rest of Co. Sligo,2014,1 - 4 years,1,1,2
Rest of Co. Sligo,2014,10 - 14 years,1,1,2
Rest of Co. Sligo,2014,15 - 19 years,0,0,0
Rest of Co. Sligo,2014,20 - 24 years,1,2,3
Rest of Co. Sligo,2014,25 - 29 years,0,2,2
Rest of Co. Sligo,2014,30 - 34 years,1,1,2
Rest of Co. Sligo,2014,35 - 39 years,2,1,3
Rest of Co. Sligo,2014,40 - 44 years,1,3,4
Rest of Co. Sligo,2014,45 - 49 years,1,6,7
Rest of Co. Sligo,2014,5 - 9 years,0,0,0
Rest of Co. Sligo,2014,50 - 54 years,3,6,9
Rest of Co. Sligo,2014,55 - 59 years,6,12,18
Rest of Co. Sligo,2014,60 - 64 years,7,8,15
Rest of Co. Sligo,2014,65 - 69 years,4,25,29
Rest of Co. Sligo,2014,70 - 74 years,10,17,27
Rest of Co. Sligo,2014,75 - 79 years,11,25,36
Rest of Co. Sligo,2014,80 - 84 years,21,25,46
Rest of Co. Sligo,2014,85 years and over,78,49,127
Rest of Co. Sligo,2014,Under 1 year,2,1,3
Rest of Co. Sligo,2015,1 - 4 years,1,1,2
Rest of Co. Sligo,2015,10 - 14 years,1,1,2
Rest of Co. Sligo,2015,15 - 19 years,0,0,0
Rest of Co. Sligo,2015,20 - 24 years,1,2,3
Rest of Co. Sligo,2015,25 - 29 years,0,2,2
Rest of Co. Sligo,2015,30 - 34 years,1,1,2
Rest of Co. Sligo,2015,35 - 39 years,2,1,3
Rest of Co. Sligo,2015,40 - 44 years,1,3,4
Rest of Co. Sligo,2015,45 - 49 years,1,6,7
Rest of Co. Sligo,2015,5 - 9 years,0,0,0
Rest of Co. Sligo,2015,50 - 54 years,3,6,9
Rest of Co. Sligo,2015,55 - 59 years,6,12,18
Rest of Co. Sligo,2015,60 - 64 years,7,8,15
Rest of Co. Sligo,2015,65 - 69 years,4,25,29
Rest of Co. Sligo,2015,70 - 74 years,10,17,27
Rest of Co. Sligo,2015,75 - 79 years,11,25,36
Rest of Co. Sligo,2015,80 - 84 years,21,25,46
Rest of Co. Sligo,2015,85 years and over,78,49,127
Rest of Co. Sligo,2015,Under 1 year,2,1,3
Rest of Co. Sligo,2016,1 - 4 years,1,1,2
Rest of Co. Sligo,2016,10 - 14 years,1,1,2
Rest of Co. Sligo,2016,15 - 19 years,0,0,0
Rest of Co. Sligo,2016,20 - 24 years,1,2,3
Rest of Co. Sligo,2016,25 - 29 years,0,2,2
Rest of Co. Sligo,2016,30 - 34 years,1,1,2
Rest of Co. Sligo,2016,35 - 39 years,2,1,3
Rest of Co. Sligo,2016,40 - 44 years,1,3,4
Rest of Co. Sligo,2016,45 - 49 years,1,6,7
Rest of Co. Sligo,2016,5 - 9 years,0,0,0
Rest of Co. Sligo,2016,50 - 54 years,3,6,9
Rest of Co. Sligo,2016,55 - 59 years,6,12,18
Rest of Co. Sligo,2016,60 - 64 years,7,8,15
Rest of Co. Sligo,2016,65 - 69 years,4,25,29
Rest of Co. Sligo,2016,70 - 74 years,10,17,27
Rest of Co. Sligo,2016,75 - 79 years,11,25,36
Rest of Co. Sligo,2016,80 - 84 years,21,25,46
Rest of Co. Sligo,2016,85 years and over,78,49,127
Rest of Co. Sligo,2016,Under 1 year,2,1,3
Rest of Co. Sligo,2017,1 - 4 years,1,1,2
Rest of Co. Sligo,2017,10 - 14 years,1,1,2
Rest of Co. Sligo,2017,15 - 19 years,1,0,1
Rest of Co. Sligo,2017,20 - 24 years,1,2,3
Rest of Co. Sligo,2017,25 - 29 years,0,1,1
Rest of Co. Sligo,2017,30 - 34 years,1,2,3
Rest of Co. Sligo,2017,35 - 39 years,2,1,3
Rest of Co. Sligo,2017,40 - 44 years,1,4,5
Rest of Co. Sligo,2017,45 - 49 years,1,3,4
Rest of Co. Sligo,2017,5 - 9 years,0,0,0
Rest of Co. Sligo,2017,50 - 54 years,4,6,10
Rest of Co. Sligo,2017,55 - 59 years,7,6,13
Rest of Co. Sligo,2017,60 - 64 years,6,13,19
Rest of Co. Sligo,2017,65 - 69 years,11,12,23
Rest of Co. Sligo,2017,70 - 74 years,5,21,26
Rest of Co. Sligo,2017,75 - 79 years,16,25,41
Rest of Co. Sligo,2017,80 - 84 years,19,30,49
Rest of Co. Sligo,2017,85 years and over,74,62,136
Rest of Co. Sligo,2017,Under 1 year,2,2,4
Rest of Co. Sligo,2018,1 - 4 years,0,0,0
Rest of Co. Sligo,2018,10 - 14 years,0,0,0
Rest of Co. Sligo,2018,15 - 19 years,0,0,0
Rest of Co. Sligo,2018,20 - 24 years,1,0,1
Rest of Co. Sligo,2018,25 - 29 years,1,0,1
Rest of Co. Sligo,2018,30 - 34 years,0,0,0
Rest of Co. Sligo,2018,35 - 39 years,1,1,2
Rest of Co. Sligo,2018,40 - 44 years,0,2,2
Rest of Co. Sligo,2018,45 - 49 years,4,4,8
Rest of Co. Sligo,2018,5 - 9 years,0,0,0
Rest of Co. Sligo,2018,50 - 54 years,3,7,10
Rest of Co. Sligo,2018,55 - 59 years,2,4,6
Rest of Co. Sligo,2018,60 - 64 years,4,11,15
Rest of Co. Sligo,2018,65 - 69 years,13,20,33
Rest of Co. Sligo,2018,70 - 74 years,14,18,32
Rest of Co. Sligo,2018,75 - 79 years,17,36,53
Rest of Co. Sligo,2018,80 - 84 years,21,27,48
Rest of Co. Sligo,2018,85 years and over,74,59,133
Rest of Co. Sligo,2018,Under 1 year,0,1,1
Rest of Co. Sligo,2019,1 - 4 years,0,0,0
Rest of Co. Sligo,2019,10 - 14 years,0,0,0
Rest of Co. Sligo,2019,15 - 19 years,0,0,0
Rest of Co. Sligo,2019,20 - 24 years,1,0,1
Rest of Co. Sligo,2019,25 - 29 years,1,0,1
Rest of Co. Sligo,2019,30 - 34 years,0,0,0
Rest of Co. Sligo,2019,35 - 39 years,1,1,2
Rest of Co. Sligo,2019,40 - 44 years,0,2,2
Rest of Co. Sligo,2019,45 - 49 years,4,4,8
Rest of Co. Sligo,2019,5 - 9 years,0,0,0
Rest of Co. Sligo,2019,50 - 54 years,3,7,10
Rest of Co. Sligo,2019,55 - 59 years,2,4,6
Rest of Co. Sligo,2019,60 - 64 years,4,11,15
Rest of Co. Sligo,2019,65 - 69 years,13,20,33
Rest of Co. Sligo,2019,70 - 74 years,14,18,32
Rest of Co. Sligo,2019,75 - 79 years,17,36,53
Rest of Co. Sligo,2019,80 - 84 years,21,27,48
Rest of Co. Sligo,2019,85 years and over,74,59,133
Rest of Co. Sligo,2019,Under 1 year,0,1,1
Rest of Co. Sligo,2020,1 - 4 years,0,0,0
Rest of Co. Sligo,2020,10 - 14 years,0,0,0
Rest of Co. Sligo,2020,15 - 19 years,0,0,0
Rest of Co. Sligo,2020,20 - 24 years,1,0,1
Rest of Co. Sligo,2020,25 - 29 years,1,0,1
Rest of Co. Sligo,2020,30 - 34 years,0,0,0
Rest of Co. Sligo,2020,35 - 39 years,1,1,2
Rest of Co. Sligo,2020,40 - 44 years,0,2,2
Rest of Co. Sligo,2020,45 - 49 years,4,4,8
Rest of Co. Sligo,2020,5 - 9 years,0,0,0
Rest of Co. Sligo,2020,50 - 54 years,3,7,10
Rest of Co. Sligo,2020,55 - 59 years,2,4,6
Rest of Co. Sligo,2020,60 - 64 years,4,11,15
Rest of Co. Sligo,2020,65 - 69 years,13,20,33
Rest of Co. Sligo,2020,70 - 74 years,14,18,32
Rest of Co. Sligo,2020,75 - 79 years,17,36,53
Rest of Co. Sligo,2020,80 - 84 years,21,27,48
Rest of Co. Sligo,2020,85 years and over,74,59,133
Rest of Co. Sligo,2020,Under 1 year,0,1,1
Rest of Co. Westmeath,2007,1 - 4 years,1,1,2
Rest of Co. Westmeath,2007,10 - 14 years,0,0,0
Rest of Co. Westmeath,2007,15 - 19 years,2,2,4
Rest of Co. Westmeath,2007,20 - 24 years,1,2,3
Rest of Co. Westmeath,2007,25 - 29 years,0,2,2
Rest of Co. Westmeath,2007,30 - 34 years,2,2,4
Rest of Co. Westmeath,2007,35 - 39 years,0,5,5
Rest of Co. Westmeath,2007,40 - 44 years,2,5,7
Rest of Co. Westmeath,2007,45 - 49 years,2,3,5
Rest of Co. Westmeath,2007,5 - 9 years,0,0,0
Rest of Co. Westmeath,2007,50 - 54 years,7,8,15
Rest of Co. Westmeath,2007,55 - 59 years,5,15,20
Rest of Co. Westmeath,2007,60 - 64 years,5,17,22
Rest of Co. Westmeath,2007,65 - 69 years,9,17,26
Rest of Co. Westmeath,2007,70 - 74 years,21,20,41
Rest of Co. Westmeath,2007,75 - 79 years,25,36,61
Rest of Co. Westmeath,2007,80 - 84 years,33,25,58
Rest of Co. Westmeath,2007,85 years and over,71,49,120
Rest of Co. Westmeath,2007,Under 1 year,2,3,5
Rest of Co. Westmeath,2008,1 - 4 years,1,1,2
Rest of Co. Westmeath,2008,10 - 14 years,0,0,0
Rest of Co. Westmeath,2008,15 - 19 years,2,3,5
Rest of Co. Westmeath,2008,20 - 24 years,3,1,4
Rest of Co. Westmeath,2008,25 - 29 years,0,5,5
Rest of Co. Westmeath,2008,30 - 34 years,1,1,2
Rest of Co. Westmeath,2008,35 - 39 years,2,1,3
Rest of Co. Westmeath,2008,40 - 44 years,1,1,2
Rest of Co. Westmeath,2008,45 - 49 years,2,2,4
Rest of Co. Westmeath,2008,5 - 9 years,0,0,0
Rest of Co. Westmeath,2008,50 - 54 years,12,6,18
Rest of Co. Westmeath,2008,55 - 59 years,9,10,19
Rest of Co. Westmeath,2008,60 - 64 years,6,20,26
Rest of Co. Westmeath,2008,65 - 69 years,9,19,28
Rest of Co. Westmeath,2008,70 - 74 years,9,19,28
Rest of Co. Westmeath,2008,75 - 79 years,23,37,60
Rest of Co. Westmeath,2008,80 - 84 years,31,29,60
Rest of Co. Westmeath,2008,85 years and over,88,30,118
Rest of Co. Westmeath,2008,Under 1 year,2,2,4
Rest of Co. Westmeath,2009,1 - 4 years,1,1,2
Rest of Co. Westmeath,2009,10 - 14 years,0,0,0
Rest of Co. Westmeath,2009,15 - 19 years,1,2,3
Rest of Co. Westmeath,2009,20 - 24 years,1,1,2
Rest of Co. Westmeath,2009,25 - 29 years,0,3,3
Rest of Co. Westmeath,2009,30 - 34 years,2,2,4
Rest of Co. Westmeath,2009,35 - 39 years,1,5,6
Rest of Co. Westmeath,2009,40 - 44 years,2,4,6
Rest of Co. Westmeath,2009,45 - 49 years,3,9,12
Rest of Co. Westmeath,2009,5 - 9 years,1,0,1
Rest of Co. Westmeath,2009,50 - 54 years,4,7,11
Rest of Co. Westmeath,2009,55 - 59 years,6,15,21
Rest of Co. Westmeath,2009,60 - 64 years,5,17,22
Rest of Co. Westmeath,2009,65 - 69 years,9,19,28
Rest of Co. Westmeath,2009,70 - 74 years,18,24,42
Rest of Co. Westmeath,2009,75 - 79 years,28,25,53
Rest of Co. Westmeath,2009,80 - 84 years,41,40,81
Rest of Co. Westmeath,2009,85 years and over,78,49,127
Rest of Co. Westmeath,2009,Under 1 year,2,5,7
Rest of Co. Westmeath,2010,1 - 4 years,1,1,2
Rest of Co. Westmeath,2010,10 - 14 years,0,0,0
Rest of Co. Westmeath,2010,15 - 19 years,1,1,2
Rest of Co. Westmeath,2010,20 - 24 years,1,3,4
Rest of Co. Westmeath,2010,25 - 29 years,2,2,4
Rest of Co. Westmeath,2010,30 - 34 years,1,1,2
Rest of Co. Westmeath,2010,35 - 39 years,1,7,8
Rest of Co. Westmeath,2010,40 - 44 years,2,1,3
Rest of Co. Westmeath,2010,45 - 49 years,1,5,6
Rest of Co. Westmeath,2010,5 - 9 years,1,0,1
Rest of Co. Westmeath,2010,50 - 54 years,10,11,21
Rest of Co. Westmeath,2010,55 - 59 years,8,6,14
Rest of Co. Westmeath,2010,60 - 64 years,10,18,28
Rest of Co. Westmeath,2010,65 - 69 years,11,22,33
Rest of Co. Westmeath,2010,70 - 74 years,15,26,41
Rest of Co. Westmeath,2010,75 - 79 years,24,29,53
Rest of Co. Westmeath,2010,80 - 84 years,32,45,77
Rest of Co. Westmeath,2010,85 years and over,87,58,145
Rest of Co. Westmeath,2010,Under 1 year,1,1,2
Rest of Co. Westmeath,2011,1 - 4 years,2,0,2
Rest of Co. Westmeath,2011,10 - 14 years,0,0,0
Rest of Co. Westmeath,2011,15 - 19 years,0,0,0
Rest of Co. Westmeath,2011,20 - 24 years,0,1,1
Rest of Co. Westmeath,2011,25 - 29 years,2,3,5
Rest of Co. Westmeath,2011,30 - 34 years,0,4,4
Rest of Co. Westmeath,2011,35 - 39 years,2,1,3
Rest of Co. Westmeath,2011,40 - 44 years,3,2,5
Rest of Co. Westmeath,2011,45 - 49 years,5,3,8
Rest of Co. Westmeath,2011,5 - 9 years,0,0,0
Rest of Co. Westmeath,2011,50 - 54 years,6,9,15
Rest of Co. Westmeath,2011,55 - 59 years,10,9,19
Rest of Co. Westmeath,2011,60 - 64 years,10,15,25
Rest of Co. Westmeath,2011,65 - 69 years,10,25,35
Rest of Co. Westmeath,2011,70 - 74 years,20,27,47
Rest of Co. Westmeath,2011,75 - 79 years,26,43,69
Rest of Co. Westmeath,2011,80 - 84 years,38,36,74
Rest of Co. Westmeath,2011,85 years and over,91,57,148
Rest of Co. Westmeath,2011,Under 1 year,3,3,6
Rest of Co. Westmeath,2012,1 - 4 years,2,0,2
Rest of Co. Westmeath,2012,10 - 14 years,0,0,0
Rest of Co. Westmeath,2012,15 - 19 years,0,1,1
Rest of Co. Westmeath,2012,20 - 24 years,0,1,1
Rest of Co. Westmeath,2012,25 - 29 years,2,4,6
Rest of Co. Westmeath,2012,30 - 34 years,0,2,2
Rest of Co. Westmeath,2012,35 - 39 years,2,1,3
Rest of Co. Westmeath,2012,40 - 44 years,3,3,6
Rest of Co. Westmeath,2012,45 - 49 years,3,3,6
Rest of Co. Westmeath,2012,5 - 9 years,0,0,0
Rest of Co. Westmeath,2012,50 - 54 years,7,5,12
Rest of Co. Westmeath,2012,55 - 59 years,5,13,18
Rest of Co. Westmeath,2012,60 - 64 years,10,11,21
Rest of Co. Westmeath,2012,65 - 69 years,14,25,39
Rest of Co. Westmeath,2012,70 - 74 years,21,28,49
Rest of Co. Westmeath,2012,75 - 79 years,28,31,59
Rest of Co. Westmeath,2012,80 - 84 years,42,45,87
Rest of Co. Westmeath,2012,85 years and over,116,61,177
Rest of Co. Westmeath,2012,Under 1 year,2,5,7
Rest of Co. Westmeath,2013,1 - 4 years,0,0,0
Rest of Co. Westmeath,2013,10 - 14 years,0,0,0
Rest of Co. Westmeath,2013,15 - 19 years,0,0,0
Rest of Co. Westmeath,2013,20 - 24 years,1,1,2
Rest of Co. Westmeath,2013,25 - 29 years,1,2,3
Rest of Co. Westmeath,2013,30 - 34 years,0,1,1
Rest of Co. Westmeath,2013,35 - 39 years,2,4,6
Rest of Co. Westmeath,2013,40 - 44 years,2,3,5
Rest of Co. Westmeath,2013,45 - 49 years,2,3,5
Rest of Co. Westmeath,2013,5 - 9 years,0,0,0
Rest of Co. Westmeath,2013,50 - 54 years,1,6,7
Rest of Co. Westmeath,2013,55 - 59 years,6,4,10
Rest of Co. Westmeath,2013,60 - 64 years,8,18,26
Rest of Co. Westmeath,2013,65 - 69 years,7,10,17
Rest of Co. Westmeath,2013,70 - 74 years,10,22,32
Rest of Co. Westmeath,2013,75 - 79 years,20,20,40
Rest of Co. Westmeath,2013,80 - 84 years,28,38,66
Rest of Co. Westmeath,2013,85 years and over,75,64,139
Rest of Co. Westmeath,2013,Under 1 year,1,3,4
Rest of Co. Westmeath,2014,1 - 4 years,0,0,0
Rest of Co. Westmeath,2014,10 - 14 years,0,1,1
Rest of Co. Westmeath,2014,15 - 19 years,0,0,0
Rest of Co. Westmeath,2014,20 - 24 years,1,1,2
Rest of Co. Westmeath,2014,25 - 29 years,2,1,3
Rest of Co. Westmeath,2014,30 - 34 years,1,1,2
Rest of Co. Westmeath,2014,35 - 39 years,2,4,6
Rest of Co. Westmeath,2014,40 - 44 years,2,2,4
Rest of Co. Westmeath,2014,45 - 49 years,5,6,11
Rest of Co. Westmeath,2014,5 - 9 years,1,1,2
Rest of Co. Westmeath,2014,50 - 54 years,6,7,13
Rest of Co. Westmeath,2014,55 - 59 years,5,8,13
Rest of Co. Westmeath,2014,60 - 64 years,8,9,17
Rest of Co. Westmeath,2014,65 - 69 years,11,18,29
Rest of Co. Westmeath,2014,70 - 74 years,13,20,33
Rest of Co. Westmeath,2014,75 - 79 years,13,33,46
Rest of Co. Westmeath,2014,80 - 84 years,31,43,74
Rest of Co. Westmeath,2014,85 years and over,84,65,149
Rest of Co. Westmeath,2014,Under 1 year,1,3,4
Rest of Co. Westmeath,2015,1 - 4 years,0,0,0
Rest of Co. Westmeath,2015,10 - 14 years,0,1,1
Rest of Co. Westmeath,2015,15 - 19 years,0,0,0
Rest of Co. Westmeath,2015,20 - 24 years,1,1,2
Rest of Co. Westmeath,2015,25 - 29 years,2,1,3
Rest of Co. Westmeath,2015,30 - 34 years,1,1,2
Rest of Co. Westmeath,2015,35 - 39 years,2,4,6
Rest of Co. Westmeath,2015,40 - 44 years,2,2,4
Rest of Co. Westmeath,2015,45 - 49 years,5,6,11
Rest of Co. Westmeath,2015,5 - 9 years,1,1,2
Rest of Co. Westmeath,2015,50 - 54 years,6,7,13
Rest of Co. Westmeath,2015,55 - 59 years,5,8,13
Rest of Co. Westmeath,2015,60 - 64 years,8,9,17
Rest of Co. Westmeath,2015,65 - 69 years,11,18,29
Rest of Co. Westmeath,2015,70 - 74 years,13,20,33
Rest of Co. Westmeath,2015,75 - 79 years,13,33,46
Rest of Co. Westmeath,2015,80 - 84 years,31,43,74
Rest of Co. Westmeath,2015,85 years and over,84,65,149
Rest of Co. Westmeath,2015,Under 1 year,1,3,4
Rest of Co. Westmeath,2016,1 - 4 years,0,0,0
Rest of Co. Westmeath,2016,10 - 14 years,0,1,1
Rest of Co. Westmeath,2016,15 - 19 years,0,0,0
Rest of Co. Westmeath,2016,20 - 24 years,1,1,2
Rest of Co. Westmeath,2016,25 - 29 years,2,1,3
Rest of Co. Westmeath,2016,30 - 34 years,1,1,2
Rest of Co. Westmeath,2016,35 - 39 years,2,4,6
Rest of Co. Westmeath,2016,40 - 44 years,2,2,4
Rest of Co. Westmeath,2016,45 - 49 years,5,6,11
Rest of Co. Westmeath,2016,5 - 9 years,1,1,2
Rest of Co. Westmeath,2016,50 - 54 years,6,7,13
Rest of Co. Westmeath,2016,55 - 59 years,5,8,13
Rest of Co. Westmeath,2016,60 - 64 years,8,9,17
Rest of Co. Westmeath,2016,65 - 69 years,11,18,29
Rest of Co. Westmeath,2016,70 - 74 years,13,20,33
Rest of Co. Westmeath,2016,75 - 79 years,13,33,46
Rest of Co. Westmeath,2016,80 - 84 years,31,43,74
Rest of Co. Westmeath,2016,85 years and over,84,65,149
Rest of Co. Westmeath,2016,Under 1 year,1,3,4
Rest of Co. Westmeath,2017,1 - 4 years,0,0,0
Rest of Co. Westmeath,2017,10 - 14 years,1,1,2
Rest of Co. Westmeath,2017,15 - 19 years,0,0,0
Rest of Co. Westmeath,2017,20 - 24 years,1,3,4
Rest of Co. Westmeath,2017,25 - 29 years,2,1,3
Rest of Co. Westmeath,2017,30 - 34 years,1,2,3
Rest of Co. Westmeath,2017,35 - 39 years,2,4,6
Rest of Co. Westmeath,2017,40 - 44 years,1,1,2
Rest of Co. Westmeath,2017,45 - 49 years,3,3,6
Rest of Co. Westmeath,2017,5 - 9 years,1,1,2
Rest of Co. Westmeath,2017,50 - 54 years,4,6,10
Rest of Co. Westmeath,2017,55 - 59 years,4,8,12
Rest of Co. Westmeath,2017,60 - 64 years,3,6,9
Rest of Co. Westmeath,2017,65 - 69 years,8,18,26
Rest of Co. Westmeath,2017,70 - 74 years,11,26,37
Rest of Co. Westmeath,2017,75 - 79 years,19,25,44
Rest of Co. Westmeath,2017,80 - 84 years,34,34,68
Rest of Co. Westmeath,2017,85 years and over,77,51,128
Rest of Co. Westmeath,2017,Under 1 year,1,1,2
Rest of Co. Westmeath,2018,1 - 4 years,0,0,0
Rest of Co. Westmeath,2018,10 - 14 years,0,0,0
Rest of Co. Westmeath,2018,15 - 19 years,0,2,2
Rest of Co. Westmeath,2018,20 - 24 years,0,0,0
Rest of Co. Westmeath,2018,25 - 29 years,1,1,2
Rest of Co. Westmeath,2018,30 - 34 years,2,1,3
Rest of Co. Westmeath,2018,35 - 39 years,0,2,2
Rest of Co. Westmeath,2018,40 - 44 years,4,0,4
Rest of Co. Westmeath,2018,45 - 49 years,3,6,9
Rest of Co. Westmeath,2018,5 - 9 years,0,0,0
Rest of Co. Westmeath,2018,50 - 54 years,5,6,11
Rest of Co. Westmeath,2018,55 - 59 years,5,8,13
Rest of Co. Westmeath,2018,60 - 64 years,5,17,22
Rest of Co. Westmeath,2018,65 - 69 years,10,12,22
Rest of Co. Westmeath,2018,70 - 74 years,14,19,33
Rest of Co. Westmeath,2018,75 - 79 years,21,24,45
Rest of Co. Westmeath,2018,80 - 84 years,20,35,55
Rest of Co. Westmeath,2018,85 years and over,77,45,122
Rest of Co. Westmeath,2018,Under 1 year,1,0,1
Rest of Co. Westmeath,2019,1 - 4 years,0,0,0
Rest of Co. Westmeath,2019,10 - 14 years,0,0,0
Rest of Co. Westmeath,2019,15 - 19 years,0,2,2
Rest of Co. Westmeath,2019,20 - 24 years,0,0,0
Rest of Co. Westmeath,2019,25 - 29 years,1,1,2
Rest of Co. Westmeath,2019,30 - 34 years,2,1,3
Rest of Co. Westmeath,2019,35 - 39 years,0,2,2
Rest of Co. Westmeath,2019,40 - 44 years,4,0,4
Rest of Co. Westmeath,2019,45 - 49 years,3,6,9
Rest of Co. Westmeath,2019,5 - 9 years,0,0,0
Rest of Co. Westmeath,2019,50 - 54 years,5,6,11
Rest of Co. Westmeath,2019,55 - 59 years,5,8,13
Rest of Co. Westmeath,2019,60 - 64 years,5,17,22
Rest of Co. Westmeath,2019,65 - 69 years,10,12,22
Rest of Co. Westmeath,2019,70 - 74 years,14,19,33
Rest of Co. Westmeath,2019,75 - 79 years,21,24,45
Rest of Co. Westmeath,2019,80 - 84 years,20,35,55
Rest of Co. Westmeath,2019,85 years and over,77,45,122
Rest of Co. Westmeath,2019,Under 1 year,1,0,1
Rest of Co. Westmeath,2020,1 - 4 years,0,0,0
Rest of Co. Westmeath,2020,10 - 14 years,0,0,0
Rest of Co. Westmeath,2020,15 - 19 years,0,2,2
Rest of Co. Westmeath,2020,20 - 24 years,0,0,0
Rest of Co. Westmeath,2020,25 - 29 years,1,1,2
Rest of Co. Westmeath,2020,30 - 34 years,2,1,3
Rest of Co. Westmeath,2020,35 - 39 years,0,2,2
Rest of Co. Westmeath,2020,40 - 44 years,4,0,4
Rest of Co. Westmeath,2020,45 - 49 years,3,6,9
Rest of Co. Westmeath,2020,5 - 9 years,0,0,0
Rest of Co. Westmeath,2020,50 - 54 years,5,6,11
Rest of Co. Westmeath,2020,55 - 59 years,5,8,13
Rest of Co. Westmeath,2020,60 - 64 years,5,17,22
Rest of Co. Westmeath,2020,65 - 69 years,10,12,22
Rest of Co. Westmeath,2020,70 - 74 years,14,19,33
Rest of Co. Westmeath,2020,75 - 79 years,21,24,45
Rest of Co. Westmeath,2020,80 - 84 years,20,35,55
Rest of Co. Westmeath,2020,85 years and over,77,45,122
Rest of Co. Westmeath,2020,Under 1 year,1,0,1
Rest of Co. Wexford,2007,1 - 4 years,0,1,1
Rest of Co. Wexford,2007,10 - 14 years,0,2,2
Rest of Co. Wexford,2007,15 - 19 years,2,3,5
Rest of Co. Wexford,2007,20 - 24 years,1,1,2
Rest of Co. Wexford,2007,25 - 29 years,0,4,4
Rest of Co. Wexford,2007,30 - 34 years,1,2,3
Rest of Co. Wexford,2007,35 - 39 years,0,4,4
Rest of Co. Wexford,2007,40 - 44 years,3,4,7
Rest of Co. Wexford,2007,45 - 49 years,5,7,12
Rest of Co. Wexford,2007,5 - 9 years,1,0,1
Rest of Co. Wexford,2007,50 - 54 years,4,3,7
Rest of Co. Wexford,2007,55 - 59 years,6,16,22
Rest of Co. Wexford,2007,60 - 64 years,15,25,40
Rest of Co. Wexford,2007,65 - 69 years,19,33,52
Rest of Co. Wexford,2007,70 - 74 years,25,38,63
Rest of Co. Wexford,2007,75 - 79 years,23,43,66
Rest of Co. Wexford,2007,80 - 84 years,47,46,93
Rest of Co. Wexford,2007,85 years and over,83,61,144
Rest of Co. Wexford,2007,Under 1 year,5,3,8
Rest of Co. Wexford,2008,1 - 4 years,0,1,1
Rest of Co. Wexford,2008,10 - 14 years,0,2,2
Rest of Co. Wexford,2008,15 - 19 years,2,3,5
Rest of Co. Wexford,2008,20 - 24 years,1,4,5
Rest of Co. Wexford,2008,25 - 29 years,0,2,2
Rest of Co. Wexford,2008,30 - 34 years,3,4,7
Rest of Co. Wexford,2008,35 - 39 years,2,3,5
Rest of Co. Wexford,2008,40 - 44 years,3,7,10
Rest of Co. Wexford,2008,45 - 49 years,3,5,8
Rest of Co. Wexford,2008,5 - 9 years,2,1,3
Rest of Co. Wexford,2008,50 - 54 years,3,12,15
Rest of Co. Wexford,2008,55 - 59 years,9,17,26
Rest of Co. Wexford,2008,60 - 64 years,10,15,25
Rest of Co. Wexford,2008,65 - 69 years,17,33,50
Rest of Co. Wexford,2008,70 - 74 years,20,30,50
Rest of Co. Wexford,2008,75 - 79 years,30,53,83
Rest of Co. Wexford,2008,80 - 84 years,47,55,102
Rest of Co. Wexford,2008,85 years and over,102,45,147
Rest of Co. Wexford,2008,Under 1 year,3,2,5
Rest of Co. Wexford,2009,1 - 4 years,1,2,3
Rest of Co. Wexford,2009,10 - 14 years,0,2,2
Rest of Co. Wexford,2009,15 - 19 years,1,3,4
Rest of Co. Wexford,2009,20 - 24 years,1,2,3
Rest of Co. Wexford,2009,25 - 29 years,3,5,8
Rest of Co. Wexford,2009,30 - 34 years,2,3,5
Rest of Co. Wexford,2009,35 - 39 years,7,3,10
Rest of Co. Wexford,2009,40 - 44 years,5,11,16
Rest of Co. Wexford,2009,45 - 49 years,12,6,18
Rest of Co. Wexford,2009,5 - 9 years,1,1,2
Rest of Co. Wexford,2009,50 - 54 years,9,11,20
Rest of Co. Wexford,2009,55 - 59 years,7,15,22
Rest of Co. Wexford,2009,60 - 64 years,20,29,49
Rest of Co. Wexford,2009,65 - 69 years,19,39,58
Rest of Co. Wexford,2009,70 - 74 years,32,53,85
Rest of Co. Wexford,2009,75 - 79 years,41,56,97
Rest of Co. Wexford,2009,80 - 84 years,58,70,128
Rest of Co. Wexford,2009,85 years and over,114,65,179
Rest of Co. Wexford,2009,Under 1 year,4,2,6
Rest of Co. Wexford,2010,1 - 4 years,1,3,4
Rest of Co. Wexford,2010,10 - 14 years,3,2,5
Rest of Co. Wexford,2010,15 - 19 years,1,4,5
Rest of Co. Wexford,2010,20 - 24 years,3,4,7
Rest of Co. Wexford,2010,25 - 29 years,3,1,4
Rest of Co. Wexford,2010,30 - 34 years,2,4,6
Rest of Co. Wexford,2010,35 - 39 years,4,5,9
Rest of Co. Wexford,2010,40 - 44 years,6,8,14
Rest of Co. Wexford,2010,45 - 49 years,6,8,14
Rest of Co. Wexford,2010,5 - 9 years,2,1,3
Rest of Co. Wexford,2010,50 - 54 years,5,14,19
Rest of Co. Wexford,2010,55 - 59 years,9,19,28
Rest of Co. Wexford,2010,60 - 64 years,15,19,34
Rest of Co. Wexford,2010,65 - 69 years,20,36,56
Rest of Co. Wexford,2010,70 - 74 years,31,38,69
Rest of Co. Wexford,2010,75 - 79 years,41,66,107
Rest of Co. Wexford,2010,80 - 84 years,56,50,106
Rest of Co. Wexford,2010,85 years and over,128,79,207
Rest of Co. Wexford,2010,Under 1 year,2,4,6
Rest of Co. Wexford,2011,1 - 4 years,0,1,1
Rest of Co. Wexford,2011,10 - 14 years,0,1,1
Rest of Co. Wexford,2011,15 - 19 years,0,7,7
Rest of Co. Wexford,2011,20 - 24 years,0,1,1
Rest of Co. Wexford,2011,25 - 29 years,3,5,8
Rest of Co. Wexford,2011,30 - 34 years,3,3,6
Rest of Co. Wexford,2011,35 - 39 years,4,3,7
Rest of Co. Wexford,2011,40 - 44 years,5,11,16
Rest of Co. Wexford,2011,45 - 49 years,10,4,14
Rest of Co. Wexford,2011,5 - 9 years,0,1,1
Rest of Co. Wexford,2011,50 - 54 years,7,10,17
Rest of Co. Wexford,2011,55 - 59 years,10,12,22
Rest of Co. Wexford,2011,60 - 64 years,17,24,41
Rest of Co. Wexford,2011,65 - 69 years,26,42,68
Rest of Co. Wexford,2011,70 - 74 years,22,43,65
Rest of Co. Wexford,2011,75 - 79 years,55,66,121
Rest of Co. Wexford,2011,80 - 84 years,54,66,120
Rest of Co. Wexford,2011,85 years and over,124,87,211
Rest of Co. Wexford,2011,Under 1 year,3,5,8
Rest of Co. Wexford,2012,1 - 4 years,0,1,1
Rest of Co. Wexford,2012,10 - 14 years,0,1,1
Rest of Co. Wexford,2012,15 - 19 years,3,4,7
Rest of Co. Wexford,2012,20 - 24 years,1,1,2
Rest of Co. Wexford,2012,25 - 29 years,3,1,4
Rest of Co. Wexford,2012,30 - 34 years,3,4,7
Rest of Co. Wexford,2012,35 - 39 years,3,7,10
Rest of Co. Wexford,2012,40 - 44 years,3,5,8
Rest of Co. Wexford,2012,45 - 49 years,5,15,20
Rest of Co. Wexford,2012,5 - 9 years,0,1,1
Rest of Co. Wexford,2012,50 - 54 years,8,11,19
Rest of Co. Wexford,2012,55 - 59 years,12,10,22
Rest of Co. Wexford,2012,60 - 64 years,13,21,34
Rest of Co. Wexford,2012,65 - 69 years,17,32,49
Rest of Co. Wexford,2012,70 - 74 years,33,40,73
Rest of Co. Wexford,2012,75 - 79 years,42,50,92
Rest of Co. Wexford,2012,80 - 84 years,41,50,91
Rest of Co. Wexford,2012,85 years and over,118,87,205
Rest of Co. Wexford,2012,Under 1 year,3,2,5
Rest of Co. Wexford,2013,1 - 4 years,0,0,0
Rest of Co. Wexford,2013,10 - 14 years,0,2,2
Rest of Co. Wexford,2013,15 - 19 years,0,2,2
Rest of Co. Wexford,2013,20 - 24 years,1,1,2
Rest of Co. Wexford,2013,25 - 29 years,0,3,3
Rest of Co. Wexford,2013,30 - 34 years,3,4,7
Rest of Co. Wexford,2013,35 - 39 years,1,0,1
Rest of Co. Wexford,2013,40 - 44 years,3,4,7
Rest of Co. Wexford,2013,45 - 49 years,9,8,17
Rest of Co. Wexford,2013,5 - 9 years,3,1,4
Rest of Co. Wexford,2013,50 - 54 years,5,16,21
Rest of Co. Wexford,2013,55 - 59 years,8,24,32
Rest of Co. Wexford,2013,60 - 64 years,15,29,44
Rest of Co. Wexford,2013,65 - 69 years,26,22,48
Rest of Co. Wexford,2013,70 - 74 years,20,44,64
Rest of Co. Wexford,2013,75 - 79 years,35,60,95
Rest of Co. Wexford,2013,80 - 84 years,58,63,121
Rest of Co. Wexford,2013,85 years and over,124,92,216
Rest of Co. Wexford,2013,Under 1 year,1,3,4
Rest of Co. Wexford,2014,1 - 4 years,0,0,0
Rest of Co. Wexford,2014,10 - 14 years,0,2,2
Rest of Co. Wexford,2014,15 - 19 years,0,1,1
Rest of Co. Wexford,2014,20 - 24 years,1,3,4
Rest of Co. Wexford,2014,25 - 29 years,4,4,8
Rest of Co. Wexford,2014,30 - 34 years,1,3,4
Rest of Co. Wexford,2014,35 - 39 years,2,6,8
Rest of Co. Wexford,2014,40 - 44 years,3,11,14
Rest of Co. Wexford,2014,45 - 49 years,6,7,13
Rest of Co. Wexford,2014,5 - 9 years,3,1,4
Rest of Co. Wexford,2014,50 - 54 years,8,20,28
Rest of Co. Wexford,2014,55 - 59 years,15,15,30
Rest of Co. Wexford,2014,60 - 64 years,16,19,35
Rest of Co. Wexford,2014,65 - 69 years,31,37,68
Rest of Co. Wexford,2014,70 - 74 years,27,40,67
Rest of Co. Wexford,2014,75 - 79 years,40,47,87
Rest of Co. Wexford,2014,80 - 84 years,53,53,106
Rest of Co. Wexford,2014,85 years and over,125,77,202
Rest of Co. Wexford,2014,Under 1 year,4,2,6
Rest of Co. Wexford,2015,1 - 4 years,0,0,0
Rest of Co. Wexford,2015,10 - 14 years,0,2,2
Rest of Co. Wexford,2015,15 - 19 years,0,1,1
Rest of Co. Wexford,2015,20 - 24 years,1,3,4
Rest of Co. Wexford,2015,25 - 29 years,4,4,8
Rest of Co. Wexford,2015,30 - 34 years,1,3,4
Rest of Co. Wexford,2015,35 - 39 years,2,6,8
Rest of Co. Wexford,2015,40 - 44 years,3,11,14
Rest of Co. Wexford,2015,45 - 49 years,6,7,13
Rest of Co. Wexford,2015,5 - 9 years,3,1,4
Rest of Co. Wexford,2015,50 - 54 years,8,20,28
Rest of Co. Wexford,2015,55 - 59 years,15,15,30
Rest of Co. Wexford,2015,60 - 64 years,16,19,35
Rest of Co. Wexford,2015,65 - 69 years,31,37,68
Rest of Co. Wexford,2015,70 - 74 years,27,40,67
Rest of Co. Wexford,2015,75 - 79 years,40,47,87
Rest of Co. Wexford,2015,80 - 84 years,53,53,106
Rest of Co. Wexford,2015,85 years and over,125,77,202
Rest of Co. Wexford,2015,Under 1 year,4,2,6
Rest of Co. Wexford,2016,1 - 4 years,0,0,0
Rest of Co. Wexford,2016,10 - 14 years,0,2,2
Rest of Co. Wexford,2016,15 - 19 years,0,1,1
Rest of Co. Wexford,2016,20 - 24 years,1,3,4
Rest of Co. Wexford,2016,25 - 29 years,4,4,8
Rest of Co. Wexford,2016,30 - 34 years,1,3,4
Rest of Co. Wexford,2016,35 - 39 years,2,6,8
Rest of Co. Wexford,2016,40 - 44 years,3,11,14
Rest of Co. Wexford,2016,45 - 49 years,6,7,13
Rest of Co. Wexford,2016,5 - 9 years,3,1,4
Rest of Co. Wexford,2016,50 - 54 years,8,20,28
Rest of Co. Wexford,2016,55 - 59 years,15,15,30
Rest of Co. Wexford,2016,60 - 64 years,16,19,35
Rest of Co. Wexford,2016,65 - 69 years,31,37,68
Rest of Co. Wexford,2016,70 - 74 years,27,40,67
Rest of Co. Wexford,2016,75 - 79 years,40,47,87
Rest of Co. Wexford,2016,80 - 84 years,53,53,106
Rest of Co. Wexford,2016,85 years and over,125,77,202
Rest of Co. Wexford,2016,Under 1 year,4,2,6
Rest of Co. Wexford,2017,1 - 4 years,0,0,0
Rest of Co. Wexford,2017,10 - 14 years,0,2,2
Rest of Co. Wexford,2017,15 - 19 years,0,2,2
Rest of Co. Wexford,2017,20 - 24 years,1,1,2
Rest of Co. Wexford,2017,25 - 29 years,2,4,6
Rest of Co. Wexford,2017,30 - 34 years,2,3,5
Rest of Co. Wexford,2017,35 - 39 years,4,3,7
Rest of Co. Wexford,2017,40 - 44 years,3,6,9
Rest of Co. Wexford,2017,45 - 49 years,4,10,14
Rest of Co. Wexford,2017,5 - 9 years,3,1,4
Rest of Co. Wexford,2017,50 - 54 years,6,11,17
Rest of Co. Wexford,2017,55 - 59 years,12,18,30
Rest of Co. Wexford,2017,60 - 64 years,13,21,34
Rest of Co. Wexford,2017,65 - 69 years,25,32,57
Rest of Co. Wexford,2017,70 - 74 years,37,44,81
Rest of Co. Wexford,2017,75 - 79 years,37,62,99
Rest of Co. Wexford,2017,80 - 84 years,56,75,131
Rest of Co. Wexford,2017,85 years and over,126,93,219
Rest of Co. Wexford,2017,Under 1 year,4,1,5
Rest of Co. Wexford,2018,1 - 4 years,0,1,1
Rest of Co. Wexford,2018,10 - 14 years,1,1,2
Rest of Co. Wexford,2018,15 - 19 years,0,1,1
Rest of Co. Wexford,2018,20 - 24 years,3,1,4
Rest of Co. Wexford,2018,25 - 29 years,1,0,1
Rest of Co. Wexford,2018,30 - 34 years,3,4,7
Rest of Co. Wexford,2018,35 - 39 years,1,4,5
Rest of Co. Wexford,2018,40 - 44 years,0,6,6
Rest of Co. Wexford,2018,45 - 49 years,5,12,17
Rest of Co. Wexford,2018,5 - 9 years,0,1,1
Rest of Co. Wexford,2018,50 - 54 years,6,11,17
Rest of Co. Wexford,2018,55 - 59 years,13,16,29
Rest of Co. Wexford,2018,60 - 64 years,22,16,38
Rest of Co. Wexford,2018,65 - 69 years,22,34,56
Rest of Co. Wexford,2018,70 - 74 years,34,48,82
Rest of Co. Wexford,2018,75 - 79 years,39,65,104
Rest of Co. Wexford,2018,80 - 84 years,60,79,139
Rest of Co. Wexford,2018,85 years and over,136,103,239
Rest of Co. Wexford,2018,Under 1 year,3,2,5
Rest of Co. Wexford,2019,1 - 4 years,0,1,1
Rest of Co. Wexford,2019,10 - 14 years,1,1,2
Rest of Co. Wexford,2019,15 - 19 years,0,1,1
Rest of Co. Wexford,2019,20 - 24 years,3,1,4
Rest of Co. Wexford,2019,25 - 29 years,1,0,1
Rest of Co. Wexford,2019,30 - 34 years,3,4,7
Rest of Co. Wexford,2019,35 - 39 years,1,4,5
Rest of Co. Wexford,2019,40 - 44 years,0,6,6
Rest of Co. Wexford,2019,45 - 49 years,5,12,17
Rest of Co. Wexford,2019,5 - 9 years,0,1,1
Rest of Co. Wexford,2019,50 - 54 years,6,11,17
Rest of Co. Wexford,2019,55 - 59 years,13,16,29
Rest of Co. Wexford,2019,60 - 64 years,22,16,38
Rest of Co. Wexford,2019,65 - 69 years,22,34,56
Rest of Co. Wexford,2019,70 - 74 years,34,48,82
Rest of Co. Wexford,2019,75 - 79 years,39,65,104
Rest of Co. Wexford,2019,80 - 84 years,60,79,139
Rest of Co. Wexford,2019,85 years and over,136,103,239
Rest of Co. Wexford,2019,Under 1 year,3,2,5
Rest of Co. Wexford,2020,1 - 4 years,0,1,1
Rest of Co. Wexford,2020,10 - 14 years,1,1,2
Rest of Co. Wexford,2020,15 - 19 years,0,1,1
Rest of Co. Wexford,2020,20 - 24 years,3,1,4
Rest of Co. Wexford,2020,25 - 29 years,1,0,1
Rest of Co. Wexford,2020,30 - 34 years,3,4,7
Rest of Co. Wexford,2020,35 - 39 years,1,4,5
Rest of Co. Wexford,2020,40 - 44 years,0,6,6
Rest of Co. Wexford,2020,45 - 49 years,5,12,17
Rest of Co. Wexford,2020,5 - 9 years,0,1,1
Rest of Co. Wexford,2020,50 - 54 years,6,11,17
Rest of Co. Wexford,2020,55 - 59 years,13,16,29
Rest of Co. Wexford,2020,60 - 64 years,22,16,38
Rest of Co. Wexford,2020,65 - 69 years,22,34,56
Rest of Co. Wexford,2020,70 - 74 years,34,48,82
Rest of Co. Wexford,2020,75 - 79 years,39,65,104
Rest of Co. Wexford,2020,80 - 84 years,60,79,139
Rest of Co. Wexford,2020,85 years and over,136,103,239
Rest of Co. Wexford,2020,Under 1 year,3,2,5
Rest of North Tipperary,2007,1 - 4 years,0,1,1
Rest of North Tipperary,2007,10 - 14 years,0,0,0
Rest of North Tipperary,2007,15 - 19 years,0,0,0
Rest of North Tipperary,2007,20 - 24 years,0,0,0
Rest of North Tipperary,2007,25 - 29 years,0,1,1
Rest of North Tipperary,2007,30 - 34 years,0,0,0
Rest of North Tipperary,2007,35 - 39 years,0,1,1
Rest of North Tipperary,2007,40 - 44 years,2,1,3
Rest of North Tipperary,2007,45 - 49 years,0,4,4
Rest of North Tipperary,2007,5 - 9 years,0,0,0
Rest of North Tipperary,2007,50 - 54 years,2,4,6
Rest of North Tipperary,2007,55 - 59 years,3,4,7
Rest of North Tipperary,2007,60 - 64 years,5,9,14
Rest of North Tipperary,2007,65 - 69 years,9,8,17
Rest of North Tipperary,2007,70 - 74 years,14,27,41
Rest of North Tipperary,2007,75 - 79 years,25,25,50
Rest of North Tipperary,2007,80 - 84 years,29,36,65
Rest of North Tipperary,2007,85 years and over,44,24,68
Rest of North Tipperary,2007,Under 1 year,1,2,3
Rest of North Tipperary,2008,1 - 4 years,0,1,1
Rest of North Tipperary,2008,10 - 14 years,0,0,0
Rest of North Tipperary,2008,15 - 19 years,0,0,0
Rest of North Tipperary,2008,20 - 24 years,0,0,0
Rest of North Tipperary,2008,25 - 29 years,0,1,1
Rest of North Tipperary,2008,30 - 34 years,1,2,3
Rest of North Tipperary,2008,35 - 39 years,1,1,2
Rest of North Tipperary,2008,40 - 44 years,1,1,2
Rest of North Tipperary,2008,45 - 49 years,3,4,7
Rest of North Tipperary,2008,5 - 9 years,0,1,1
Rest of North Tipperary,2008,50 - 54 years,2,4,6
Rest of North Tipperary,2008,55 - 59 years,2,4,6
Rest of North Tipperary,2008,60 - 64 years,3,7,10
Rest of North Tipperary,2008,65 - 69 years,4,11,15
Rest of North Tipperary,2008,70 - 74 years,11,20,31
Rest of North Tipperary,2008,75 - 79 years,16,25,41
Rest of North Tipperary,2008,80 - 84 years,18,18,36
Rest of North Tipperary,2008,85 years and over,48,27,75
Rest of North Tipperary,2008,Under 1 year,1,2,3
Rest of North Tipperary,2009,1 - 4 years,0,1,1
Rest of North Tipperary,2009,10 - 14 years,0,0,0
Rest of North Tipperary,2009,15 - 19 years,0,0,0
Rest of North Tipperary,2009,20 - 24 years,1,6,7
Rest of North Tipperary,2009,25 - 29 years,0,3,3
Rest of North Tipperary,2009,30 - 34 years,1,2,3
Rest of North Tipperary,2009,35 - 39 years,1,4,5
Rest of North Tipperary,2009,40 - 44 years,1,1,2
Rest of North Tipperary,2009,45 - 49 years,4,6,10
Rest of North Tipperary,2009,5 - 9 years,0,1,1
Rest of North Tipperary,2009,50 - 54 years,4,6,10
Rest of North Tipperary,2009,55 - 59 years,3,9,12
Rest of North Tipperary,2009,60 - 64 years,10,14,24
Rest of North Tipperary,2009,65 - 69 years,14,19,33
Rest of North Tipperary,2009,70 - 74 years,14,30,44
Rest of North Tipperary,2009,75 - 79 years,33,42,75
Rest of North Tipperary,2009,80 - 84 years,42,42,84
Rest of North Tipperary,2009,85 years and over,69,55,124
Rest of North Tipperary,2009,Under 1 year,2,2,4
Rest of North Tipperary,2010,1 - 4 years,0,1,1
Rest of North Tipperary,2010,10 - 14 years,0,0,0
Rest of North Tipperary,2010,15 - 19 years,0,0,0
Rest of North Tipperary,2010,20 - 24 years,1,3,4
Rest of North Tipperary,2010,25 - 29 years,0,3,3
Rest of North Tipperary,2010,30 - 34 years,1,1,2
Rest of North Tipperary,2010,35 - 39 years,3,3,6
Rest of North Tipperary,2010,40 - 44 years,5,1,6
Rest of North Tipperary,2010,45 - 49 years,4,3,7
Rest of North Tipperary,2010,5 - 9 years,0,1,1
Rest of North Tipperary,2010,50 - 54 years,3,11,14
Rest of North Tipperary,2010,55 - 59 years,4,12,16
Rest of North Tipperary,2010,60 - 64 years,8,19,27
Rest of North Tipperary,2010,65 - 69 years,6,16,22
Rest of North Tipperary,2010,70 - 74 years,15,25,40
Rest of North Tipperary,2010,75 - 79 years,21,25,46
Rest of North Tipperary,2010,80 - 84 years,36,39,75
Rest of North Tipperary,2010,85 years and over,85,52,137
Rest of North Tipperary,2010,Under 1 year,3,2,5
Rest of North Tipperary,2011,1 - 4 years,0,0,0
Rest of North Tipperary,2011,10 - 14 years,0,0,0
Rest of North Tipperary,2011,15 - 19 years,0,2,2
Rest of North Tipperary,2011,20 - 24 years,1,0,1
Rest of North Tipperary,2011,25 - 29 years,1,2,3
Rest of North Tipperary,2011,30 - 34 years,1,1,2
Rest of North Tipperary,2011,35 - 39 years,0,4,4
Rest of North Tipperary,2011,40 - 44 years,2,4,6
Rest of North Tipperary,2011,45 - 49 years,2,6,8
Rest of North Tipperary,2011,5 - 9 years,0,0,0
Rest of North Tipperary,2011,50 - 54 years,5,6,11
Rest of North Tipperary,2011,55 - 59 years,7,6,13
Rest of North Tipperary,2011,60 - 64 years,10,15,25
Rest of North Tipperary,2011,65 - 69 years,11,25,36
Rest of North Tipperary,2011,70 - 74 years,16,22,38
Rest of North Tipperary,2011,75 - 79 years,25,37,62
Rest of North Tipperary,2011,80 - 84 years,36,43,79
Rest of North Tipperary,2011,85 years and over,92,53,145
Rest of North Tipperary,2011,Under 1 year,1,1,2
Rest of North Tipperary,2012,1 - 4 years,0,0,0
Rest of North Tipperary,2012,10 - 14 years,0,0,0
Rest of North Tipperary,2012,15 - 19 years,0,1,1
Rest of North Tipperary,2012,20 - 24 years,1,0,1
Rest of North Tipperary,2012,25 - 29 years,1,1,2
Rest of North Tipperary,2012,30 - 34 years,1,1,2
Rest of North Tipperary,2012,35 - 39 years,0,4,4
Rest of North Tipperary,2012,40 - 44 years,1,2,3
Rest of North Tipperary,2012,45 - 49 years,6,2,8
Rest of North Tipperary,2012,5 - 9 years,0,0,0
Rest of North Tipperary,2012,50 - 54 years,2,7,9
Rest of North Tipperary,2012,55 - 59 years,9,7,16
Rest of North Tipperary,2012,60 - 64 years,6,11,17
Rest of North Tipperary,2012,65 - 69 years,11,11,22
Rest of North Tipperary,2012,70 - 74 years,11,25,36
Rest of North Tipperary,2012,75 - 79 years,22,27,49
Rest of North Tipperary,2012,80 - 84 years,30,35,65
Rest of North Tipperary,2012,85 years and over,97,54,151
Rest of North Tipperary,2012,Under 1 year,5,2,7
Rest of North Tipperary,2013,1 - 4 years,0,0,0
Rest of North Tipperary,2013,10 - 14 years,2,0,2
Rest of North Tipperary,2013,15 - 19 years,0,2,2
Rest of North Tipperary,2013,20 - 24 years,0,4,4
Rest of North Tipperary,2013,25 - 29 years,0,3,3
Rest of North Tipperary,2013,30 - 34 years,1,3,4
Rest of North Tipperary,2013,35 - 39 years,0,1,1
Rest of North Tipperary,2013,40 - 44 years,1,2,3
Rest of North Tipperary,2013,45 - 49 years,2,6,8
Rest of North Tipperary,2013,5 - 9 years,0,0,0
Rest of North Tipperary,2013,50 - 54 years,4,8,12
Rest of North Tipperary,2013,55 - 59 years,3,5,8
Rest of North Tipperary,2013,60 - 64 years,7,10,17
Rest of North Tipperary,2013,65 - 69 years,14,24,38
Rest of North Tipperary,2013,70 - 74 years,12,23,35
Rest of North Tipperary,2013,75 - 79 years,14,25,39
Rest of North Tipperary,2013,80 - 84 years,27,32,59
Rest of North Tipperary,2013,85 years and over,87,54,141
Rest of North Tipperary,2013,Under 1 year,3,1,4
Rest of North Tipperary,2014,1 - 4 years,0,0,0
Rest of North Tipperary,2014,10 - 14 years,2,0,2
Rest of North Tipperary,2014,15 - 19 years,0,3,3
Rest of North Tipperary,2014,20 - 24 years,0,1,1
Rest of North Tipperary,2014,25 - 29 years,0,1,1
Rest of North Tipperary,2014,30 - 34 years,2,3,5
Rest of North Tipperary,2014,35 - 39 years,0,2,2
Rest of North Tipperary,2014,40 - 44 years,1,2,3
Rest of North Tipperary,2014,45 - 49 years,3,2,5
Rest of North Tipperary,2014,5 - 9 years,0,0,0
Rest of North Tipperary,2014,50 - 54 years,4,4,8
Rest of North Tipperary,2014,55 - 59 years,8,10,18
Rest of North Tipperary,2014,60 - 64 years,8,12,20
Rest of North Tipperary,2014,65 - 69 years,8,18,26
Rest of North Tipperary,2014,70 - 74 years,15,34,49
Rest of North Tipperary,2014,75 - 79 years,17,28,45
Rest of North Tipperary,2014,80 - 84 years,40,40,80
Rest of North Tipperary,2014,85 years and over,72,59,131
Rest of North Tipperary,2014,Under 1 year,3,1,4
Rest of North Tipperary,2015,1 - 4 years,0,0,0
Rest of North Tipperary,2015,10 - 14 years,2,0,2
Rest of North Tipperary,2015,15 - 19 years,0,3,3
Rest of North Tipperary,2015,20 - 24 years,0,1,1
Rest of North Tipperary,2015,25 - 29 years,0,1,1
Rest of North Tipperary,2015,30 - 34 years,2,3,5
Rest of North Tipperary,2015,35 - 39 years,0,2,2
Rest of North Tipperary,2015,40 - 44 years,1,2,3
Rest of North Tipperary,2015,45 - 49 years,3,2,5
Rest of North Tipperary,2015,5 - 9 years,0,0,0
Rest of North Tipperary,2015,50 - 54 years,4,4,8
Rest of North Tipperary,2015,55 - 59 years,8,10,18
Rest of North Tipperary,2015,60 - 64 years,8,12,20
Rest of North Tipperary,2015,65 - 69 years,8,18,26
Rest of North Tipperary,2015,70 - 74 years,15,34,49
Rest of North Tipperary,2015,75 - 79 years,17,28,45
Rest of North Tipperary,2015,80 - 84 years,40,40,80
Rest of North Tipperary,2015,85 years and over,72,59,131
Rest of North Tipperary,2015,Under 1 year,3,1,4
Rest of North Tipperary,2016,1 - 4 years,0,0,0
Rest of North Tipperary,2016,10 - 14 years,2,0,2
Rest of North Tipperary,2016,15 - 19 years,0,3,3
Rest of North Tipperary,2016,20 - 24 years,0,1,1
Rest of North Tipperary,2016,25 - 29 years,0,1,1
Rest of North Tipperary,2016,30 - 34 years,2,3,5
Rest of North Tipperary,2016,35 - 39 years,0,2,2
Rest of North Tipperary,2016,40 - 44 years,1,2,3
Rest of North Tipperary,2016,45 - 49 years,3,2,5
Rest of North Tipperary,2016,5 - 9 years,0,0,0
Rest of North Tipperary,2016,50 - 54 years,4,4,8
Rest of North Tipperary,2016,55 - 59 years,8,10,18
Rest of North Tipperary,2016,60 - 64 years,8,12,20
Rest of North Tipperary,2016,65 - 69 years,8,18,26
Rest of North Tipperary,2016,70 - 74 years,15,34,49
Rest of North Tipperary,2016,75 - 79 years,17,28,45
Rest of North Tipperary,2016,80 - 84 years,40,40,80
Rest of North Tipperary,2016,85 years and over,72,59,131
Rest of North Tipperary,2016,Under 1 year,3,1,4
Rest of North Tipperary,2017,1 - 4 years,1,1,2
Rest of North Tipperary,2017,10 - 14 years,2,0,2
Rest of North Tipperary,2017,15 - 19 years,0,1,1
Rest of North Tipperary,2017,20 - 24 years,1,2,3
Rest of North Tipperary,2017,25 - 29 years,0,2,2
Rest of North Tipperary,2017,30 - 34 years,2,2,4
Rest of North Tipperary,2017,35 - 39 years,1,1,2
Rest of North Tipperary,2017,40 - 44 years,4,4,8
Rest of North Tipperary,2017,45 - 49 years,3,3,6
Rest of North Tipperary,2017,5 - 9 years,0,0,0
Rest of North Tipperary,2017,50 - 54 years,4,6,10
Rest of North Tipperary,2017,55 - 59 years,1,7,8
Rest of North Tipperary,2017,60 - 64 years,7,6,13
Rest of North Tipperary,2017,65 - 69 years,13,17,30
Rest of North Tipperary,2017,70 - 74 years,14,22,36
Rest of North Tipperary,2017,75 - 79 years,14,27,41
Rest of North Tipperary,2017,80 - 84 years,24,40,64
Rest of North Tipperary,2017,85 years and over,105,61,166
Rest of North Tipperary,2017,Under 1 year,1,1,2
Rest of North Tipperary,2018,1 - 4 years,1,1,2
Rest of North Tipperary,2018,10 - 14 years,2,0,2
Rest of North Tipperary,2018,15 - 19 years,0,1,1
Rest of North Tipperary,2018,20 - 24 years,1,2,3
Rest of North Tipperary,2018,25 - 29 years,0,2,2
Rest of North Tipperary,2018,30 - 34 years,2,2,4
Rest of North Tipperary,2018,35 - 39 years,1,1,2
Rest of North Tipperary,2018,40 - 44 years,4,4,8
Rest of North Tipperary,2018,45 - 49 years,3,3,6
Rest of North Tipperary,2018,5 - 9 years,0,0,0
Rest of North Tipperary,2018,50 - 54 years,4,6,10
Rest of North Tipperary,2018,55 - 59 years,1,7,8
Rest of North Tipperary,2018,60 - 64 years,7,6,13
Rest of North Tipperary,2018,65 - 69 years,13,17,30
Rest of North Tipperary,2018,70 - 74 years,14,22,36
Rest of North Tipperary,2018,75 - 79 years,14,27,41
Rest of North Tipperary,2018,80 - 84 years,24,40,64
Rest of North Tipperary,2018,85 years and over,105,61,166
Rest of North Tipperary,2018,Under 1 year,1,1,2
Rest of North Tipperary,2019,1 - 4 years,1,1,2
Rest of North Tipperary,2019,10 - 14 years,2,0,2
Rest of North Tipperary,2019,15 - 19 years,0,1,1
Rest of North Tipperary,2019,20 - 24 years,1,2,3
Rest of North Tipperary,2019,25 - 29 years,0,2,2
Rest of North Tipperary,2019,30 - 34 years,2,2,4
Rest of North Tipperary,2019,35 - 39 years,1,1,2
Rest of North Tipperary,2019,40 - 44 years,4,4,8
Rest of North Tipperary,2019,45 - 49 years,3,3,6
Rest of North Tipperary,2019,5 - 9 years,0,0,0
Rest of North Tipperary,2019,50 - 54 years,4,6,10
Rest of North Tipperary,2019,55 - 59 years,1,7,8
Rest of North Tipperary,2019,60 - 64 years,7,6,13
Rest of North Tipperary,2019,65 - 69 years,13,17,30
Rest of North Tipperary,2019,70 - 74 years,14,22,36
Rest of North Tipperary,2019,75 - 79 years,14,27,41
Rest of North Tipperary,2019,80 - 84 years,24,40,64
Rest of North Tipperary,2019,85 years and over,105,61,166
Rest of North Tipperary,2019,Under 1 year,1,1,2
Rest of North Tipperary,2020,1 - 4 years,1,1,2
Rest of North Tipperary,2020,10 - 14 years,2,0,2
Rest of North Tipperary,2020,15 - 19 years,0,1,1
Rest of North Tipperary,2020,20 - 24 years,1,2,3
Rest of North Tipperary,2020,25 - 29 years,0,2,2
Rest of North Tipperary,2020,30 - 34 years,2,2,4
Rest of North Tipperary,2020,35 - 39 years,1,1,2
Rest of North Tipperary,2020,40 - 44 years,4,4,8
Rest of North Tipperary,2020,45 - 49 years,3,3,6
Rest of North Tipperary,2020,5 - 9 years,0,0,0
Rest of North Tipperary,2020,50 - 54 years,4,6,10
Rest of North Tipperary,2020,55 - 59 years,1,7,8
Rest of North Tipperary,2020,60 - 64 years,7,6,13
Rest of North Tipperary,2020,65 - 69 years,13,17,30
Rest of North Tipperary,2020,70 - 74 years,14,22,36
Rest of North Tipperary,2020,75 - 79 years,14,27,41
Rest of North Tipperary,2020,80 - 84 years,24,40,64
Rest of North Tipperary,2020,85 years and over,105,61,166
Rest of North Tipperary,2020,Under 1 year,1,1,2
Rest of South Tipperary,2007,1 - 4 years,0,0,0
Rest of South Tipperary,2007,10 - 14 years,0,0,0
Rest of South Tipperary,2007,15 - 19 years,0,2,2
Rest of South Tipperary,2007,20 - 24 years,1,2,3
Rest of South Tipperary,2007,25 - 29 years,0,2,2
Rest of South Tipperary,2007,30 - 34 years,0,3,3
Rest of South Tipperary,2007,35 - 39 years,1,0,1
Rest of South Tipperary,2007,40 - 44 years,0,1,1
Rest of South Tipperary,2007,45 - 49 years,3,2,5
Rest of South Tipperary,2007,5 - 9 years,0,1,1
Rest of South Tipperary,2007,50 - 54 years,1,4,5
Rest of South Tipperary,2007,55 - 59 years,7,10,17
Rest of South Tipperary,2007,60 - 64 years,6,8,14
Rest of South Tipperary,2007,65 - 69 years,8,9,17
Rest of South Tipperary,2007,70 - 74 years,16,17,33
Rest of South Tipperary,2007,75 - 79 years,9,35,44
Rest of South Tipperary,2007,80 - 84 years,26,33,59
Rest of South Tipperary,2007,85 years and over,37,34,71
Rest of South Tipperary,2007,Under 1 year,0,0,0
Rest of South Tipperary,2008,1 - 4 years,0,0,0
Rest of South Tipperary,2008,10 - 14 years,0,0,0
Rest of South Tipperary,2008,15 - 19 years,0,2,2
Rest of South Tipperary,2008,20 - 24 years,1,1,2
Rest of South Tipperary,2008,25 - 29 years,0,2,2
Rest of South Tipperary,2008,30 - 34 years,1,2,3
Rest of South Tipperary,2008,35 - 39 years,1,1,2
Rest of South Tipperary,2008,40 - 44 years,1,4,5
Rest of South Tipperary,2008,45 - 49 years,1,1,2
Rest of South Tipperary,2008,5 - 9 years,0,1,1
Rest of South Tipperary,2008,50 - 54 years,2,3,5
Rest of South Tipperary,2008,55 - 59 years,5,7,12
Rest of South Tipperary,2008,60 - 64 years,6,10,16
Rest of South Tipperary,2008,65 - 69 years,6,9,15
Rest of South Tipperary,2008,70 - 74 years,8,16,24
Rest of South Tipperary,2008,75 - 79 years,14,28,42
Rest of South Tipperary,2008,80 - 84 years,25,23,48
Rest of South Tipperary,2008,85 years and over,56,28,84
Rest of South Tipperary,2008,Under 1 year,1,1,2
Rest of South Tipperary,2009,1 - 4 years,0,1,1
Rest of South Tipperary,2009,10 - 14 years,0,0,0
Rest of South Tipperary,2009,15 - 19 years,0,2,2
Rest of South Tipperary,2009,20 - 24 years,1,2,3
Rest of South Tipperary,2009,25 - 29 years,0,3,3
Rest of South Tipperary,2009,30 - 34 years,1,2,3
Rest of South Tipperary,2009,35 - 39 years,1,1,2
Rest of South Tipperary,2009,40 - 44 years,1,2,3
Rest of South Tipperary,2009,45 - 49 years,4,1,5
Rest of South Tipperary,2009,5 - 9 years,0,1,1
Rest of South Tipperary,2009,50 - 54 years,8,3,11
Rest of South Tipperary,2009,55 - 59 years,6,6,12
Rest of South Tipperary,2009,60 - 64 years,5,14,19
Rest of South Tipperary,2009,65 - 69 years,7,14,21
Rest of South Tipperary,2009,70 - 74 years,15,32,47
Rest of South Tipperary,2009,75 - 79 years,16,25,41
Rest of South Tipperary,2009,80 - 84 years,30,26,56
Rest of South Tipperary,2009,85 years and over,53,38,91
Rest of South Tipperary,2009,Under 1 year,3,1,4
Rest of South Tipperary,2010,1 - 4 years,0,1,1
Rest of South Tipperary,2010,10 - 14 years,0,0,0
Rest of South Tipperary,2010,15 - 19 years,1,1,2
Rest of South Tipperary,2010,20 - 24 years,1,1,2
Rest of South Tipperary,2010,25 - 29 years,2,3,5
Rest of South Tipperary,2010,30 - 34 years,1,1,2
Rest of South Tipperary,2010,35 - 39 years,4,3,7
Rest of South Tipperary,2010,40 - 44 years,4,1,5
Rest of South Tipperary,2010,45 - 49 years,2,4,6
Rest of South Tipperary,2010,5 - 9 years,0,1,1
Rest of South Tipperary,2010,50 - 54 years,3,6,9
Rest of South Tipperary,2010,55 - 59 years,2,9,11
Rest of South Tipperary,2010,60 - 64 years,7,7,14
Rest of South Tipperary,2010,65 - 69 years,6,16,22
Rest of South Tipperary,2010,70 - 74 years,14,21,35
Rest of South Tipperary,2010,75 - 79 years,18,35,53
Rest of South Tipperary,2010,80 - 84 years,21,39,60
Rest of South Tipperary,2010,85 years and over,62,51,113
Rest of South Tipperary,2010,Under 1 year,3,2,5
Rest of South Tipperary,2011,1 - 4 years,0,0,0
Rest of South Tipperary,2011,10 - 14 years,0,1,1
Rest of South Tipperary,2011,15 - 19 years,1,0,1
Rest of South Tipperary,2011,20 - 24 years,2,4,6
Rest of South Tipperary,2011,25 - 29 years,0,0,0
Rest of South Tipperary,2011,30 - 34 years,1,0,1
Rest of South Tipperary,2011,35 - 39 years,0,3,3
Rest of South Tipperary,2011,40 - 44 years,2,3,5
Rest of South Tipperary,2011,45 - 49 years,4,3,7
Rest of South Tipperary,2011,5 - 9 years,0,0,0
Rest of South Tipperary,2011,50 - 54 years,2,5,7
Rest of South Tipperary,2011,55 - 59 years,8,6,14
Rest of South Tipperary,2011,60 - 64 years,6,11,17
Rest of South Tipperary,2011,65 - 69 years,8,16,24
Rest of South Tipperary,2011,70 - 74 years,13,13,26
Rest of South Tipperary,2011,75 - 79 years,21,33,54
Rest of South Tipperary,2011,80 - 84 years,24,26,50
Rest of South Tipperary,2011,85 years and over,85,44,129
Rest of South Tipperary,2011,Under 1 year,3,0,3
Rest of South Tipperary,2012,1 - 4 years,0,0,0
Rest of South Tipperary,2012,10 - 14 years,0,1,1
Rest of South Tipperary,2012,15 - 19 years,1,0,1
Rest of South Tipperary,2012,20 - 24 years,2,1,3
Rest of South Tipperary,2012,25 - 29 years,2,0,2
Rest of South Tipperary,2012,30 - 34 years,1,0,1
Rest of South Tipperary,2012,35 - 39 years,2,3,5
Rest of South Tipperary,2012,40 - 44 years,2,1,3
Rest of South Tipperary,2012,45 - 49 years,2,3,5
Rest of South Tipperary,2012,5 - 9 years,1,0,1
Rest of South Tipperary,2012,50 - 54 years,3,7,10
Rest of South Tipperary,2012,55 - 59 years,5,5,10
Rest of South Tipperary,2012,60 - 64 years,2,10,12
Rest of South Tipperary,2012,65 - 69 years,9,17,26
Rest of South Tipperary,2012,70 - 74 years,9,20,29
Rest of South Tipperary,2012,75 - 79 years,22,28,50
Rest of South Tipperary,2012,80 - 84 years,17,30,47
Rest of South Tipperary,2012,85 years and over,61,44,105
Rest of South Tipperary,2012,Under 1 year,3,0,3
Rest of South Tipperary,2013,1 - 4 years,0,1,1
Rest of South Tipperary,2013,10 - 14 years,0,0,0
Rest of South Tipperary,2013,15 - 19 years,1,1,2
Rest of South Tipperary,2013,20 - 24 years,0,0,0
Rest of South Tipperary,2013,25 - 29 years,0,0,0
Rest of South Tipperary,2013,30 - 34 years,1,1,2
Rest of South Tipperary,2013,35 - 39 years,0,2,2
Rest of South Tipperary,2013,40 - 44 years,0,2,2
Rest of South Tipperary,2013,45 - 49 years,3,8,11
Rest of South Tipperary,2013,5 - 9 years,0,1,1
Rest of South Tipperary,2013,50 - 54 years,3,4,7
Rest of South Tipperary,2013,55 - 59 years,2,10,12
Rest of South Tipperary,2013,60 - 64 years,10,21,31
Rest of South Tipperary,2013,65 - 69 years,13,24,37
Rest of South Tipperary,2013,70 - 74 years,11,20,31
Rest of South Tipperary,2013,75 - 79 years,15,37,52
Rest of South Tipperary,2013,80 - 84 years,23,36,59
Rest of South Tipperary,2013,85 years and over,95,73,168
Rest of South Tipperary,2013,Under 1 year,1,1,2
Rest of South Tipperary,2014,1 - 4 years,0,1,1
Rest of South Tipperary,2014,10 - 14 years,0,1,1
Rest of South Tipperary,2014,15 - 19 years,1,2,3
Rest of South Tipperary,2014,20 - 24 years,0,0,0
Rest of South Tipperary,2014,25 - 29 years,1,5,6
Rest of South Tipperary,2014,30 - 34 years,1,4,5
Rest of South Tipperary,2014,35 - 39 years,1,2,3
Rest of South Tipperary,2014,40 - 44 years,1,5,6
Rest of South Tipperary,2014,45 - 49 years,3,1,4
Rest of South Tipperary,2014,5 - 9 years,0,1,1
Rest of South Tipperary,2014,50 - 54 years,3,5,8
Rest of South Tipperary,2014,55 - 59 years,6,6,12
Rest of South Tipperary,2014,60 - 64 years,8,10,18
Rest of South Tipperary,2014,65 - 69 years,8,17,25
Rest of South Tipperary,2014,70 - 74 years,11,32,43
Rest of South Tipperary,2014,75 - 79 years,14,25,39
Rest of South Tipperary,2014,80 - 84 years,29,39,68
Rest of South Tipperary,2014,85 years and over,75,44,119
Rest of South Tipperary,2014,Under 1 year,1,1,2
Rest of South Tipperary,2015,1 - 4 years,0,1,1
Rest of South Tipperary,2015,10 - 14 years,0,1,1
Rest of South Tipperary,2015,15 - 19 years,1,2,3
Rest of South Tipperary,2015,20 - 24 years,0,0,0
Rest of South Tipperary,2015,25 - 29 years,1,5,6
Rest of South Tipperary,2015,30 - 34 years,1,4,5
Rest of South Tipperary,2015,35 - 39 years,1,2,3
Rest of South Tipperary,2015,40 - 44 years,1,5,6
Rest of South Tipperary,2015,45 - 49 years,3,1,4
Rest of South Tipperary,2015,5 - 9 years,0,1,1
Rest of South Tipperary,2015,50 - 54 years,3,5,8
Rest of South Tipperary,2015,55 - 59 years,6,6,12
Rest of South Tipperary,2015,60 - 64 years,8,10,18
Rest of South Tipperary,2015,65 - 69 years,8,17,25
Rest of South Tipperary,2015,70 - 74 years,11,32,43
Rest of South Tipperary,2015,75 - 79 years,14,25,39
Rest of South Tipperary,2015,80 - 84 years,29,39,68
Rest of South Tipperary,2015,85 years and over,75,44,119
Rest of South Tipperary,2015,Under 1 year,1,1,2
Rest of South Tipperary,2016,1 - 4 years,0,1,1
Rest of South Tipperary,2016,10 - 14 years,0,1,1
Rest of South Tipperary,2016,15 - 19 years,1,2,3
Rest of South Tipperary,2016,20 - 24 years,0,0,0
Rest of South Tipperary,2016,25 - 29 years,1,5,6
Rest of South Tipperary,2016,30 - 34 years,1,4,5
Rest of South Tipperary,2016,35 - 39 years,1,2,3
Rest of South Tipperary,2016,40 - 44 years,1,5,6
Rest of South Tipperary,2016,45 - 49 years,3,1,4
Rest of South Tipperary,2016,5 - 9 years,0,1,1
Rest of South Tipperary,2016,50 - 54 years,3,5,8
Rest of South Tipperary,2016,55 - 59 years,6,6,12
Rest of South Tipperary,2016,60 - 64 years,8,10,18
Rest of South Tipperary,2016,65 - 69 years,8,17,25
Rest of South Tipperary,2016,70 - 74 years,11,32,43
Rest of South Tipperary,2016,75 - 79 years,14,25,39
Rest of South Tipperary,2016,80 - 84 years,29,39,68
Rest of South Tipperary,2016,85 years and over,75,44,119
Rest of South Tipperary,2016,Under 1 year,1,1,2
Rest of South Tipperary,2017,1 - 4 years,0,1,1
Rest of South Tipperary,2017,10 - 14 years,0,1,1
Rest of South Tipperary,2017,15 - 19 years,1,2,3
Rest of South Tipperary,2017,20 - 24 years,1,1,2
Rest of South Tipperary,2017,25 - 29 years,1,1,2
Rest of South Tipperary,2017,30 - 34 years,1,3,4
Rest of South Tipperary,2017,35 - 39 years,2,2,4
Rest of South Tipperary,2017,40 - 44 years,1,2,3
Rest of South Tipperary,2017,45 - 49 years,3,2,5
Rest of South Tipperary,2017,5 - 9 years,0,1,1
Rest of South Tipperary,2017,50 - 54 years,6,8,14
Rest of South Tipperary,2017,55 - 59 years,3,8,11
Rest of South Tipperary,2017,60 - 64 years,7,8,15
Rest of South Tipperary,2017,65 - 69 years,5,16,21
Rest of South Tipperary,2017,70 - 74 years,10,18,28
Rest of South Tipperary,2017,75 - 79 years,22,29,51
Rest of South Tipperary,2017,80 - 84 years,32,32,64
Rest of South Tipperary,2017,85 years and over,77,48,125
Rest of South Tipperary,2017,Under 1 year,4,2,6
Rest of South Tipperary,2018,1 - 4 years,0,1,1
Rest of South Tipperary,2018,10 - 14 years,0,1,1
Rest of South Tipperary,2018,15 - 19 years,1,2,3
Rest of South Tipperary,2018,20 - 24 years,1,1,2
Rest of South Tipperary,2018,25 - 29 years,1,1,2
Rest of South Tipperary,2018,30 - 34 years,1,3,4
Rest of South Tipperary,2018,35 - 39 years,2,2,4
Rest of South Tipperary,2018,40 - 44 years,1,2,3
Rest of South Tipperary,2018,45 - 49 years,3,2,5
Rest of South Tipperary,2018,5 - 9 years,0,1,1
Rest of South Tipperary,2018,50 - 54 years,6,8,14
Rest of South Tipperary,2018,55 - 59 years,3,8,11
Rest of South Tipperary,2018,60 - 64 years,7,8,15
Rest of South Tipperary,2018,65 - 69 years,5,16,21
Rest of South Tipperary,2018,70 - 74 years,10,18,28
Rest of South Tipperary,2018,75 - 79 years,22,29,51
Rest of South Tipperary,2018,80 - 84 years,32,32,64
Rest of South Tipperary,2018,85 years and over,77,48,125
Rest of South Tipperary,2018,Under 1 year,4,2,6
Rest of South Tipperary,2019,1 - 4 years,0,1,1
Rest of South Tipperary,2019,10 - 14 years,0,1,1
Rest of South Tipperary,2019,15 - 19 years,1,2,3
Rest of South Tipperary,2019,20 - 24 years,1,1,2
Rest of South Tipperary,2019,25 - 29 years,1,1,2
Rest of South Tipperary,2019,30 - 34 years,1,3,4
Rest of South Tipperary,2019,35 - 39 years,2,2,4
Rest of South Tipperary,2019,40 - 44 years,1,2,3
Rest of South Tipperary,2019,45 - 49 years,3,2,5
Rest of South Tipperary,2019,5 - 9 years,0,1,1
Rest of South Tipperary,2019,50 - 54 years,6,8,14
Rest of South Tipperary,2019,55 - 59 years,3,8,11
Rest of South Tipperary,2019,60 - 64 years,7,8,15
Rest of South Tipperary,2019,65 - 69 years,5,16,21
Rest of South Tipperary,2019,70 - 74 years,10,18,28
Rest of South Tipperary,2019,75 - 79 years,22,29,51
Rest of South Tipperary,2019,80 - 84 years,32,32,64
Rest of South Tipperary,2019,85 years and over,77,48,125
Rest of South Tipperary,2019,Under 1 year,4,2,6
Rest of South Tipperary,2020,1 - 4 years,0,1,1
Rest of South Tipperary,2020,10 - 14 years,0,1,1
Rest of South Tipperary,2020,15 - 19 years,1,2,3
Rest of South Tipperary,2020,20 - 24 years,1,1,2
Rest of South Tipperary,2020,25 - 29 years,1,1,2
Rest of South Tipperary,2020,30 - 34 years,1,3,4
Rest of South Tipperary,2020,35 - 39 years,2,2,4
Rest of South Tipperary,2020,40 - 44 years,1,2,3
Rest of South Tipperary,2020,45 - 49 years,3,2,5
Rest of South Tipperary,2020,5 - 9 years,0,1,1
Rest of South Tipperary,2020,50 - 54 years,6,8,14
Rest of South Tipperary,2020,55 - 59 years,3,8,11
Rest of South Tipperary,2020,60 - 64 years,7,8,15
Rest of South Tipperary,2020,65 - 69 years,5,16,21
Rest of South Tipperary,2020,70 - 74 years,10,18,28
Rest of South Tipperary,2020,75 - 79 years,22,29,51
Rest of South Tipperary,2020,80 - 84 years,32,32,64
Rest of South Tipperary,2020,85 years and over,77,48,125
Rest of South Tipperary,2020,Under 1 year,4,2,6
Rest of Waterford,2007,1 - 4 years,1,0,1
Rest of Waterford,2007,10 - 14 years,0,1,1
Rest of Waterford,2007,15 - 19 years,0,1,1
Rest of Waterford,2007,20 - 24 years,0,3,3
Rest of Waterford,2007,25 - 29 years,3,0,3
Rest of Waterford,2007,30 - 34 years,1,1,2
Rest of Waterford,2007,35 - 39 years,1,1,2
Rest of Waterford,2007,40 - 44 years,2,2,4
Rest of Waterford,2007,45 - 49 years,1,8,9
Rest of Waterford,2007,5 - 9 years,0,0,0
Rest of Waterford,2007,50 - 54 years,4,4,8
Rest of Waterford,2007,55 - 59 years,7,3,10
Rest of Waterford,2007,60 - 64 years,9,14,23
Rest of Waterford,2007,65 - 69 years,8,18,26
Rest of Waterford,2007,70 - 74 years,14,19,33
Rest of Waterford,2007,75 - 79 years,27,20,47
Rest of Waterford,2007,80 - 84 years,33,29,62
Rest of Waterford,2007,85 years and over,66,35,101
Rest of Waterford,2007,Under 1 year,1,1,2
Rest of Waterford,2008,1 - 4 years,1,0,1
Rest of Waterford,2008,10 - 14 years,1,1,2
Rest of Waterford,2008,15 - 19 years,0,1,1
Rest of Waterford,2008,20 - 24 years,1,3,4
Rest of Waterford,2008,25 - 29 years,1,2,3
Rest of Waterford,2008,30 - 34 years,1,4,5
Rest of Waterford,2008,35 - 39 years,3,2,5
Rest of Waterford,2008,40 - 44 years,2,3,5
Rest of Waterford,2008,45 - 49 years,2,5,7
Rest of Waterford,2008,5 - 9 years,1,1,2
Rest of Waterford,2008,50 - 54 years,2,5,7
Rest of Waterford,2008,55 - 59 years,5,11,16
Rest of Waterford,2008,60 - 64 years,7,7,14
Rest of Waterford,2008,65 - 69 years,17,18,35
Rest of Waterford,2008,70 - 74 years,12,18,30
Rest of Waterford,2008,75 - 79 years,20,21,41
Rest of Waterford,2008,80 - 84 years,30,30,60
Rest of Waterford,2008,85 years and over,75,51,126
Rest of Waterford,2008,Under 1 year,2,2,4
Rest of Waterford,2009,1 - 4 years,1,1,2
Rest of Waterford,2009,10 - 14 years,2,1,3
Rest of Waterford,2009,15 - 19 years,1,1,2
Rest of Waterford,2009,20 - 24 years,2,1,3
Rest of Waterford,2009,25 - 29 years,1,2,3
Rest of Waterford,2009,30 - 34 years,2,4,6
Rest of Waterford,2009,35 - 39 years,3,5,8
Rest of Waterford,2009,40 - 44 years,2,5,7
Rest of Waterford,2009,45 - 49 years,3,4,7
Rest of Waterford,2009,5 - 9 years,1,1,2
Rest of Waterford,2009,50 - 54 years,5,7,12
Rest of Waterford,2009,55 - 59 years,12,11,23
Rest of Waterford,2009,60 - 64 years,11,14,25
Rest of Waterford,2009,65 - 69 years,11,18,29
Rest of Waterford,2009,70 - 74 years,20,29,49
Rest of Waterford,2009,75 - 79 years,20,30,50
Rest of Waterford,2009,80 - 84 years,39,45,84
Rest of Waterford,2009,85 years and over,77,43,120
Rest of Waterford,2009,Under 1 year,3,2,5
Rest of Waterford,2010,1 - 4 years,1,1,2
Rest of Waterford,2010,10 - 14 years,2,1,3
Rest of Waterford,2010,15 - 19 years,1,1,2
Rest of Waterford,2010,20 - 24 years,2,1,3
Rest of Waterford,2010,25 - 29 years,1,2,3
Rest of Waterford,2010,30 - 34 years,1,5,6
Rest of Waterford,2010,35 - 39 years,3,5,8
Rest of Waterford,2010,40 - 44 years,3,1,4
Rest of Waterford,2010,45 - 49 years,4,2,6
Rest of Waterford,2010,5 - 9 years,1,1,2
Rest of Waterford,2010,50 - 54 years,4,7,11
Rest of Waterford,2010,55 - 59 years,11,6,17
Rest of Waterford,2010,60 - 64 years,8,16,24
Rest of Waterford,2010,65 - 69 years,10,16,26
Rest of Waterford,2010,70 - 74 years,12,21,33
Rest of Waterford,2010,75 - 79 years,19,38,57
Rest of Waterford,2010,80 - 84 years,39,34,73
Rest of Waterford,2010,85 years and over,68,37,105
Rest of Waterford,2010,Under 1 year,1,2,3
Rest of Waterford,2011,1 - 4 years,0,0,0
Rest of Waterford,2011,10 - 14 years,0,0,0
Rest of Waterford,2011,15 - 19 years,1,1,2
Rest of Waterford,2011,20 - 24 years,1,0,1
Rest of Waterford,2011,25 - 29 years,0,3,3
Rest of Waterford,2011,30 - 34 years,1,0,1
Rest of Waterford,2011,35 - 39 years,1,2,3
Rest of Waterford,2011,40 - 44 years,0,1,1
Rest of Waterford,2011,45 - 49 years,4,5,9
Rest of Waterford,2011,5 - 9 years,1,0,1
Rest of Waterford,2011,50 - 54 years,3,12,15
Rest of Waterford,2011,55 - 59 years,3,9,12
Rest of Waterford,2011,60 - 64 years,11,15,26
Rest of Waterford,2011,65 - 69 years,12,18,30
Rest of Waterford,2011,70 - 74 years,16,33,49
Rest of Waterford,2011,75 - 79 years,24,29,53
Rest of Waterford,2011,80 - 84 years,36,40,76
Rest of Waterford,2011,85 years and over,62,39,101
Rest of Waterford,2011,Under 1 year,0,5,5
Rest of Waterford,2012,1 - 4 years,0,0,0
Rest of Waterford,2012,10 - 14 years,1,0,1
Rest of Waterford,2012,15 - 19 years,1,1,2
Rest of Waterford,2012,20 - 24 years,1,3,4
Rest of Waterford,2012,25 - 29 years,0,2,2
Rest of Waterford,2012,30 - 34 years,1,2,3
Rest of Waterford,2012,35 - 39 years,1,2,3
Rest of Waterford,2012,40 - 44 years,2,2,4
Rest of Waterford,2012,45 - 49 years,4,3,7
Rest of Waterford,2012,5 - 9 years,1,0,1
Rest of Waterford,2012,50 - 54 years,5,9,14
Rest of Waterford,2012,55 - 59 years,5,5,10
Rest of Waterford,2012,60 - 64 years,8,15,23
Rest of Waterford,2012,65 - 69 years,10,19,29
Rest of Waterford,2012,70 - 74 years,19,19,38
Rest of Waterford,2012,75 - 79 years,26,33,59
Rest of Waterford,2012,80 - 84 years,35,46,81
Rest of Waterford,2012,85 years and over,92,57,149
Rest of Waterford,2012,Under 1 year,1,3,4
Rest of Waterford,2013,1 - 4 years,1,0,1
Rest of Waterford,2013,10 - 14 years,0,0,0
Rest of Waterford,2013,15 - 19 years,0,0,0
Rest of Waterford,2013,20 - 24 years,1,0,1
Rest of Waterford,2013,25 - 29 years,0,1,1
Rest of Waterford,2013,30 - 34 years,0,0,0
Rest of Waterford,2013,35 - 39 years,3,3,6
Rest of Waterford,2013,40 - 44 years,0,1,1
Rest of Waterford,2013,45 - 49 years,1,4,5
Rest of Waterford,2013,5 - 9 years,0,0,0
Rest of Waterford,2013,50 - 54 years,2,5,7
Rest of Waterford,2013,55 - 59 years,6,13,19
Rest of Waterford,2013,60 - 64 years,6,8,14
Rest of Waterford,2013,65 - 69 years,4,14,18
Rest of Waterford,2013,70 - 74 years,13,20,33
Rest of Waterford,2013,75 - 79 years,13,26,39
Rest of Waterford,2013,80 - 84 years,23,27,50
Rest of Waterford,2013,85 years and over,63,48,111
Rest of Waterford,2013,Under 1 year,3,1,4
Rest of Waterford,2014,1 - 4 years,1,0,1
Rest of Waterford,2014,10 - 14 years,0,0,0
Rest of Waterford,2014,15 - 19 years,0,1,1
Rest of Waterford,2014,20 - 24 years,1,2,3
Rest of Waterford,2014,25 - 29 years,0,1,1
Rest of Waterford,2014,30 - 34 years,0,0,0
Rest of Waterford,2014,35 - 39 years,1,2,3
Rest of Waterford,2014,40 - 44 years,2,2,4
Rest of Waterford,2014,45 - 49 years,4,1,5
Rest of Waterford,2014,5 - 9 years,0,0,0
Rest of Waterford,2014,50 - 54 years,5,9,14
Rest of Waterford,2014,55 - 59 years,8,6,14
Rest of Waterford,2014,60 - 64 years,7,12,19
Rest of Waterford,2014,65 - 69 years,8,15,23
Rest of Waterford,2014,70 - 74 years,9,18,27
Rest of Waterford,2014,75 - 79 years,16,18,34
Rest of Waterford,2014,80 - 84 years,26,26,52
Rest of Waterford,2014,85 years and over,63,48,111
Rest of Waterford,2014,Under 1 year,3,2,5
Rest of Waterford,2015,1 - 4 years,1,0,1
Rest of Waterford,2015,10 - 14 years,0,0,0
Rest of Waterford,2015,15 - 19 years,0,1,1
Rest of Waterford,2015,20 - 24 years,1,2,3
Rest of Waterford,2015,25 - 29 years,0,1,1
Rest of Waterford,2015,30 - 34 years,0,0,0
Rest of Waterford,2015,35 - 39 years,1,2,3
Rest of Waterford,2015,40 - 44 years,2,2,4
Rest of Waterford,2015,45 - 49 years,4,1,5
Rest of Waterford,2015,5 - 9 years,0,0,0
Rest of Waterford,2015,50 - 54 years,5,9,14
Rest of Waterford,2015,55 - 59 years,8,6,14
Rest of Waterford,2015,60 - 64 years,7,12,19
Rest of Waterford,2015,65 - 69 years,8,15,23
Rest of Waterford,2015,70 - 74 years,9,18,27
Rest of Waterford,2015,75 - 79 years,16,18,34
Rest of Waterford,2015,80 - 84 years,26,26,52
Rest of Waterford,2015,85 years and over,63,48,111
Rest of Waterford,2015,Under 1 year,3,2,5
Rest of Waterford,2016,1 - 4 years,1,0,1
Rest of Waterford,2016,10 - 14 years,0,0,0
Rest of Waterford,2016,15 - 19 years,0,1,1
Rest of Waterford,2016,20 - 24 years,1,2,3
Rest of Waterford,2016,25 - 29 years,0,1,1
Rest of Waterford,2016,30 - 34 years,0,0,0
Rest of Waterford,2016,35 - 39 years,1,2,3
Rest of Waterford,2016,40 - 44 years,2,2,4
Rest of Waterford,2016,45 - 49 years,4,1,5
Rest of Waterford,2016,5 - 9 years,0,0,0
Rest of Waterford,2016,50 - 54 years,5,9,14
Rest of Waterford,2016,55 - 59 years,8,6,14
Rest of Waterford,2016,60 - 64 years,7,12,19
Rest of Waterford,2016,65 - 69 years,8,15,23
Rest of Waterford,2016,70 - 74 years,9,18,27
Rest of Waterford,2016,75 - 79 years,16,18,34
Rest of Waterford,2016,80 - 84 years,26,26,52
Rest of Waterford,2016,85 years and over,63,48,111
Rest of Waterford,2016,Under 1 year,3,2,5
Rest of Waterford,2017,1 - 4 years,1,0,1
Rest of Waterford,2017,10 - 14 years,1,0,1
Rest of Waterford,2017,15 - 19 years,0,1,1
Rest of Waterford,2017,20 - 24 years,1,2,3
Rest of Waterford,2017,25 - 29 years,0,1,1
Rest of Waterford,2017,30 - 34 years,0,1,1
Rest of Waterford,2017,35 - 39 years,1,1,2
Rest of Waterford,2017,40 - 44 years,1,3,4
Rest of Waterford,2017,45 - 49 years,2,1,3
Rest of Waterford,2017,5 - 9 years,1,0,1
Rest of Waterford,2017,50 - 54 years,5,8,13
Rest of Waterford,2017,55 - 59 years,5,6,11
Rest of Waterford,2017,60 - 64 years,3,9,12
Rest of Waterford,2017,65 - 69 years,5,9,14
Rest of Waterford,2017,70 - 74 years,8,19,27
Rest of Waterford,2017,75 - 79 years,15,28,43
Rest of Waterford,2017,80 - 84 years,19,29,48
Rest of Waterford,2017,85 years and over,70,48,118
Rest of Waterford,2017,Under 1 year,1,1,2
Rest of Waterford,2018,1 - 4 years,0,0,0
Rest of Waterford,2018,10 - 14 years,0,0,0
Rest of Waterford,2018,15 - 19 years,1,1,2
Rest of Waterford,2018,20 - 24 years,0,0,0
Rest of Waterford,2018,25 - 29 years,0,0,0
Rest of Waterford,2018,30 - 34 years,0,2,2
Rest of Waterford,2018,35 - 39 years,0,3,3
Rest of Waterford,2018,40 - 44 years,2,5,7
Rest of Waterford,2018,45 - 49 years,2,5,7
Rest of Waterford,2018,5 - 9 years,0,0,0
Rest of Waterford,2018,50 - 54 years,3,5,8
Rest of Waterford,2018,55 - 59 years,4,6,10
Rest of Waterford,2018,60 - 64 years,5,7,12
Rest of Waterford,2018,65 - 69 years,3,14,17
Rest of Waterford,2018,70 - 74 years,12,23,35
Rest of Waterford,2018,75 - 79 years,24,26,50
Rest of Waterford,2018,80 - 84 years,30,29,59
Rest of Waterford,2018,85 years and over,68,46,114
Rest of Waterford,2018,Under 1 year,0,0,0
Rest of Waterford,2019,1 - 4 years,0,0,0
Rest of Waterford,2019,10 - 14 years,0,0,0
Rest of Waterford,2019,15 - 19 years,1,1,2
Rest of Waterford,2019,20 - 24 years,0,0,0
Rest of Waterford,2019,25 - 29 years,0,0,0
Rest of Waterford,2019,30 - 34 years,0,2,2
Rest of Waterford,2019,35 - 39 years,0,3,3
Rest of Waterford,2019,40 - 44 years,2,5,7
Rest of Waterford,2019,45 - 49 years,2,5,7
Rest of Waterford,2019,5 - 9 years,0,0,0
Rest of Waterford,2019,50 - 54 years,3,5,8
Rest of Waterford,2019,55 - 59 years,4,6,10
Rest of Waterford,2019,60 - 64 years,5,7,12
Rest of Waterford,2019,65 - 69 years,3,14,17
Rest of Waterford,2019,70 - 74 years,12,23,35
Rest of Waterford,2019,75 - 79 years,24,26,50
Rest of Waterford,2019,80 - 84 years,30,29,59
Rest of Waterford,2019,85 years and over,68,46,114
Rest of Waterford,2019,Under 1 year,0,0,0
Rest of Waterford,2020,1 - 4 years,0,0,0
Rest of Waterford,2020,10 - 14 years,0,0,0
Rest of Waterford,2020,15 - 19 years,1,1,2
Rest of Waterford,2020,20 - 24 years,0,0,0
Rest of Waterford,2020,25 - 29 years,0,0,0
Rest of Waterford,2020,30 - 34 years,0,2,2
Rest of Waterford,2020,35 - 39 years,0,3,3
Rest of Waterford,2020,40 - 44 years,2,5,7
Rest of Waterford,2020,45 - 49 years,2,5,7
Rest of Waterford,2020,5 - 9 years,0,0,0
Rest of Waterford,2020,50 - 54 years,3,5,8
Rest of Waterford,2020,55 - 59 years,4,6,10
Rest of Waterford,2020,60 - 64 years,5,7,12
Rest of Waterford,2020,65 - 69 years,3,14,17
Rest of Waterford,2020,70 - 74 years,12,23,35
Rest of Waterford,2020,75 - 79 years,24,26,50
Rest of Waterford,2020,80 - 84 years,30,29,59
Rest of Waterford,2020,85 years and over,68,46,114
Rest of Waterford,2020,Under 1 year,0,0,0
Rest of Wicklow,2007,1 - 4 years,2,0,2
Rest of Wicklow,2007,10 - 14 years,0,1,1
Rest of Wicklow,2007,15 - 19 years,1,3,4
Rest of Wicklow,2007,20 - 24 years,0,2,2
Rest of Wicklow,2007,25 - 29 years,1,3,4
Rest of Wicklow,2007,30 - 34 years,3,2,5
Rest of Wicklow,2007,35 - 39 years,1,3,4
Rest of Wicklow,2007,40 - 44 years,4,3,7
Rest of Wicklow,2007,45 - 49 years,4,5,9
Rest of Wicklow,2007,5 - 9 years,0,1,1
Rest of Wicklow,2007,50 - 54 years,6,4,10
Rest of Wicklow,2007,55 - 59 years,4,14,18
Rest of Wicklow,2007,60 - 64 years,10,21,31
Rest of Wicklow,2007,65 - 69 years,14,24,38
Rest of Wicklow,2007,70 - 74 years,16,19,35
Rest of Wicklow,2007,75 - 79 years,36,35,71
Rest of Wicklow,2007,80 - 84 years,39,47,86
Rest of Wicklow,2007,85 years and over,76,54,130
Rest of Wicklow,2007,Under 1 year,1,2,3
Rest of Wicklow,2008,1 - 4 years,2,0,2
Rest of Wicklow,2008,10 - 14 years,0,2,2
Rest of Wicklow,2008,15 - 19 years,1,3,4
Rest of Wicklow,2008,20 - 24 years,0,2,2
Rest of Wicklow,2008,25 - 29 years,3,6,9
Rest of Wicklow,2008,30 - 34 years,1,3,4
Rest of Wicklow,2008,35 - 39 years,2,3,5
Rest of Wicklow,2008,40 - 44 years,2,3,5
Rest of Wicklow,2008,45 - 49 years,2,9,11
Rest of Wicklow,2008,5 - 9 years,0,1,1
Rest of Wicklow,2008,50 - 54 years,7,9,16
Rest of Wicklow,2008,55 - 59 years,7,9,16
Rest of Wicklow,2008,60 - 64 years,12,19,31
Rest of Wicklow,2008,65 - 69 years,15,15,30
Rest of Wicklow,2008,70 - 74 years,18,24,42
Rest of Wicklow,2008,75 - 79 years,21,24,45
Rest of Wicklow,2008,80 - 84 years,32,47,79
Rest of Wicklow,2008,85 years and over,66,40,106
Rest of Wicklow,2008,Under 1 year,2,4,6
Rest of Wicklow,2009,1 - 4 years,2,0,2
Rest of Wicklow,2009,10 - 14 years,1,2,3
Rest of Wicklow,2009,15 - 19 years,1,2,3
Rest of Wicklow,2009,20 - 24 years,0,2,2
Rest of Wicklow,2009,25 - 29 years,3,1,4
Rest of Wicklow,2009,30 - 34 years,1,1,2
Rest of Wicklow,2009,35 - 39 years,2,5,7
Rest of Wicklow,2009,40 - 44 years,2,4,6
Rest of Wicklow,2009,45 - 49 years,3,3,6
Rest of Wicklow,2009,5 - 9 years,0,1,1
Rest of Wicklow,2009,50 - 54 years,8,11,19
Rest of Wicklow,2009,55 - 59 years,10,12,22
Rest of Wicklow,2009,60 - 64 years,6,22,28
Rest of Wicklow,2009,65 - 69 years,15,23,38
Rest of Wicklow,2009,70 - 74 years,23,34,57
Rest of Wicklow,2009,75 - 79 years,27,32,59
Rest of Wicklow,2009,80 - 84 years,30,45,75
Rest of Wicklow,2009,85 years and over,73,53,126
Rest of Wicklow,2009,Under 1 year,3,1,4
Rest of Wicklow,2010,1 - 4 years,2,1,3
Rest of Wicklow,2010,10 - 14 years,1,2,3
Rest of Wicklow,2010,15 - 19 years,1,1,2
Rest of Wicklow,2010,20 - 24 years,1,2,3
Rest of Wicklow,2010,25 - 29 years,3,2,5
Rest of Wicklow,2010,30 - 34 years,1,2,3
Rest of Wicklow,2010,35 - 39 years,1,1,2
Rest of Wicklow,2010,40 - 44 years,1,2,3
Rest of Wicklow,2010,45 - 49 years,7,9,16
Rest of Wicklow,2010,5 - 9 years,0,1,1
Rest of Wicklow,2010,50 - 54 years,6,4,10
Rest of Wicklow,2010,55 - 59 years,1,7,8
Rest of Wicklow,2010,60 - 64 years,9,19,28
Rest of Wicklow,2010,65 - 69 years,14,22,36
Rest of Wicklow,2010,70 - 74 years,12,24,36
Rest of Wicklow,2010,75 - 79 years,18,36,54
Rest of Wicklow,2010,80 - 84 years,29,41,70
Rest of Wicklow,2010,85 years and over,76,42,118
Rest of Wicklow,2010,Under 1 year,4,7,11
Rest of Wicklow,2011,1 - 4 years,0,1,1
Rest of Wicklow,2011,10 - 14 years,1,0,1
Rest of Wicklow,2011,15 - 19 years,0,0,0
Rest of Wicklow,2011,20 - 24 years,0,3,3
Rest of Wicklow,2011,25 - 29 years,1,1,2
Rest of Wicklow,2011,30 - 34 years,1,2,3
Rest of Wicklow,2011,35 - 39 years,2,4,6
Rest of Wicklow,2011,40 - 44 years,2,4,6
Rest of Wicklow,2011,45 - 49 years,7,8,15
Rest of Wicklow,2011,5 - 9 years,0,1,1
Rest of Wicklow,2011,50 - 54 years,6,9,15
Rest of Wicklow,2011,55 - 59 years,10,18,28
Rest of Wicklow,2011,60 - 64 years,12,18,30
Rest of Wicklow,2011,65 - 69 years,10,24,34
Rest of Wicklow,2011,70 - 74 years,17,33,50
Rest of Wicklow,2011,75 - 79 years,23,36,59
Rest of Wicklow,2011,80 - 84 years,35,37,72
Rest of Wicklow,2011,85 years and over,88,51,139
Rest of Wicklow,2011,Under 1 year,3,2,5
Rest of Wicklow,2012,1 - 4 years,0,1,1
Rest of Wicklow,2012,10 - 14 years,1,0,1
Rest of Wicklow,2012,15 - 19 years,0,1,1
Rest of Wicklow,2012,20 - 24 years,1,2,3
Rest of Wicklow,2012,25 - 29 years,1,1,2
Rest of Wicklow,2012,30 - 34 years,2,1,3
Rest of Wicklow,2012,35 - 39 years,4,3,7
Rest of Wicklow,2012,40 - 44 years,4,5,9
Rest of Wicklow,2012,45 - 49 years,1,6,7
Rest of Wicklow,2012,5 - 9 years,0,1,1
Rest of Wicklow,2012,50 - 54 years,5,6,11
Rest of Wicklow,2012,55 - 59 years,11,6,17
Rest of Wicklow,2012,60 - 64 years,8,23,31
Rest of Wicklow,2012,65 - 69 years,9,30,39
Rest of Wicklow,2012,70 - 74 years,20,20,40
Rest of Wicklow,2012,75 - 79 years,29,38,67
Rest of Wicklow,2012,80 - 84 years,37,32,69
Rest of Wicklow,2012,85 years and over,91,47,138
Rest of Wicklow,2012,Under 1 year,3,1,4
Rest of Wicklow,2013,1 - 4 years,0,1,1
Rest of Wicklow,2013,10 - 14 years,1,0,1
Rest of Wicklow,2013,15 - 19 years,0,0,0
Rest of Wicklow,2013,20 - 24 years,1,0,1
Rest of Wicklow,2013,25 - 29 years,2,3,5
Rest of Wicklow,2013,30 - 34 years,0,1,1
Rest of Wicklow,2013,35 - 39 years,1,3,4
Rest of Wicklow,2013,40 - 44 years,0,4,4
Rest of Wicklow,2013,45 - 49 years,4,4,8
Rest of Wicklow,2013,5 - 9 years,0,0,0
Rest of Wicklow,2013,50 - 54 years,6,8,14
Rest of Wicklow,2013,55 - 59 years,9,8,17
Rest of Wicklow,2013,60 - 64 years,4,7,11
Rest of Wicklow,2013,65 - 69 years,10,17,27
Rest of Wicklow,2013,70 - 74 years,13,22,35
Rest of Wicklow,2013,75 - 79 years,26,26,52
Rest of Wicklow,2013,80 - 84 years,29,28,57
Rest of Wicklow,2013,85 years and over,88,55,143
Rest of Wicklow,2013,Under 1 year,1,3,4
Rest of Wicklow,2014,1 - 4 years,0,1,1
Rest of Wicklow,2014,10 - 14 years,1,1,2
Rest of Wicklow,2014,15 - 19 years,0,0,0
Rest of Wicklow,2014,20 - 24 years,1,2,3
Rest of Wicklow,2014,25 - 29 years,2,2,4
Rest of Wicklow,2014,30 - 34 years,1,3,4
Rest of Wicklow,2014,35 - 39 years,1,4,5
Rest of Wicklow,2014,40 - 44 years,1,4,5
Rest of Wicklow,2014,45 - 49 years,2,7,9
Rest of Wicklow,2014,5 - 9 years,0,0,0
Rest of Wicklow,2014,50 - 54 years,8,4,12
Rest of Wicklow,2014,55 - 59 years,10,10,20
Rest of Wicklow,2014,60 - 64 years,8,17,25
Rest of Wicklow,2014,65 - 69 years,18,21,39
Rest of Wicklow,2014,70 - 74 years,15,23,38
Rest of Wicklow,2014,75 - 79 years,20,21,41
Rest of Wicklow,2014,80 - 84 years,28,30,58
Rest of Wicklow,2014,85 years and over,87,43,130
Rest of Wicklow,2014,Under 1 year,2,2,4
Rest of Wicklow,2015,1 - 4 years,0,1,1
Rest of Wicklow,2015,10 - 14 years,1,1,2
Rest of Wicklow,2015,15 - 19 years,0,0,0
Rest of Wicklow,2015,20 - 24 years,1,2,3
Rest of Wicklow,2015,25 - 29 years,2,2,4
Rest of Wicklow,2015,30 - 34 years,1,3,4
Rest of Wicklow,2015,35 - 39 years,1,4,5
Rest of Wicklow,2015,40 - 44 years,1,4,5
Rest of Wicklow,2015,45 - 49 years,2,7,9
Rest of Wicklow,2015,5 - 9 years,0,0,0
Rest of Wicklow,2015,50 - 54 years,8,4,12
Rest of Wicklow,2015,55 - 59 years,10,10,20
Rest of Wicklow,2015,60 - 64 years,8,17,25
Rest of Wicklow,2015,65 - 69 years,18,21,39
Rest of Wicklow,2015,70 - 74 years,15,23,38
Rest of Wicklow,2015,75 - 79 years,20,21,41
Rest of Wicklow,2015,80 - 84 years,28,30,58
Rest of Wicklow,2015,85 years and over,87,43,130
Rest of Wicklow,2015,Under 1 year,2,2,4
Rest of Wicklow,2016,1 - 4 years,0,1,1
Rest of Wicklow,2016,10 - 14 years,1,1,2
Rest of Wicklow,2016,15 - 19 years,0,0,0
Rest of Wicklow,2016,20 - 24 years,1,2,3
Rest of Wicklow,2016,25 - 29 years,2,2,4
Rest of Wicklow,2016,30 - 34 years,1,3,4
Rest of Wicklow,2016,35 - 39 years,1,4,5
Rest of Wicklow,2016,40 - 44 years,1,4,5
Rest of Wicklow,2016,45 - 49 years,2,7,9
Rest of Wicklow,2016,5 - 9 years,0,0,0
Rest of Wicklow,2016,50 - 54 years,8,4,12
Rest of Wicklow,2016,55 - 59 years,10,10,20
Rest of Wicklow,2016,60 - 64 years,8,17,25
Rest of Wicklow,2016,65 - 69 years,18,21,39
Rest of Wicklow,2016,70 - 74 years,15,23,38
Rest of Wicklow,2016,75 - 79 years,20,21,41
Rest of Wicklow,2016,80 - 84 years,28,30,58
Rest of Wicklow,2016,85 years and over,87,43,130
Rest of Wicklow,2016,Under 1 year,2,2,4
Rest of Wicklow,2017,1 - 4 years,0,1,1
Rest of Wicklow,2017,10 - 14 years,1,1,2
Rest of Wicklow,2017,15 - 19 years,0,0,0
Rest of Wicklow,2017,20 - 24 years,1,1,2
Rest of Wicklow,2017,25 - 29 years,2,2,4
Rest of Wicklow,2017,30 - 34 years,1,3,4
Rest of Wicklow,2017,35 - 39 years,1,3,4
Rest of Wicklow,2017,40 - 44 years,2,5,7
Rest of Wicklow,2017,45 - 49 years,3,2,5
Rest of Wicklow,2017,5 - 9 years,0,0,0
Rest of Wicklow,2017,50 - 54 years,7,6,13
Rest of Wicklow,2017,55 - 59 years,4,14,18
Rest of Wicklow,2017,60 - 64 years,8,7,15
Rest of Wicklow,2017,65 - 69 years,20,21,41
Rest of Wicklow,2017,70 - 74 years,26,38,64
Rest of Wicklow,2017,75 - 79 years,21,33,54
Rest of Wicklow,2017,80 - 84 years,25,38,63
Rest of Wicklow,2017,85 years and over,66,64,130
Rest of Wicklow,2017,Under 1 year,2,3,5
Rest of Wicklow,2018,1 - 4 years,0,0,0
Rest of Wicklow,2018,10 - 14 years,0,0,0
Rest of Wicklow,2018,15 - 19 years,1,0,1
Rest of Wicklow,2018,20 - 24 years,1,2,3
Rest of Wicklow,2018,25 - 29 years,0,2,2
Rest of Wicklow,2018,30 - 34 years,2,2,4
Rest of Wicklow,2018,35 - 39 years,2,2,4
Rest of Wicklow,2018,40 - 44 years,2,3,5
Rest of Wicklow,2018,45 - 49 years,1,9,10
Rest of Wicklow,2018,5 - 9 years,0,0,0
Rest of Wicklow,2018,50 - 54 years,8,0,8
Rest of Wicklow,2018,55 - 59 years,7,7,14
Rest of Wicklow,2018,60 - 64 years,12,13,25
Rest of Wicklow,2018,65 - 69 years,13,24,37
Rest of Wicklow,2018,70 - 74 years,20,32,52
Rest of Wicklow,2018,75 - 79 years,29,28,57
Rest of Wicklow,2018,80 - 84 years,35,38,73
Rest of Wicklow,2018,85 years and over,80,67,147
Rest of Wicklow,2018,Under 1 year,1,3,4
Rest of Wicklow,2019,1 - 4 years,0,0,0
Rest of Wicklow,2019,10 - 14 years,0,0,0
Rest of Wicklow,2019,15 - 19 years,1,0,1
Rest of Wicklow,2019,20 - 24 years,1,2,3
Rest of Wicklow,2019,25 - 29 years,0,2,2
Rest of Wicklow,2019,30 - 34 years,2,2,4
Rest of Wicklow,2019,35 - 39 years,2,2,4
Rest of Wicklow,2019,40 - 44 years,2,3,5
Rest of Wicklow,2019,45 - 49 years,1,9,10
Rest of Wicklow,2019,5 - 9 years,0,0,0
Rest of Wicklow,2019,50 - 54 years,8,0,8
Rest of Wicklow,2019,55 - 59 years,7,7,14
Rest of Wicklow,2019,60 - 64 years,12,13,25
Rest of Wicklow,2019,65 - 69 years,13,24,37
Rest of Wicklow,2019,70 - 74 years,20,32,52
Rest of Wicklow,2019,75 - 79 years,29,28,57
Rest of Wicklow,2019,80 - 84 years,35,38,73
Rest of Wicklow,2019,85 years and over,80,67,147
Rest of Wicklow,2019,Under 1 year,1,3,4
Rest of Wicklow,2020,1 - 4 years,0,0,0
Rest of Wicklow,2020,10 - 14 years,0,0,0
Rest of Wicklow,2020,15 - 19 years,1,0,1
Rest of Wicklow,2020,20 - 24 years,1,2,3
Rest of Wicklow,2020,25 - 29 years,0,2,2
Rest of Wicklow,2020,30 - 34 years,2,2,4
Rest of Wicklow,2020,35 - 39 years,2,2,4
Rest of Wicklow,2020,40 - 44 years,2,3,5
Rest of Wicklow,2020,45 - 49 years,1,9,10
Rest of Wicklow,2020,5 - 9 years,0,0,0
Rest of Wicklow,2020,50 - 54 years,8,0,8
Rest of Wicklow,2020,55 - 59 years,7,7,14
Rest of Wicklow,2020,60 - 64 years,12,13,25
Rest of Wicklow,2020,65 - 69 years,13,24,37
Rest of Wicklow,2020,70 - 74 years,20,32,52
Rest of Wicklow,2020,75 - 79 years,29,28,57
Rest of Wicklow,2020,80 - 84 years,35,38,73
Rest of Wicklow,2020,85 years and over,80,67,147
Rest of Wicklow,2020,Under 1 year,1,3,4
Roscommon,2007,1 - 4 years,0,0,0
Roscommon,2007,10 - 14 years,0,1,1
Roscommon,2007,15 - 19 years,1,3,4
Roscommon,2007,20 - 24 years,0,6,6
Roscommon,2007,25 - 29 years,0,4,4
Roscommon,2007,30 - 34 years,2,2,4
Roscommon,2007,35 - 39 years,1,3,4
Roscommon,2007,40 - 44 years,2,3,5
Roscommon,2007,45 - 49 years,3,3,6
Roscommon,2007,5 - 9 years,1,0,1
Roscommon,2007,50 - 54 years,2,6,8
Roscommon,2007,55 - 59 years,4,14,18
Roscommon,2007,60 - 64 years,4,16,20
Roscommon,2007,65 - 69 years,6,26,32
Roscommon,2007,70 - 74 years,14,29,43
Roscommon,2007,75 - 79 years,33,48,81
Roscommon,2007,80 - 84 years,51,63,114
Roscommon,2007,85 years and over,83,68,151
Roscommon,2007,Under 1 year,2,0,2
Roscommon,2008,1 - 4 years,0,0,0
Roscommon,2008,10 - 14 years,1,1,2
Roscommon,2008,15 - 19 years,1,2,3
Roscommon,2008,20 - 24 years,1,1,2
Roscommon,2008,25 - 29 years,1,1,2
Roscommon,2008,30 - 34 years,2,2,4
Roscommon,2008,35 - 39 years,2,2,4
Roscommon,2008,40 - 44 years,1,3,4
Roscommon,2008,45 - 49 years,3,5,8
Roscommon,2008,5 - 9 years,1,0,1
Roscommon,2008,50 - 54 years,4,8,12
Roscommon,2008,55 - 59 years,4,11,15
Roscommon,2008,60 - 64 years,15,22,37
Roscommon,2008,65 - 69 years,14,33,47
Roscommon,2008,70 - 74 years,31,41,72
Roscommon,2008,75 - 79 years,24,45,69
Roscommon,2008,80 - 84 years,49,51,100
Roscommon,2008,85 years and over,113,65,178
Roscommon,2008,Under 1 year,2,3,5
Roscommon,2009,1 - 4 years,0,0,0
Roscommon,2009,10 - 14 years,1,1,2
Roscommon,2009,15 - 19 years,1,1,2
Roscommon,2009,20 - 24 years,1,2,3
Roscommon,2009,25 - 29 years,3,1,4
Roscommon,2009,30 - 34 years,4,1,5
Roscommon,2009,35 - 39 years,1,2,3
Roscommon,2009,40 - 44 years,3,3,6
Roscommon,2009,45 - 49 years,4,3,7
Roscommon,2009,5 - 9 years,1,0,1
Roscommon,2009,50 - 54 years,4,10,14
Roscommon,2009,55 - 59 years,7,11,18
Roscommon,2009,60 - 64 years,9,21,30
Roscommon,2009,65 - 69 years,8,16,24
Roscommon,2009,70 - 74 years,19,35,54
Roscommon,2009,75 - 79 years,23,57,80
Roscommon,2009,80 - 84 years,39,61,100
Roscommon,2009,85 years and over,93,79,172
Roscommon,2009,Under 1 year,1,2,3
Roscommon,2010,1 - 4 years,0,0,0
Roscommon,2010,10 - 14 years,1,1,2
Roscommon,2010,15 - 19 years,1,1,2
Roscommon,2010,20 - 24 years,1,1,2
Roscommon,2010,25 - 29 years,1,3,4
Roscommon,2010,30 - 34 years,1,1,2
Roscommon,2010,35 - 39 years,1,2,3
Roscommon,2010,40 - 44 years,2,2,4
Roscommon,2010,45 - 49 years,1,8,9
Roscommon,2010,5 - 9 years,1,0,1
Roscommon,2010,50 - 54 years,1,13,14
Roscommon,2010,55 - 59 years,9,14,23
Roscommon,2010,60 - 64 years,8,23,31
Roscommon,2010,65 - 69 years,18,15,33
Roscommon,2010,70 - 74 years,15,30,45
Roscommon,2010,75 - 79 years,35,39,74
Roscommon,2010,80 - 84 years,40,40,80
Roscommon,2010,85 years and over,97,55,152
Roscommon,2010,Under 1 year,5,1,6
Roscommon,2011,1 - 4 years,0,0,0
Roscommon,2011,10 - 14 years,0,0,0
Roscommon,2011,15 - 19 years,0,0,0
Roscommon,2011,20 - 24 years,0,2,2
Roscommon,2011,25 - 29 years,0,0,0
Roscommon,2011,30 - 34 years,2,2,4
Roscommon,2011,35 - 39 years,0,1,1
Roscommon,2011,40 - 44 years,1,1,2
Roscommon,2011,45 - 49 years,2,3,5
Roscommon,2011,5 - 9 years,0,1,1
Roscommon,2011,50 - 54 years,11,6,17
Roscommon,2011,55 - 59 years,6,14,20
Roscommon,2011,60 - 64 years,10,15,25
Roscommon,2011,65 - 69 years,12,30,42
Roscommon,2011,70 - 74 years,9,26,35
Roscommon,2011,75 - 79 years,23,44,67
Roscommon,2011,80 - 84 years,44,43,87
Roscommon,2011,85 years and over,105,67,172
Roscommon,2011,Under 1 year,2,3,5
Roscommon,2012,1 - 4 years,0,0,0
Roscommon,2012,10 - 14 years,0,0,0
Roscommon,2012,15 - 19 years,1,1,2
Roscommon,2012,20 - 24 years,0,1,1
Roscommon,2012,25 - 29 years,2,2,4
Roscommon,2012,30 - 34 years,2,2,4
Roscommon,2012,35 - 39 years,0,2,2
Roscommon,2012,40 - 44 years,1,5,6
Roscommon,2012,45 - 49 years,2,7,9
Roscommon,2012,5 - 9 years,0,1,1
Roscommon,2012,50 - 54 years,5,4,9
Roscommon,2012,55 - 59 years,6,8,14
Roscommon,2012,60 - 64 years,11,16,27
Roscommon,2012,65 - 69 years,10,23,33
Roscommon,2012,70 - 74 years,15,26,41
Roscommon,2012,75 - 79 years,24,30,54
Roscommon,2012,80 - 84 years,45,55,100
Roscommon,2012,85 years and over,109,66,175
Roscommon,2012,Under 1 year,2,3,5
Roscommon,2013,1 - 4 years,0,0,0
Roscommon,2013,10 - 14 years,0,0,0
Roscommon,2013,15 - 19 years,0,1,1
Roscommon,2013,20 - 24 years,1,0,1
Roscommon,2013,25 - 29 years,0,2,2
Roscommon,2013,30 - 34 years,0,2,2
Roscommon,2013,35 - 39 years,1,3,4
Roscommon,2013,40 - 44 years,0,6,6
Roscommon,2013,45 - 49 years,4,3,7
Roscommon,2013,5 - 9 years,1,1,2
Roscommon,2013,50 - 54 years,4,8,12
Roscommon,2013,55 - 59 years,6,6,12
Roscommon,2013,60 - 64 years,2,18,20
Roscommon,2013,65 - 69 years,21,23,44
Roscommon,2013,70 - 74 years,20,28,48
Roscommon,2013,75 - 79 years,24,44,68
Roscommon,2013,80 - 84 years,38,45,83
Roscommon,2013,85 years and over,111,62,173
Roscommon,2013,Under 1 year,0,1,1
Roscommon,2014,1 - 4 years,0,0,0
Roscommon,2014,10 - 14 years,0,0,0
Roscommon,2014,15 - 19 years,0,1,1
Roscommon,2014,20 - 24 years,1,4,5
Roscommon,2014,25 - 29 years,1,1,2
Roscommon,2014,30 - 34 years,2,2,4
Roscommon,2014,35 - 39 years,3,1,4
Roscommon,2014,40 - 44 years,3,3,6
Roscommon,2014,45 - 49 years,3,7,10
Roscommon,2014,5 - 9 years,1,1,2
Roscommon,2014,50 - 54 years,5,7,12
Roscommon,2014,55 - 59 years,5,9,14
Roscommon,2014,60 - 64 years,10,18,28
Roscommon,2014,65 - 69 years,19,29,48
Roscommon,2014,70 - 74 years,11,28,39
Roscommon,2014,75 - 79 years,22,48,70
Roscommon,2014,80 - 84 years,40,50,90
Roscommon,2014,85 years and over,112,68,180
Roscommon,2014,Under 1 year,1,3,4
Roscommon,2015,1 - 4 years,0,0,0
Roscommon,2015,10 - 14 years,0,1,1
Roscommon,2015,15 - 19 years,0,1,1
Roscommon,2015,20 - 24 years,1,4,5
Roscommon,2015,25 - 29 years,1,1,2
Roscommon,2015,30 - 34 years,1,1,2
Roscommon,2015,35 - 39 years,3,2,5
Roscommon,2015,40 - 44 years,3,3,6
Roscommon,2015,45 - 49 years,3,6,9
Roscommon,2015,5 - 9 years,1,1,2
Roscommon,2015,50 - 54 years,3,10,13
Roscommon,2015,55 - 59 years,6,13,19
Roscommon,2015,60 - 64 years,10,11,21
Roscommon,2015,65 - 69 years,7,24,31
Roscommon,2015,70 - 74 years,21,30,51
Roscommon,2015,75 - 79 years,27,37,64
Roscommon,2015,80 - 84 years,27,57,84
Roscommon,2015,85 years and over,139,83,222
Roscommon,2015,Under 1 year,3,1,4
Roscommon,2016,1 - 4 years,0,0,0
Roscommon,2016,10 - 14 years,0,1,1
Roscommon,2016,15 - 19 years,0,1,1
Roscommon,2016,20 - 24 years,1,1,2
Roscommon,2016,25 - 29 years,1,1,2
Roscommon,2016,30 - 34 years,1,1,2
Roscommon,2016,35 - 39 years,1,4,5
Roscommon,2016,40 - 44 years,3,3,6
Roscommon,2016,45 - 49 years,5,4,9
Roscommon,2016,5 - 9 years,1,1,2
Roscommon,2016,50 - 54 years,2,6,8
Roscommon,2016,55 - 59 years,3,8,11
Roscommon,2016,60 - 64 years,3,18,21
Roscommon,2016,65 - 69 years,15,25,40
Roscommon,2016,70 - 74 years,15,29,44
Roscommon,2016,75 - 79 years,18,44,62
Roscommon,2016,80 - 84 years,42,38,80
Roscommon,2016,85 years and over,125,87,212
Roscommon,2016,Under 1 year,2,4,6
Roscommon,2017,1 - 4 years,0,1,1
Roscommon,2017,10 - 14 years,0,1,1
Roscommon,2017,15 - 19 years,0,1,1
Roscommon,2017,20 - 24 years,1,1,2
Roscommon,2017,25 - 29 years,1,2,3
Roscommon,2017,30 - 34 years,2,1,3
Roscommon,2017,35 - 39 years,1,1,2
Roscommon,2017,40 - 44 years,6,6,12
Roscommon,2017,45 - 49 years,4,4,8
Roscommon,2017,5 - 9 years,2,1,3
Roscommon,2017,50 - 54 years,2,6,8
Roscommon,2017,55 - 59 years,6,15,21
Roscommon,2017,60 - 64 years,9,14,23
Roscommon,2017,65 - 69 years,14,14,28
Roscommon,2017,70 - 74 years,16,26,42
Roscommon,2017,75 - 79 years,24,29,53
Roscommon,2017,80 - 84 years,28,44,72
Roscommon,2017,85 years and over,115,77,192
Roscommon,2017,Under 1 year,2,4,6
Roscommon,2018,1 - 4 years,1,1,2
Roscommon,2018,10 - 14 years,0,0,0
Roscommon,2018,15 - 19 years,0,0,0
Roscommon,2018,20 - 24 years,0,0,0
Roscommon,2018,25 - 29 years,0,0,0
Roscommon,2018,30 - 34 years,1,2,3
Roscommon,2018,35 - 39 years,1,2,3
Roscommon,2018,40 - 44 years,2,1,3
Roscommon,2018,45 - 49 years,5,4,9
Roscommon,2018,5 - 9 years,0,1,1
Roscommon,2018,50 - 54 years,6,8,14
Roscommon,2018,55 - 59 years,6,12,18
Roscommon,2018,60 - 64 years,7,17,24
Roscommon,2018,65 - 69 years,17,24,41
Roscommon,2018,70 - 74 years,19,29,48
Roscommon,2018,75 - 79 years,22,42,64
Roscommon,2018,80 - 84 years,28,41,69
Roscommon,2018,85 years and over,146,83,229
Roscommon,2018,Under 1 year,0,3,3
Roscommon,2019,1 - 4 years,0,0,0
Roscommon,2019,10 - 14 years,0,0,0
Roscommon,2019,15 - 19 years,0,0,0
Roscommon,2019,20 - 24 years,0,0,0
Roscommon,2019,25 - 29 years,2,1,3
Roscommon,2019,30 - 34 years,2,3,5
Roscommon,2019,35 - 39 years,2,5,7
Roscommon,2019,40 - 44 years,2,2,4
Roscommon,2019,45 - 49 years,2,3,5
Roscommon,2019,5 - 9 years,0,0,0
Roscommon,2019,50 - 54 years,2,8,10
Roscommon,2019,55 - 59 years,7,13,20
Roscommon,2019,60 - 64 years,13,20,33
Roscommon,2019,65 - 69 years,12,24,36
Roscommon,2019,70 - 74 years,22,28,50
Roscommon,2019,75 - 79 years,21,38,59
Roscommon,2019,80 - 84 years,27,47,74
Roscommon,2019,85 years and over,125,91,216
Roscommon,2019,Under 1 year,0,1,1
Roscommon,2020,1 - 4 years,0,0,0
Roscommon,2020,10 - 14 years,0,0,0
Roscommon,2020,15 - 19 years,0,0,0
Roscommon,2020,20 - 24 years,1,0,1
Roscommon,2020,25 - 29 years,2,1,3
Roscommon,2020,30 - 34 years,1,4,5
Roscommon,2020,35 - 39 years,2,5,7
Roscommon,2020,40 - 44 years,2,1,3
Roscommon,2020,45 - 49 years,1,4,5
Roscommon,2020,5 - 9 years,0,0,0
Roscommon,2020,50 - 54 years,6,8,14
Roscommon,2020,55 - 59 years,3,6,9
Roscommon,2020,60 - 64 years,9,14,23
Roscommon,2020,65 - 69 years,10,20,30
Roscommon,2020,70 - 74 years,21,29,50
Roscommon,2020,75 - 79 years,30,40,70
Roscommon,2020,80 - 84 years,35,57,92
Roscommon,2020,85 years and over,105,93,198
Roscommon,2020,Under 1 year,2,2,4
Skibbereen Town,2007,1 - 4 years,0,0,0
Skibbereen Town,2007,10 - 14 years,0,0,0
Skibbereen Town,2007,15 - 19 years,0,1,1
Skibbereen Town,2007,20 - 24 years,0,0,0
Skibbereen Town,2007,25 - 29 years,0,0,0
Skibbereen Town,2007,30 - 34 years,0,1,1
Skibbereen Town,2007,35 - 39 years,0,0,0
Skibbereen Town,2007,40 - 44 years,0,0,0
Skibbereen Town,2007,45 - 49 years,0,1,1
Skibbereen Town,2007,5 - 9 years,0,0,0
Skibbereen Town,2007,50 - 54 years,0,2,2
Skibbereen Town,2007,55 - 59 years,0,0,0
Skibbereen Town,2007,60 - 64 years,2,0,2
Skibbereen Town,2007,65 - 69 years,1,2,3
Skibbereen Town,2007,70 - 74 years,0,3,3
Skibbereen Town,2007,75 - 79 years,4,5,9
Skibbereen Town,2007,80 - 84 years,7,5,12
Skibbereen Town,2007,85 years and over,10,6,16
Skibbereen Town,2007,Under 1 year,0,0,0
Skibbereen Town,2008,1 - 4 years,0,0,0
Skibbereen Town,2008,10 - 14 years,0,0,0
Skibbereen Town,2008,15 - 19 years,0,1,1
Skibbereen Town,2008,20 - 24 years,0,0,0
Skibbereen Town,2008,25 - 29 years,0,3,3
Skibbereen Town,2008,30 - 34 years,0,1,1
Skibbereen Town,2008,35 - 39 years,0,1,1
Skibbereen Town,2008,40 - 44 years,0,0,0
Skibbereen Town,2008,45 - 49 years,0,1,1
Skibbereen Town,2008,5 - 9 years,0,0,0
Skibbereen Town,2008,50 - 54 years,0,5,5
Skibbereen Town,2008,55 - 59 years,0,1,1
Skibbereen Town,2008,60 - 64 years,2,3,5
Skibbereen Town,2008,65 - 69 years,1,2,3
Skibbereen Town,2008,70 - 74 years,3,7,10
Skibbereen Town,2008,75 - 79 years,4,3,7
Skibbereen Town,2008,80 - 84 years,5,2,7
Skibbereen Town,2008,85 years and over,10,6,16
Skibbereen Town,2008,Under 1 year,0,0,0
Skibbereen Town,2009,1 - 4 years,0,0,0
Skibbereen Town,2009,10 - 14 years,0,0,0
Skibbereen Town,2009,15 - 19 years,0,1,1
Skibbereen Town,2009,20 - 24 years,0,0,0
Skibbereen Town,2009,25 - 29 years,0,3,3
Skibbereen Town,2009,30 - 34 years,0,1,1
Skibbereen Town,2009,35 - 39 years,0,1,1
Skibbereen Town,2009,40 - 44 years,0,1,1
Skibbereen Town,2009,45 - 49 years,0,1,1
Skibbereen Town,2009,5 - 9 years,0,0,0
Skibbereen Town,2009,50 - 54 years,0,5,5
Skibbereen Town,2009,55 - 59 years,0,1,1
Skibbereen Town,2009,60 - 64 years,2,3,5
Skibbereen Town,2009,65 - 69 years,1,2,3
Skibbereen Town,2009,70 - 74 years,2,1,3
Skibbereen Town,2009,75 - 79 years,2,4,6
Skibbereen Town,2009,80 - 84 years,2,5,7
Skibbereen Town,2009,85 years and over,5,7,12
Skibbereen Town,2009,Under 1 year,0,1,1
Skibbereen Town,2010,1 - 4 years,0,0,0
Skibbereen Town,2010,10 - 14 years,0,0,0
Skibbereen Town,2010,15 - 19 years,0,1,1
Skibbereen Town,2010,20 - 24 years,0,0,0
Skibbereen Town,2010,25 - 29 years,0,3,3
Skibbereen Town,2010,30 - 34 years,0,1,1
Skibbereen Town,2010,35 - 39 years,1,1,2
Skibbereen Town,2010,40 - 44 years,1,1,2
Skibbereen Town,2010,45 - 49 years,2,2,4
Skibbereen Town,2010,5 - 9 years,0,0,0
Skibbereen Town,2010,50 - 54 years,0,5,5
Skibbereen Town,2010,55 - 59 years,0,1,1
Skibbereen Town,2010,60 - 64 years,2,3,5
Skibbereen Town,2010,65 - 69 years,1,1,2
Skibbereen Town,2010,70 - 74 years,2,6,8
Skibbereen Town,2010,75 - 79 years,2,1,3
Skibbereen Town,2010,80 - 84 years,2,2,4
Skibbereen Town,2010,85 years and over,6,6,12
Skibbereen Town,2010,Under 1 year,0,1,1
Skibbereen Town,2011,1 - 4 years,0,0,0
Skibbereen Town,2011,10 - 14 years,0,0,0
Skibbereen Town,2011,15 - 19 years,0,0,0
Skibbereen Town,2011,20 - 24 years,0,0,0
Skibbereen Town,2011,25 - 29 years,0,0,0
Skibbereen Town,2011,30 - 34 years,0,0,0
Skibbereen Town,2011,35 - 39 years,0,0,0
Skibbereen Town,2011,40 - 44 years,0,1,1
Skibbereen Town,2011,45 - 49 years,0,0,0
Skibbereen Town,2011,5 - 9 years,0,0,0
Skibbereen Town,2011,50 - 54 years,0,0,0
Skibbereen Town,2011,55 - 59 years,0,2,2
Skibbereen Town,2011,60 - 64 years,0,0,0
Skibbereen Town,2011,65 - 69 years,0,2,2
Skibbereen Town,2011,70 - 74 years,0,1,1
Skibbereen Town,2011,75 - 79 years,1,2,3
Skibbereen Town,2011,80 - 84 years,4,2,6
Skibbereen Town,2011,85 years and over,5,2,7
Skibbereen Town,2011,Under 1 year,0,0,0
Skibbereen Town,2012,1 - 4 years,0,0,0
Skibbereen Town,2012,10 - 14 years,0,0,0
Skibbereen Town,2012,15 - 19 years,0,0,0
Skibbereen Town,2012,20 - 24 years,0,1,1
Skibbereen Town,2012,25 - 29 years,0,1,1
Skibbereen Town,2012,30 - 34 years,0,1,1
Skibbereen Town,2012,35 - 39 years,0,1,1
Skibbereen Town,2012,40 - 44 years,0,1,1
Skibbereen Town,2012,45 - 49 years,1,0,1
Skibbereen Town,2012,5 - 9 years,0,0,0
Skibbereen Town,2012,50 - 54 years,0,2,2
Skibbereen Town,2012,55 - 59 years,0,2,2
Skibbereen Town,2012,60 - 64 years,0,3,3
Skibbereen Town,2012,65 - 69 years,0,1,1
Skibbereen Town,2012,70 - 74 years,2,3,5
Skibbereen Town,2012,75 - 79 years,1,1,2
Skibbereen Town,2012,80 - 84 years,5,5,10
Skibbereen Town,2012,85 years and over,11,2,13
Skibbereen Town,2012,Under 1 year,0,0,0
Skibbereen Town,2013,1 - 4 years,0,0,0
Skibbereen Town,2013,10 - 14 years,0,1,1
Skibbereen Town,2013,15 - 19 years,0,0,0
Skibbereen Town,2013,20 - 24 years,1,0,1
Skibbereen Town,2013,25 - 29 years,0,0,0
Skibbereen Town,2013,30 - 34 years,0,0,0
Skibbereen Town,2013,35 - 39 years,0,0,0
Skibbereen Town,2013,40 - 44 years,0,0,0
Skibbereen Town,2013,45 - 49 years,0,1,1
Skibbereen Town,2013,5 - 9 years,0,0,0
Skibbereen Town,2013,50 - 54 years,0,1,1
Skibbereen Town,2013,55 - 59 years,0,0,0
Skibbereen Town,2013,60 - 64 years,0,3,3
Skibbereen Town,2013,65 - 69 years,2,1,3
Skibbereen Town,2013,70 - 74 years,2,0,2
Skibbereen Town,2013,75 - 79 years,7,2,9
Skibbereen Town,2013,80 - 84 years,3,3,6
Skibbereen Town,2013,85 years and over,10,1,11
Skibbereen Town,2013,Under 1 year,0,0,0
Skibbereen Town,2014,1 - 4 years,0,0,0
Skibbereen Town,2014,10 - 14 years,0,1,1
Skibbereen Town,2014,15 - 19 years,0,0,0
Skibbereen Town,2014,20 - 24 years,1,0,1
Skibbereen Town,2014,25 - 29 years,0,0,0
Skibbereen Town,2014,30 - 34 years,0,0,0
Skibbereen Town,2014,35 - 39 years,0,0,0
Skibbereen Town,2014,40 - 44 years,1,0,1
Skibbereen Town,2014,45 - 49 years,0,2,2
Skibbereen Town,2014,5 - 9 years,0,0,0
Skibbereen Town,2014,50 - 54 years,0,1,1
Skibbereen Town,2014,55 - 59 years,0,0,0
Skibbereen Town,2014,60 - 64 years,0,3,3
Skibbereen Town,2014,65 - 69 years,2,1,3
Skibbereen Town,2014,70 - 74 years,2,1,3
Skibbereen Town,2014,75 - 79 years,2,4,6
Skibbereen Town,2014,80 - 84 years,1,1,2
Skibbereen Town,2014,85 years and over,12,2,14
Skibbereen Town,2014,Under 1 year,0,0,0
Skibbereen Town,2015,1 - 4 years,0,0,0
Skibbereen Town,2015,10 - 14 years,0,1,1
Skibbereen Town,2015,15 - 19 years,0,0,0
Skibbereen Town,2015,20 - 24 years,1,0,1
Skibbereen Town,2015,25 - 29 years,0,0,0
Skibbereen Town,2015,30 - 34 years,0,0,0
Skibbereen Town,2015,35 - 39 years,0,0,0
Skibbereen Town,2015,40 - 44 years,1,0,1
Skibbereen Town,2015,45 - 49 years,0,2,2
Skibbereen Town,2015,5 - 9 years,0,0,0
Skibbereen Town,2015,50 - 54 years,0,1,1
Skibbereen Town,2015,55 - 59 years,0,0,0
Skibbereen Town,2015,60 - 64 years,0,3,3
Skibbereen Town,2015,65 - 69 years,2,1,3
Skibbereen Town,2015,70 - 74 years,2,1,3
Skibbereen Town,2015,75 - 79 years,2,4,6
Skibbereen Town,2015,80 - 84 years,1,1,2
Skibbereen Town,2015,85 years and over,12,2,14
Skibbereen Town,2015,Under 1 year,0,0,0
Skibbereen Town,2016,1 - 4 years,0,0,0
Skibbereen Town,2016,10 - 14 years,0,1,1
Skibbereen Town,2016,15 - 19 years,0,0,0
Skibbereen Town,2016,20 - 24 years,1,0,1
Skibbereen Town,2016,25 - 29 years,0,0,0
Skibbereen Town,2016,30 - 34 years,0,0,0
Skibbereen Town,2016,35 - 39 years,0,0,0
Skibbereen Town,2016,40 - 44 years,1,0,1
Skibbereen Town,2016,45 - 49 years,0,2,2
Skibbereen Town,2016,5 - 9 years,0,0,0
Skibbereen Town,2016,50 - 54 years,0,1,1
Skibbereen Town,2016,55 - 59 years,0,0,0
Skibbereen Town,2016,60 - 64 years,0,3,3
Skibbereen Town,2016,65 - 69 years,2,1,3
Skibbereen Town,2016,70 - 74 years,2,1,3
Skibbereen Town,2016,75 - 79 years,2,4,6
Skibbereen Town,2016,80 - 84 years,1,1,2
Skibbereen Town,2016,85 years and over,12,2,14
Skibbereen Town,2016,Under 1 year,0,0,0
Skibbereen Town,2017,1 - 4 years,0,0,0
Skibbereen Town,2017,10 - 14 years,0,1,1
Skibbereen Town,2017,15 - 19 years,0,1,1
Skibbereen Town,2017,20 - 24 years,1,0,1
Skibbereen Town,2017,25 - 29 years,0,0,0
Skibbereen Town,2017,30 - 34 years,0,0,0
Skibbereen Town,2017,35 - 39 years,0,0,0
Skibbereen Town,2017,40 - 44 years,1,0,1
Skibbereen Town,2017,45 - 49 years,0,2,2
Skibbereen Town,2017,5 - 9 years,0,0,0
Skibbereen Town,2017,50 - 54 years,0,2,2
Skibbereen Town,2017,55 - 59 years,0,0,0
Skibbereen Town,2017,60 - 64 years,0,3,3
Skibbereen Town,2017,65 - 69 years,2,3,5
Skibbereen Town,2017,70 - 74 years,1,1,2
Skibbereen Town,2017,75 - 79 years,2,3,5
Skibbereen Town,2017,80 - 84 years,4,2,6
Skibbereen Town,2017,85 years and over,9,6,15
Skibbereen Town,2017,Under 1 year,0,0,0
Skibbereen Town,2018,1 - 4 years,0,0,0
Skibbereen Town,2018,10 - 14 years,0,0,0
Skibbereen Town,2018,15 - 19 years,0,0,0
Skibbereen Town,2018,20 - 24 years,0,0,0
Skibbereen Town,2018,25 - 29 years,0,0,0
Skibbereen Town,2018,30 - 34 years,0,0,0
Skibbereen Town,2018,35 - 39 years,0,0,0
Skibbereen Town,2018,40 - 44 years,0,0,0
Skibbereen Town,2018,45 - 49 years,0,2,2
Skibbereen Town,2018,5 - 9 years,0,0,0
Skibbereen Town,2018,50 - 54 years,0,2,2
Skibbereen Town,2018,55 - 59 years,0,0,0
Skibbereen Town,2018,60 - 64 years,1,1,2
Skibbereen Town,2018,65 - 69 years,1,0,1
Skibbereen Town,2018,70 - 74 years,3,0,3
Skibbereen Town,2018,75 - 79 years,0,2,2
Skibbereen Town,2018,80 - 84 years,0,4,4
Skibbereen Town,2018,85 years and over,11,3,14
Skibbereen Town,2018,Under 1 year,0,0,0
Skibbereen Town,2019,1 - 4 years,0,0,0
Skibbereen Town,2019,10 - 14 years,0,0,0
Skibbereen Town,2019,15 - 19 years,0,0,0
Skibbereen Town,2019,20 - 24 years,0,0,0
Skibbereen Town,2019,25 - 29 years,0,0,0
Skibbereen Town,2019,30 - 34 years,0,0,0
Skibbereen Town,2019,35 - 39 years,0,0,0
Skibbereen Town,2019,40 - 44 years,0,0,0
Skibbereen Town,2019,45 - 49 years,0,2,2
Skibbereen Town,2019,5 - 9 years,0,0,0
Skibbereen Town,2019,50 - 54 years,0,2,2
Skibbereen Town,2019,55 - 59 years,0,0,0
Skibbereen Town,2019,60 - 64 years,1,1,2
Skibbereen Town,2019,65 - 69 years,1,0,1
Skibbereen Town,2019,70 - 74 years,3,0,3
Skibbereen Town,2019,75 - 79 years,0,2,2
Skibbereen Town,2019,80 - 84 years,0,4,4
Skibbereen Town,2019,85 years and over,11,3,14
Skibbereen Town,2019,Under 1 year,0,0,0
Skibbereen Town,2020,1 - 4 years,0,0,0
Skibbereen Town,2020,10 - 14 years,0,0,0
Skibbereen Town,2020,15 - 19 years,0,0,0
Skibbereen Town,2020,20 - 24 years,0,0,0
Skibbereen Town,2020,25 - 29 years,0,0,0
Skibbereen Town,2020,30 - 34 years,0,0,0
Skibbereen Town,2020,35 - 39 years,0,0,0
Skibbereen Town,2020,40 - 44 years,0,0,0
Skibbereen Town,2020,45 - 49 years,0,2,2
Skibbereen Town,2020,5 - 9 years,0,0,0
Skibbereen Town,2020,50 - 54 years,0,2,2
Skibbereen Town,2020,55 - 59 years,0,0,0
Skibbereen Town,2020,60 - 64 years,1,1,2
Skibbereen Town,2020,65 - 69 years,1,0,1
Skibbereen Town,2020,70 - 74 years,3,0,3
Skibbereen Town,2020,75 - 79 years,0,2,2
Skibbereen Town,2020,80 - 84 years,0,4,4
Skibbereen Town,2020,85 years and over,11,3,14
Skibbereen Town,2020,Under 1 year,0,0,0
Sligo,2007,1 - 4 years,0,0,0
Sligo,2007,10 - 14 years,0,0,0
Sligo,2007,15 - 19 years,0,1,1
Sligo,2007,20 - 24 years,1,2,3
Sligo,2007,25 - 29 years,0,1,1
Sligo,2007,30 - 34 years,2,2,4
Sligo,2007,35 - 39 years,0,1,1
Sligo,2007,40 - 44 years,1,5,6
Sligo,2007,45 - 49 years,3,6,9
Sligo,2007,5 - 9 years,0,0,0
Sligo,2007,50 - 54 years,6,3,9
Sligo,2007,55 - 59 years,5,8,13
Sligo,2007,60 - 64 years,12,12,24
Sligo,2007,65 - 69 years,7,16,23
Sligo,2007,70 - 74 years,26,31,57
Sligo,2007,75 - 79 years,25,38,63
Sligo,2007,80 - 84 years,43,46,89
Sligo,2007,85 years and over,90,68,158
Sligo,2007,Under 1 year,2,1,3
Sligo,2008,1 - 4 years,0,1,1
Sligo,2008,10 - 14 years,2,0,2
Sligo,2008,15 - 19 years,1,1,2
Sligo,2008,20 - 24 years,1,2,3
Sligo,2008,25 - 29 years,0,3,3
Sligo,2008,30 - 34 years,2,2,4
Sligo,2008,35 - 39 years,1,3,4
Sligo,2008,40 - 44 years,1,2,3
Sligo,2008,45 - 49 years,3,4,7
Sligo,2008,5 - 9 years,0,0,0
Sligo,2008,50 - 54 years,3,4,7
Sligo,2008,55 - 59 years,6,8,14
Sligo,2008,60 - 64 years,6,17,23
Sligo,2008,65 - 69 years,13,17,30
Sligo,2008,70 - 74 years,13,31,44
Sligo,2008,75 - 79 years,21,34,55
Sligo,2008,80 - 84 years,55,49,104
Sligo,2008,85 years and over,102,61,163
Sligo,2008,Under 1 year,1,5,6
Sligo,2009,1 - 4 years,1,1,2
Sligo,2009,10 - 14 years,2,0,2
Sligo,2009,15 - 19 years,1,1,2
Sligo,2009,20 - 24 years,1,1,2
Sligo,2009,25 - 29 years,2,1,3
Sligo,2009,30 - 34 years,1,1,2
Sligo,2009,35 - 39 years,1,4,5
Sligo,2009,40 - 44 years,2,2,4
Sligo,2009,45 - 49 years,4,4,8
Sligo,2009,5 - 9 years,1,0,1
Sligo,2009,50 - 54 years,9,7,16
Sligo,2009,55 - 59 years,8,17,25
Sligo,2009,60 - 64 years,11,19,30
Sligo,2009,65 - 69 years,11,20,31
Sligo,2009,70 - 74 years,23,27,50
Sligo,2009,75 - 79 years,17,34,51
Sligo,2009,80 - 84 years,44,47,91
Sligo,2009,85 years and over,99,42,141
Sligo,2009,Under 1 year,1,1,2
Sligo,2010,1 - 4 years,1,1,2
Sligo,2010,10 - 14 years,2,0,2
Sligo,2010,15 - 19 years,1,2,3
Sligo,2010,20 - 24 years,1,1,2
Sligo,2010,25 - 29 years,2,1,3
Sligo,2010,30 - 34 years,1,3,4
Sligo,2010,35 - 39 years,1,4,5
Sligo,2010,40 - 44 years,5,1,6
Sligo,2010,45 - 49 years,1,9,10
Sligo,2010,5 - 9 years,1,0,1
Sligo,2010,50 - 54 years,7,6,13
Sligo,2010,55 - 59 years,5,12,17
Sligo,2010,60 - 64 years,8,7,15
Sligo,2010,65 - 69 years,10,20,30
Sligo,2010,70 - 74 years,16,22,38
Sligo,2010,75 - 79 years,12,35,47
Sligo,2010,80 - 84 years,35,30,65
Sligo,2010,85 years and over,85,62,147
Sligo,2010,Under 1 year,1,2,3
Sligo,2011,1 - 4 years,0,0,0
Sligo,2011,10 - 14 years,0,1,1
Sligo,2011,15 - 19 years,1,0,1
Sligo,2011,20 - 24 years,1,1,2
Sligo,2011,25 - 29 years,2,0,2
Sligo,2011,30 - 34 years,1,1,2
Sligo,2011,35 - 39 years,0,1,1
Sligo,2011,40 - 44 years,3,3,6
Sligo,2011,45 - 49 years,2,7,9
Sligo,2011,5 - 9 years,0,0,0
Sligo,2011,50 - 54 years,6,7,13
Sligo,2011,55 - 59 years,11,18,29
Sligo,2011,60 - 64 years,7,24,31
Sligo,2011,65 - 69 years,7,17,24
Sligo,2011,70 - 74 years,15,28,43
Sligo,2011,75 - 79 years,27,39,66
Sligo,2011,80 - 84 years,47,46,93
Sligo,2011,85 years and over,98,60,158
Sligo,2011,Under 1 year,3,2,5
Sligo,2012,1 - 4 years,0,0,0
Sligo,2012,10 - 14 years,0,1,1
Sligo,2012,15 - 19 years,1,1,2
Sligo,2012,20 - 24 years,1,2,3
Sligo,2012,25 - 29 years,2,2,4
Sligo,2012,30 - 34 years,1,5,6
Sligo,2012,35 - 39 years,2,2,4
Sligo,2012,40 - 44 years,1,3,4
Sligo,2012,45 - 49 years,6,3,9
Sligo,2012,5 - 9 years,0,0,0
Sligo,2012,50 - 54 years,3,3,6
Sligo,2012,55 - 59 years,10,14,24
Sligo,2012,60 - 64 years,5,11,16
Sligo,2012,65 - 69 years,18,22,40
Sligo,2012,70 - 74 years,13,24,37
Sligo,2012,75 - 79 years,27,32,59
Sligo,2012,80 - 84 years,31,38,69
Sligo,2012,85 years and over,112,57,169
Sligo,2012,Under 1 year,2,4,6
Sligo,2013,1 - 4 years,1,1,2
Sligo,2013,10 - 14 years,0,1,1
Sligo,2013,15 - 19 years,0,0,0
Sligo,2013,20 - 24 years,1,3,4
Sligo,2013,25 - 29 years,0,0,0
Sligo,2013,30 - 34 years,0,3,3
Sligo,2013,35 - 39 years,0,1,1
Sligo,2013,40 - 44 years,1,1,2
Sligo,2013,45 - 49 years,3,5,8
Sligo,2013,5 - 9 years,0,0,0
Sligo,2013,50 - 54 years,3,7,10
Sligo,2013,55 - 59 years,7,12,19
Sligo,2013,60 - 64 years,13,12,25
Sligo,2013,65 - 69 years,12,27,39
Sligo,2013,70 - 74 years,12,32,44
Sligo,2013,75 - 79 years,35,37,72
Sligo,2013,80 - 84 years,35,37,72
Sligo,2013,85 years and over,108,64,172
Sligo,2013,Under 1 year,2,1,3
Sligo,2014,1 - 4 years,1,1,2
Sligo,2014,10 - 14 years,1,1,2
Sligo,2014,15 - 19 years,0,0,0
Sligo,2014,20 - 24 years,1,3,4
Sligo,2014,25 - 29 years,0,2,2
Sligo,2014,30 - 34 years,2,2,4
Sligo,2014,35 - 39 years,2,1,3
Sligo,2014,40 - 44 years,1,4,5
Sligo,2014,45 - 49 years,2,8,10
Sligo,2014,5 - 9 years,0,0,0
Sligo,2014,50 - 54 years,4,6,10
Sligo,2014,55 - 59 years,9,18,27
Sligo,2014,60 - 64 years,10,13,23
Sligo,2014,65 - 69 years,7,27,34
Sligo,2014,70 - 74 years,14,25,39
Sligo,2014,75 - 79 years,22,37,59
Sligo,2014,80 - 84 years,34,35,69
Sligo,2014,85 years and over,103,74,177
Sligo,2014,Under 1 year,2,1,3
Sligo,2015,1 - 4 years,1,1,2
Sligo,2015,10 - 14 years,1,1,2
Sligo,2015,15 - 19 years,0,0,0
Sligo,2015,20 - 24 years,1,2,3
Sligo,2015,25 - 29 years,0,2,2
Sligo,2015,30 - 34 years,2,2,4
Sligo,2015,35 - 39 years,2,2,4
Sligo,2015,40 - 44 years,2,4,6
Sligo,2015,45 - 49 years,3,7,10
Sligo,2015,5 - 9 years,0,0,0
Sligo,2015,50 - 54 years,8,4,12
Sligo,2015,55 - 59 years,9,10,19
Sligo,2015,60 - 64 years,10,14,24
Sligo,2015,65 - 69 years,14,18,32
Sligo,2015,70 - 74 years,19,33,52
Sligo,2015,75 - 79 years,22,38,60
Sligo,2015,80 - 84 years,38,41,79
Sligo,2015,85 years and over,126,74,200
Sligo,2015,Under 1 year,2,2,4
Sligo,2016,1 - 4 years,1,1,2
Sligo,2016,10 - 14 years,1,1,2
Sligo,2016,15 - 19 years,0,1,1
Sligo,2016,20 - 24 years,1,1,2
Sligo,2016,25 - 29 years,0,2,2
Sligo,2016,30 - 34 years,2,2,4
Sligo,2016,35 - 39 years,2,1,3
Sligo,2016,40 - 44 years,1,4,5
Sligo,2016,45 - 49 years,3,4,7
Sligo,2016,5 - 9 years,0,0,0
Sligo,2016,50 - 54 years,9,6,15
Sligo,2016,55 - 59 years,4,16,20
Sligo,2016,60 - 64 years,13,15,28
Sligo,2016,65 - 69 years,16,34,50
Sligo,2016,70 - 74 years,10,33,43
Sligo,2016,75 - 79 years,31,32,63
Sligo,2016,80 - 84 years,37,49,86
Sligo,2016,85 years and over,122,62,184
Sligo,2016,Under 1 year,1,1,2
Sligo,2017,1 - 4 years,1,1,2
Sligo,2017,10 - 14 years,1,1,2
Sligo,2017,15 - 19 years,1,1,2
Sligo,2017,20 - 24 years,1,1,2
Sligo,2017,25 - 29 years,0,1,1
Sligo,2017,30 - 34 years,1,2,3
Sligo,2017,35 - 39 years,3,1,4
Sligo,2017,40 - 44 years,2,5,7
Sligo,2017,45 - 49 years,3,4,7
Sligo,2017,5 - 9 years,0,0,0
Sligo,2017,50 - 54 years,7,8,15
Sligo,2017,55 - 59 years,9,13,22
Sligo,2017,60 - 64 years,10,20,30
Sligo,2017,65 - 69 years,17,19,36
Sligo,2017,70 - 74 years,11,36,47
Sligo,2017,75 - 79 years,27,37,64
Sligo,2017,80 - 84 years,37,40,77
Sligo,2017,85 years and over,109,81,190
Sligo,2017,Under 1 year,1,3,4
Sligo,2018,1 - 4 years,0,0,0
Sligo,2018,10 - 14 years,0,0,0
Sligo,2018,15 - 19 years,0,1,1
Sligo,2018,20 - 24 years,1,0,1
Sligo,2018,25 - 29 years,3,0,3
Sligo,2018,30 - 34 years,1,0,1
Sligo,2018,35 - 39 years,2,2,4
Sligo,2018,40 - 44 years,0,3,3
Sligo,2018,45 - 49 years,4,5,9
Sligo,2018,5 - 9 years,0,0,0
Sligo,2018,50 - 54 years,4,11,15
Sligo,2018,55 - 59 years,3,7,10
Sligo,2018,60 - 64 years,8,18,26
Sligo,2018,65 - 69 years,18,29,47
Sligo,2018,70 - 74 years,21,28,49
Sligo,2018,75 - 79 years,30,48,78
Sligo,2018,80 - 84 years,33,40,73
Sligo,2018,85 years and over,117,78,195
Sligo,2018,Under 1 year,0,1,1
Sligo,2019,1 - 4 years,0,0,0
Sligo,2019,10 - 14 years,0,0,0
Sligo,2019,15 - 19 years,0,0,0
Sligo,2019,20 - 24 years,0,0,0
Sligo,2019,25 - 29 years,1,0,1
Sligo,2019,30 - 34 years,0,0,0
Sligo,2019,35 - 39 years,3,2,5
Sligo,2019,40 - 44 years,4,3,7
Sligo,2019,45 - 49 years,2,4,6
Sligo,2019,5 - 9 years,0,0,0
Sligo,2019,50 - 54 years,4,9,13
Sligo,2019,55 - 59 years,4,8,12
Sligo,2019,60 - 64 years,15,13,28
Sligo,2019,65 - 69 years,16,29,45
Sligo,2019,70 - 74 years,22,35,57
Sligo,2019,75 - 79 years,27,39,66
Sligo,2019,80 - 84 years,31,28,59
Sligo,2019,85 years and over,127,76,203
Sligo,2019,Under 1 year,0,0,0
Sligo,2020,1 - 4 years,0,1,1
Sligo,2020,10 - 14 years,0,0,0
Sligo,2020,15 - 19 years,0,2,2
Sligo,2020,20 - 24 years,0,1,1
Sligo,2020,25 - 29 years,1,1,2
Sligo,2020,30 - 34 years,0,1,1
Sligo,2020,35 - 39 years,2,2,4
Sligo,2020,40 - 44 years,1,5,6
Sligo,2020,45 - 49 years,2,4,6
Sligo,2020,5 - 9 years,0,0,0
Sligo,2020,50 - 54 years,5,8,13
Sligo,2020,55 - 59 years,6,14,20
Sligo,2020,60 - 64 years,14,23,37
Sligo,2020,65 - 69 years,14,18,32
Sligo,2020,70 - 74 years,17,37,54
Sligo,2020,75 - 79 years,43,37,80
Sligo,2020,80 - 84 years,38,36,74
Sligo,2020,85 years and over,134,73,207
Sligo,2020,Under 1 year,2,0,2
Sligo Borough,2007,1 - 4 years,0,0,0
Sligo Borough,2007,10 - 14 years,0,0,0
Sligo Borough,2007,15 - 19 years,0,0,0
Sligo Borough,2007,20 - 24 years,0,0,0
Sligo Borough,2007,25 - 29 years,0,1,1
Sligo Borough,2007,30 - 34 years,1,0,1
Sligo Borough,2007,35 - 39 years,0,0,0
Sligo Borough,2007,40 - 44 years,0,0,0
Sligo Borough,2007,45 - 49 years,1,1,2
Sligo Borough,2007,5 - 9 years,0,0,0
Sligo Borough,2007,50 - 54 years,1,1,2
Sligo Borough,2007,55 - 59 years,0,1,1
Sligo Borough,2007,60 - 64 years,4,3,7
Sligo Borough,2007,65 - 69 years,2,1,3
Sligo Borough,2007,70 - 74 years,6,7,13
Sligo Borough,2007,75 - 79 years,4,8,12
Sligo Borough,2007,80 - 84 years,8,8,16
Sligo Borough,2007,85 years and over,14,9,23
Sligo Borough,2007,Under 1 year,0,0,0
Sligo Borough,2008,1 - 4 years,0,0,0
Sligo Borough,2008,10 - 14 years,0,0,0
Sligo Borough,2008,15 - 19 years,0,0,0
Sligo Borough,2008,20 - 24 years,0,0,0
Sligo Borough,2008,25 - 29 years,0,2,2
Sligo Borough,2008,30 - 34 years,1,1,2
Sligo Borough,2008,35 - 39 years,0,1,1
Sligo Borough,2008,40 - 44 years,0,1,1
Sligo Borough,2008,45 - 49 years,1,2,3
Sligo Borough,2008,5 - 9 years,0,0,0
Sligo Borough,2008,50 - 54 years,1,1,2
Sligo Borough,2008,55 - 59 years,0,2,2
Sligo Borough,2008,60 - 64 years,1,5,6
Sligo Borough,2008,65 - 69 years,3,4,7
Sligo Borough,2008,70 - 74 years,3,10,13
Sligo Borough,2008,75 - 79 years,3,8,11
Sligo Borough,2008,80 - 84 years,14,10,24
Sligo Borough,2008,85 years and over,23,13,36
Sligo Borough,2008,Under 1 year,0,1,1
Sligo Borough,2009,1 - 4 years,1,0,1
Sligo Borough,2009,10 - 14 years,0,0,0
Sligo Borough,2009,15 - 19 years,0,1,1
Sligo Borough,2009,20 - 24 years,0,0,0
Sligo Borough,2009,25 - 29 years,1,1,2
Sligo Borough,2009,30 - 34 years,1,1,2
Sligo Borough,2009,35 - 39 years,0,1,1
Sligo Borough,2009,40 - 44 years,1,1,2
Sligo Borough,2009,45 - 49 years,1,1,2
Sligo Borough,2009,5 - 9 years,0,0,0
Sligo Borough,2009,50 - 54 years,2,1,3
Sligo Borough,2009,55 - 59 years,3,9,12
Sligo Borough,2009,60 - 64 years,4,4,8
Sligo Borough,2009,65 - 69 years,4,4,8
Sligo Borough,2009,70 - 74 years,8,10,18
Sligo Borough,2009,75 - 79 years,7,8,15
Sligo Borough,2009,80 - 84 years,17,11,28
Sligo Borough,2009,85 years and over,16,15,31
Sligo Borough,2009,Under 1 year,0,1,1
Sligo Borough,2010,1 - 4 years,1,0,1
Sligo Borough,2010,10 - 14 years,0,0,0
Sligo Borough,2010,15 - 19 years,0,1,1
Sligo Borough,2010,20 - 24 years,0,0,0
Sligo Borough,2010,25 - 29 years,1,1,2
Sligo Borough,2010,30 - 34 years,1,1,2
Sligo Borough,2010,35 - 39 years,1,3,4
Sligo Borough,2010,40 - 44 years,2,1,3
Sligo Borough,2010,45 - 49 years,1,5,6
Sligo Borough,2010,5 - 9 years,0,0,0
Sligo Borough,2010,50 - 54 years,1,2,3
Sligo Borough,2010,55 - 59 years,1,1,2
Sligo Borough,2010,60 - 64 years,3,1,4
Sligo Borough,2010,65 - 69 years,3,3,6
Sligo Borough,2010,70 - 74 years,6,9,15
Sligo Borough,2010,75 - 79 years,4,9,13
Sligo Borough,2010,80 - 84 years,8,5,13
Sligo Borough,2010,85 years and over,14,10,24
Sligo Borough,2010,Under 1 year,0,1,1
Sligo Borough,2011,1 - 4 years,0,0,0
Sligo Borough,2011,10 - 14 years,0,0,0
Sligo Borough,2011,15 - 19 years,0,0,0
Sligo Borough,2011,20 - 24 years,0,0,0
Sligo Borough,2011,25 - 29 years,2,0,2
Sligo Borough,2011,30 - 34 years,0,0,0
Sligo Borough,2011,35 - 39 years,0,1,1
Sligo Borough,2011,40 - 44 years,0,1,1
Sligo Borough,2011,45 - 49 years,1,0,1
Sligo Borough,2011,5 - 9 years,0,0,0
Sligo Borough,2011,50 - 54 years,0,3,3
Sligo Borough,2011,55 - 59 years,5,8,13
Sligo Borough,2011,60 - 64 years,1,7,8
Sligo Borough,2011,65 - 69 years,2,2,4
Sligo Borough,2011,70 - 74 years,7,7,14
Sligo Borough,2011,75 - 79 years,8,9,17
Sligo Borough,2011,80 - 84 years,15,6,21
Sligo Borough,2011,85 years and over,36,16,52
Sligo Borough,2011,Under 1 year,0,1,1
Sligo Borough,2012,1 - 4 years,0,0,0
Sligo Borough,2012,10 - 14 years,0,0,0
Sligo Borough,2012,15 - 19 years,0,1,1
Sligo Borough,2012,20 - 24 years,1,0,1
Sligo Borough,2012,25 - 29 years,2,1,3
Sligo Borough,2012,30 - 34 years,0,1,1
Sligo Borough,2012,35 - 39 years,0,2,2
Sligo Borough,2012,40 - 44 years,0,1,1
Sligo Borough,2012,45 - 49 years,3,1,4
Sligo Borough,2012,5 - 9 years,0,0,0
Sligo Borough,2012,50 - 54 years,1,1,2
Sligo Borough,2012,55 - 59 years,2,5,7
Sligo Borough,2012,60 - 64 years,1,4,5
Sligo Borough,2012,65 - 69 years,4,2,6
Sligo Borough,2012,70 - 74 years,3,4,7
Sligo Borough,2012,75 - 79 years,5,10,15
Sligo Borough,2012,80 - 84 years,7,8,15
Sligo Borough,2012,85 years and over,30,10,40
Sligo Borough,2012,Under 1 year,1,2,3
Sligo Borough,2013,1 - 4 years,0,0,0
Sligo Borough,2013,10 - 14 years,0,0,0
Sligo Borough,2013,15 - 19 years,0,0,0
Sligo Borough,2013,20 - 24 years,1,1,2
Sligo Borough,2013,25 - 29 years,0,0,0
Sligo Borough,2013,30 - 34 years,0,1,1
Sligo Borough,2013,35 - 39 years,0,1,1
Sligo Borough,2013,40 - 44 years,0,0,0
Sligo Borough,2013,45 - 49 years,1,1,2
Sligo Borough,2013,5 - 9 years,0,0,0
Sligo Borough,2013,50 - 54 years,0,1,1
Sligo Borough,2013,55 - 59 years,1,4,5
Sligo Borough,2013,60 - 64 years,4,2,6
Sligo Borough,2013,65 - 69 years,2,5,7
Sligo Borough,2013,70 - 74 years,4,6,10
Sligo Borough,2013,75 - 79 years,12,8,20
Sligo Borough,2013,80 - 84 years,10,11,21
Sligo Borough,2013,85 years and over,30,12,42
Sligo Borough,2013,Under 1 year,0,0,0
Sligo Borough,2014,1 - 4 years,0,0,0
Sligo Borough,2014,10 - 14 years,0,0,0
Sligo Borough,2014,15 - 19 years,0,0,0
Sligo Borough,2014,20 - 24 years,1,1,2
Sligo Borough,2014,25 - 29 years,0,0,0
Sligo Borough,2014,30 - 34 years,1,1,2
Sligo Borough,2014,35 - 39 years,0,1,1
Sligo Borough,2014,40 - 44 years,0,1,1
Sligo Borough,2014,45 - 49 years,1,2,3
Sligo Borough,2014,5 - 9 years,0,0,0
Sligo Borough,2014,50 - 54 years,1,1,2
Sligo Borough,2014,55 - 59 years,3,6,9
Sligo Borough,2014,60 - 64 years,3,5,8
Sligo Borough,2014,65 - 69 years,3,2,5
Sligo Borough,2014,70 - 74 years,4,8,12
Sligo Borough,2014,75 - 79 years,11,12,23
Sligo Borough,2014,80 - 84 years,13,10,23
Sligo Borough,2014,85 years and over,25,25,50
Sligo Borough,2014,Under 1 year,0,0,0
Sligo Borough,2015,1 - 4 years,0,0,0
Sligo Borough,2015,10 - 14 years,0,0,0
Sligo Borough,2015,15 - 19 years,0,0,0
Sligo Borough,2015,20 - 24 years,1,1,2
Sligo Borough,2015,25 - 29 years,0,0,0
Sligo Borough,2015,30 - 34 years,1,1,2
Sligo Borough,2015,35 - 39 years,0,1,1
Sligo Borough,2015,40 - 44 years,0,1,1
Sligo Borough,2015,45 - 49 years,1,2,3
Sligo Borough,2015,5 - 9 years,0,0,0
Sligo Borough,2015,50 - 54 years,1,1,2
Sligo Borough,2015,55 - 59 years,3,6,9
Sligo Borough,2015,60 - 64 years,3,5,8
Sligo Borough,2015,65 - 69 years,3,2,5
Sligo Borough,2015,70 - 74 years,4,8,12
Sligo Borough,2015,75 - 79 years,11,12,23
Sligo Borough,2015,80 - 84 years,13,10,23
Sligo Borough,2015,85 years and over,25,25,50
Sligo Borough,2015,Under 1 year,0,0,0
Sligo Borough,2016,1 - 4 years,0,0,0
Sligo Borough,2016,10 - 14 years,0,0,0
Sligo Borough,2016,15 - 19 years,0,0,0
Sligo Borough,2016,20 - 24 years,1,1,2
Sligo Borough,2016,25 - 29 years,0,0,0
Sligo Borough,2016,30 - 34 years,1,1,2
Sligo Borough,2016,35 - 39 years,0,1,1
Sligo Borough,2016,40 - 44 years,0,1,1
Sligo Borough,2016,45 - 49 years,1,2,3
Sligo Borough,2016,5 - 9 years,0,0,0
Sligo Borough,2016,50 - 54 years,1,1,2
Sligo Borough,2016,55 - 59 years,3,6,9
Sligo Borough,2016,60 - 64 years,3,5,8
Sligo Borough,2016,65 - 69 years,3,2,5
Sligo Borough,2016,70 - 74 years,4,8,12
Sligo Borough,2016,75 - 79 years,11,12,23
Sligo Borough,2016,80 - 84 years,13,10,23
Sligo Borough,2016,85 years and over,25,25,50
Sligo Borough,2016,Under 1 year,0,0,0
Sligo Borough,2017,1 - 4 years,0,1,1
Sligo Borough,2017,10 - 14 years,0,0,0
Sligo Borough,2017,15 - 19 years,0,0,0
Sligo Borough,2017,20 - 24 years,1,1,2
Sligo Borough,2017,25 - 29 years,0,0,0
Sligo Borough,2017,30 - 34 years,1,1,2
Sligo Borough,2017,35 - 39 years,1,1,2
Sligo Borough,2017,40 - 44 years,2,1,3
Sligo Borough,2017,45 - 49 years,3,1,4
Sligo Borough,2017,5 - 9 years,0,0,0
Sligo Borough,2017,50 - 54 years,3,2,5
Sligo Borough,2017,55 - 59 years,2,7,9
Sligo Borough,2017,60 - 64 years,4,7,11
Sligo Borough,2017,65 - 69 years,6,7,13
Sligo Borough,2017,70 - 74 years,6,15,21
Sligo Borough,2017,75 - 79 years,11,12,23
Sligo Borough,2017,80 - 84 years,18,10,28
Sligo Borough,2017,85 years and over,35,19,54
Sligo Borough,2017,Under 1 year,1,1,2
Sligo Borough,2018,1 - 4 years,0,0,0
Sligo Borough,2018,10 - 14 years,0,0,0
Sligo Borough,2018,15 - 19 years,0,1,1
Sligo Borough,2018,20 - 24 years,0,0,0
Sligo Borough,2018,25 - 29 years,2,0,2
Sligo Borough,2018,30 - 34 years,1,0,1
Sligo Borough,2018,35 - 39 years,1,1,2
Sligo Borough,2018,40 - 44 years,0,1,1
Sligo Borough,2018,45 - 49 years,0,1,1
Sligo Borough,2018,5 - 9 years,0,0,0
Sligo Borough,2018,50 - 54 years,1,4,5
Sligo Borough,2018,55 - 59 years,1,3,4
Sligo Borough,2018,60 - 64 years,4,7,11
Sligo Borough,2018,65 - 69 years,5,9,14
Sligo Borough,2018,70 - 74 years,7,10,17
Sligo Borough,2018,75 - 79 years,13,12,25
Sligo Borough,2018,80 - 84 years,12,13,25
Sligo Borough,2018,85 years and over,43,19,62
Sligo Borough,2018,Under 1 year,0,0,0
Sligo Borough,2019,1 - 4 years,0,0,0
Sligo Borough,2019,10 - 14 years,0,0,0
Sligo Borough,2019,15 - 19 years,0,1,1
Sligo Borough,2019,20 - 24 years,0,0,0
Sligo Borough,2019,25 - 29 years,2,0,2
Sligo Borough,2019,30 - 34 years,1,0,1
Sligo Borough,2019,35 - 39 years,1,1,2
Sligo Borough,2019,40 - 44 years,0,1,1
Sligo Borough,2019,45 - 49 years,0,1,1
Sligo Borough,2019,5 - 9 years,0,0,0
Sligo Borough,2019,50 - 54 years,1,4,5
Sligo Borough,2019,55 - 59 years,1,3,4
Sligo Borough,2019,60 - 64 years,4,7,11
Sligo Borough,2019,65 - 69 years,5,9,14
Sligo Borough,2019,70 - 74 years,7,10,17
Sligo Borough,2019,75 - 79 years,13,12,25
Sligo Borough,2019,80 - 84 years,12,13,25
Sligo Borough,2019,85 years and over,43,19,62
Sligo Borough,2019,Under 1 year,0,0,0
Sligo Borough,2020,1 - 4 years,0,0,0
Sligo Borough,2020,10 - 14 years,0,0,0
Sligo Borough,2020,15 - 19 years,0,1,1
Sligo Borough,2020,20 - 24 years,0,0,0
Sligo Borough,2020,25 - 29 years,2,0,2
Sligo Borough,2020,30 - 34 years,1,0,1
Sligo Borough,2020,35 - 39 years,1,1,2
Sligo Borough,2020,40 - 44 years,0,1,1
Sligo Borough,2020,45 - 49 years,0,1,1
Sligo Borough,2020,5 - 9 years,0,0,0
Sligo Borough,2020,50 - 54 years,1,4,5
Sligo Borough,2020,55 - 59 years,1,3,4
Sligo Borough,2020,60 - 64 years,4,7,11
Sligo Borough,2020,65 - 69 years,5,9,14
Sligo Borough,2020,70 - 74 years,7,10,17
Sligo Borough,2020,75 - 79 years,13,12,25
Sligo Borough,2020,80 - 84 years,12,13,25
Sligo Borough,2020,85 years and over,43,19,62
Sligo Borough,2020,Under 1 year,0,0,0
South Dublin,2007,1 - 4 years,0,2,2
South Dublin,2007,10 - 14 years,1,6,7
South Dublin,2007,15 - 19 years,3,8,11
South Dublin,2007,20 - 24 years,4,5,9
South Dublin,2007,25 - 29 years,3,10,13
South Dublin,2007,30 - 34 years,5,8,13
South Dublin,2007,35 - 39 years,2,9,11
South Dublin,2007,40 - 44 years,7,16,23
South Dublin,2007,45 - 49 years,10,21,31
South Dublin,2007,5 - 9 years,0,0,0
South Dublin,2007,50 - 54 years,23,25,48
South Dublin,2007,55 - 59 years,26,47,73
South Dublin,2007,60 - 64 years,37,56,93
South Dublin,2007,65 - 69 years,16,38,54
South Dublin,2007,70 - 74 years,37,47,84
South Dublin,2007,75 - 79 years,48,57,105
South Dublin,2007,80 - 84 years,66,55,121
South Dublin,2007,85 years and over,106,61,167
South Dublin,2007,Under 1 year,7,4,11
South Dublin,2008,1 - 4 years,1,2,3
South Dublin,2008,10 - 14 years,1,2,3
South Dublin,2008,15 - 19 years,4,6,10
South Dublin,2008,20 - 24 years,2,7,9
South Dublin,2008,25 - 29 years,7,12,19
South Dublin,2008,30 - 34 years,6,11,17
South Dublin,2008,35 - 39 years,7,13,20
South Dublin,2008,40 - 44 years,10,12,22
South Dublin,2008,45 - 49 years,20,10,30
South Dublin,2008,5 - 9 years,0,0,0
South Dublin,2008,50 - 54 years,28,18,46
South Dublin,2008,55 - 59 years,27,33,60
South Dublin,2008,60 - 64 years,37,47,84
South Dublin,2008,65 - 69 years,27,57,84
South Dublin,2008,70 - 74 years,36,53,89
South Dublin,2008,75 - 79 years,55,55,110
South Dublin,2008,80 - 84 years,63,67,130
South Dublin,2008,85 years and over,86,55,141
South Dublin,2008,Under 1 year,7,7,14
South Dublin,2009,1 - 4 years,1,3,4
South Dublin,2009,10 - 14 years,1,3,4
South Dublin,2009,15 - 19 years,1,8,9
South Dublin,2009,20 - 24 years,2,8,10
South Dublin,2009,25 - 29 years,3,11,14
South Dublin,2009,30 - 34 years,10,15,25
South Dublin,2009,35 - 39 years,5,14,19
South Dublin,2009,40 - 44 years,5,16,21
South Dublin,2009,45 - 49 years,15,15,30
South Dublin,2009,5 - 9 years,0,0,0
South Dublin,2009,50 - 54 years,17,24,41
South Dublin,2009,55 - 59 years,24,43,67
South Dublin,2009,60 - 64 years,35,36,71
South Dublin,2009,65 - 69 years,31,58,89
South Dublin,2009,70 - 74 years,37,48,85
South Dublin,2009,75 - 79 years,57,49,106
South Dublin,2009,80 - 84 years,46,53,99
South Dublin,2009,85 years and over,115,56,171
South Dublin,2009,Under 1 year,5,6,11
South Dublin,2010,1 - 4 years,1,1,2
South Dublin,2010,10 - 14 years,1,2,3
South Dublin,2010,15 - 19 years,1,4,5
South Dublin,2010,20 - 24 years,3,4,7
South Dublin,2010,25 - 29 years,3,8,11
South Dublin,2010,30 - 34 years,4,9,13
South Dublin,2010,35 - 39 years,4,13,17
South Dublin,2010,40 - 44 years,14,9,23
South Dublin,2010,45 - 49 years,11,17,28
South Dublin,2010,5 - 9 years,0,0,0
South Dublin,2010,50 - 54 years,20,21,41
South Dublin,2010,55 - 59 years,24,38,62
South Dublin,2010,60 - 64 years,35,66,101
South Dublin,2010,65 - 69 years,33,60,93
South Dublin,2010,70 - 74 years,43,66,109
South Dublin,2010,75 - 79 years,41,55,96
South Dublin,2010,80 - 84 years,57,61,118
South Dublin,2010,85 years and over,135,56,191
South Dublin,2010,Under 1 year,2,8,10
South Dublin,2011,1 - 4 years,2,0,2
South Dublin,2011,10 - 14 years,1,1,2
South Dublin,2011,15 - 19 years,2,3,5
South Dublin,2011,20 - 24 years,3,9,12
South Dublin,2011,25 - 29 years,6,9,15
South Dublin,2011,30 - 34 years,8,9,17
South Dublin,2011,35 - 39 years,7,9,16
South Dublin,2011,40 - 44 years,9,16,25
South Dublin,2011,45 - 49 years,14,18,32
South Dublin,2011,5 - 9 years,1,0,1
South Dublin,2011,50 - 54 years,19,29,48
South Dublin,2011,55 - 59 years,25,36,61
South Dublin,2011,60 - 64 years,36,47,83
South Dublin,2011,65 - 69 years,40,56,96
South Dublin,2011,70 - 74 years,52,80,132
South Dublin,2011,75 - 79 years,54,77,131
South Dublin,2011,80 - 84 years,86,86,172
South Dublin,2011,85 years and over,171,81,252
South Dublin,2011,Under 1 year,6,6,12
South Dublin,2012,1 - 4 years,1,1,2
South Dublin,2012,10 - 14 years,1,1,2
South Dublin,2012,15 - 19 years,1,3,4
South Dublin,2012,20 - 24 years,2,4,6
South Dublin,2012,25 - 29 years,3,8,11
South Dublin,2012,30 - 34 years,3,13,16
South Dublin,2012,35 - 39 years,7,12,19
South Dublin,2012,40 - 44 years,14,11,25
South Dublin,2012,45 - 49 years,6,11,17
South Dublin,2012,5 - 9 years,1,0,1
South Dublin,2012,50 - 54 years,18,14,32
South Dublin,2012,55 - 59 years,30,38,68
South Dublin,2012,60 - 64 years,35,60,95
South Dublin,2012,65 - 69 years,41,58,99
South Dublin,2012,70 - 74 years,42,62,104
South Dublin,2012,75 - 79 years,46,68,114
South Dublin,2012,80 - 84 years,61,60,121
South Dublin,2012,85 years and over,157,75,232
South Dublin,2012,Under 1 year,9,9,18
South Dublin,2013,1 - 4 years,2,2,4
South Dublin,2013,10 - 14 years,0,1,1
South Dublin,2013,15 - 19 years,1,2,3
South Dublin,2013,20 - 24 years,3,8,11
South Dublin,2013,25 - 29 years,1,4,5
South Dublin,2013,30 - 34 years,7,10,17
South Dublin,2013,35 - 39 years,6,13,19
South Dublin,2013,40 - 44 years,5,13,18
South Dublin,2013,45 - 49 years,11,25,36
South Dublin,2013,5 - 9 years,2,2,4
South Dublin,2013,50 - 54 years,18,24,42
South Dublin,2013,55 - 59 years,29,41,70
South Dublin,2013,60 - 64 years,46,44,90
South Dublin,2013,65 - 69 years,42,63,105
South Dublin,2013,70 - 74 years,52,62,114
South Dublin,2013,75 - 79 years,63,61,124
South Dublin,2013,80 - 84 years,54,83,137
South Dublin,2013,85 years and over,145,86,231
South Dublin,2013,Under 1 year,12,6,18
South Dublin,2014,1 - 4 years,2,1,3
South Dublin,2014,10 - 14 years,0,1,1
South Dublin,2014,15 - 19 years,1,2,3
South Dublin,2014,20 - 24 years,2,6,8
South Dublin,2014,25 - 29 years,2,7,9
South Dublin,2014,30 - 34 years,7,7,14
South Dublin,2014,35 - 39 years,9,10,19
South Dublin,2014,40 - 44 years,14,14,28
South Dublin,2014,45 - 49 years,8,23,31
South Dublin,2014,5 - 9 years,1,2,3
South Dublin,2014,50 - 54 years,20,25,45
South Dublin,2014,55 - 59 years,30,34,64
South Dublin,2014,60 - 64 years,47,55,102
South Dublin,2014,65 - 69 years,52,70,122
South Dublin,2014,70 - 74 years,53,81,134
South Dublin,2014,75 - 79 years,60,71,131
South Dublin,2014,80 - 84 years,90,77,167
South Dublin,2014,85 years and over,169,93,262
South Dublin,2014,Under 1 year,5,10,15
South Dublin,2015,1 - 4 years,2,1,3
South Dublin,2015,10 - 14 years,1,1,2
South Dublin,2015,15 - 19 years,1,1,2
South Dublin,2015,20 - 24 years,2,1,3
South Dublin,2015,25 - 29 years,1,5,6
South Dublin,2015,30 - 34 years,6,6,12
South Dublin,2015,35 - 39 years,4,8,12
South Dublin,2015,40 - 44 years,9,10,19
South Dublin,2015,45 - 49 years,5,16,21
South Dublin,2015,5 - 9 years,1,2,3
South Dublin,2015,50 - 54 years,25,22,47
South Dublin,2015,55 - 59 years,25,30,55
South Dublin,2015,60 - 64 years,40,48,88
South Dublin,2015,65 - 69 years,50,71,121
South Dublin,2015,70 - 74 years,64,58,122
South Dublin,2015,75 - 79 years,59,88,147
South Dublin,2015,80 - 84 years,81,87,168
South Dublin,2015,85 years and over,197,102,299
South Dublin,2015,Under 1 year,7,5,12
South Dublin,2016,1 - 4 years,1,1,2
South Dublin,2016,10 - 14 years,1,2,3
South Dublin,2016,15 - 19 years,1,3,4
South Dublin,2016,20 - 24 years,1,1,2
South Dublin,2016,25 - 29 years,1,5,6
South Dublin,2016,30 - 34 years,6,4,10
South Dublin,2016,35 - 39 years,4,18,22
South Dublin,2016,40 - 44 years,8,18,26
South Dublin,2016,45 - 49 years,7,16,23
South Dublin,2016,5 - 9 years,3,2,5
South Dublin,2016,50 - 54 years,19,19,38
South Dublin,2016,55 - 59 years,28,23,51
South Dublin,2016,60 - 64 years,34,52,86
South Dublin,2016,65 - 69 years,59,70,129
South Dublin,2016,70 - 74 years,62,90,152
South Dublin,2016,75 - 79 years,59,91,150
South Dublin,2016,80 - 84 years,82,103,185
South Dublin,2016,85 years and over,189,126,315
South Dublin,2016,Under 1 year,9,8,17
South Dublin,2017,1 - 4 years,2,1,3
South Dublin,2017,10 - 14 years,1,2,3
South Dublin,2017,15 - 19 years,1,3,4
South Dublin,2017,20 - 24 years,1,2,3
South Dublin,2017,25 - 29 years,3,3,6
South Dublin,2017,30 - 34 years,4,6,10
South Dublin,2017,35 - 39 years,5,10,15
South Dublin,2017,40 - 44 years,8,8,16
South Dublin,2017,45 - 49 years,8,12,20
South Dublin,2017,5 - 9 years,3,1,4
South Dublin,2017,50 - 54 years,16,31,47
South Dublin,2017,55 - 59 years,25,29,54
South Dublin,2017,60 - 64 years,43,40,83
South Dublin,2017,65 - 69 years,48,90,138
South Dublin,2017,70 - 74 years,56,102,158
South Dublin,2017,75 - 79 years,66,101,167
South Dublin,2017,80 - 84 years,93,102,195
South Dublin,2017,85 years and over,223,128,351
South Dublin,2017,Under 1 year,7,9,16
South Dublin,2018,1 - 4 years,1,0,1
South Dublin,2018,10 - 14 years,0,1,1
South Dublin,2018,15 - 19 years,0,1,1
South Dublin,2018,20 - 24 years,2,3,5
South Dublin,2018,25 - 29 years,1,4,5
South Dublin,2018,30 - 34 years,5,8,13
South Dublin,2018,35 - 39 years,8,7,15
South Dublin,2018,40 - 44 years,12,20,32
South Dublin,2018,45 - 49 years,10,19,29
South Dublin,2018,5 - 9 years,0,0,0
South Dublin,2018,50 - 54 years,14,15,29
South Dublin,2018,55 - 59 years,23,39,62
South Dublin,2018,60 - 64 years,32,47,79
South Dublin,2018,65 - 69 years,60,81,141
South Dublin,2018,70 - 74 years,80,95,175
South Dublin,2018,75 - 79 years,76,102,178
South Dublin,2018,80 - 84 years,100,102,202
South Dublin,2018,85 years and over,203,144,347
South Dublin,2018,Under 1 year,2,7,9
South Dublin,2019,1 - 4 years,1,1,2
South Dublin,2019,10 - 14 years,0,1,1
South Dublin,2019,15 - 19 years,1,2,3
South Dublin,2019,20 - 24 years,3,2,5
South Dublin,2019,25 - 29 years,2,4,6
South Dublin,2019,30 - 34 years,3,7,10
South Dublin,2019,35 - 39 years,10,4,14
South Dublin,2019,40 - 44 years,21,15,36
South Dublin,2019,45 - 49 years,7,17,24
South Dublin,2019,5 - 9 years,1,1,2
South Dublin,2019,50 - 54 years,11,16,27
South Dublin,2019,55 - 59 years,21,39,60
South Dublin,2019,60 - 64 years,39,46,85
South Dublin,2019,65 - 69 years,65,69,134
South Dublin,2019,70 - 74 years,70,111,181
South Dublin,2019,75 - 79 years,68,114,182
South Dublin,2019,80 - 84 years,100,105,205
South Dublin,2019,85 years and over,202,155,357
South Dublin,2019,Under 1 year,4,11,15
South Dublin,2020,1 - 4 years,1,1,2
South Dublin,2020,10 - 14 years,0,1,1
South Dublin,2020,15 - 19 years,1,2,3
South Dublin,2020,20 - 24 years,2,5,7
South Dublin,2020,25 - 29 years,1,2,3
South Dublin,2020,30 - 34 years,1,5,6
South Dublin,2020,35 - 39 years,10,13,23
South Dublin,2020,40 - 44 years,10,21,31
South Dublin,2020,45 - 49 years,13,12,25
South Dublin,2020,5 - 9 years,1,2,3
South Dublin,2020,50 - 54 years,18,23,41
South Dublin,2020,55 - 59 years,28,36,64
South Dublin,2020,60 - 64 years,39,49,88
South Dublin,2020,65 - 69 years,56,66,122
South Dublin,2020,70 - 74 years,87,94,181
South Dublin,2020,75 - 79 years,75,102,177
South Dublin,2020,80 - 84 years,98,126,224
South Dublin,2020,85 years and over,232,171,403
South Dublin,2020,Under 1 year,6,3,9
South Tipperary,2007,1 - 4 years,0,0,0
South Tipperary,2007,10 - 14 years,1,0,1
South Tipperary,2007,15 - 19 years,0,2,2
South Tipperary,2007,20 - 24 years,2,3,5
South Tipperary,2007,25 - 29 years,0,4,4
South Tipperary,2007,30 - 34 years,0,4,4
South Tipperary,2007,35 - 39 years,3,2,5
South Tipperary,2007,40 - 44 years,2,3,5
South Tipperary,2007,45 - 49 years,5,8,13
South Tipperary,2007,5 - 9 years,0,1,1
South Tipperary,2007,50 - 54 years,4,10,14
South Tipperary,2007,55 - 59 years,10,18,28
South Tipperary,2007,60 - 64 years,14,16,30
South Tipperary,2007,65 - 69 years,16,32,48
South Tipperary,2007,70 - 74 years,38,37,75
South Tipperary,2007,75 - 79 years,28,63,91
South Tipperary,2007,80 - 84 years,57,63,120
South Tipperary,2007,85 years and over,91,66,157
South Tipperary,2007,Under 1 year,0,3,3
South Tipperary,2008,1 - 4 years,0,0,0
South Tipperary,2008,10 - 14 years,1,1,2
South Tipperary,2008,15 - 19 years,0,1,1
South Tipperary,2008,20 - 24 years,3,1,4
South Tipperary,2008,25 - 29 years,0,3,3
South Tipperary,2008,30 - 34 years,4,4,8
South Tipperary,2008,35 - 39 years,3,10,13
South Tipperary,2008,40 - 44 years,9,7,16
South Tipperary,2008,45 - 49 years,3,5,8
South Tipperary,2008,5 - 9 years,0,1,1
South Tipperary,2008,50 - 54 years,4,7,11
South Tipperary,2008,55 - 59 years,14,16,30
South Tipperary,2008,60 - 64 years,18,20,38
South Tipperary,2008,65 - 69 years,10,28,38
South Tipperary,2008,70 - 74 years,18,34,52
South Tipperary,2008,75 - 79 years,41,51,92
South Tipperary,2008,80 - 84 years,56,46,102
South Tipperary,2008,85 years and over,112,71,183
South Tipperary,2008,Under 1 year,3,5,8
South Tipperary,2009,1 - 4 years,0,2,2
South Tipperary,2009,10 - 14 years,1,1,2
South Tipperary,2009,15 - 19 years,0,1,1
South Tipperary,2009,20 - 24 years,1,3,4
South Tipperary,2009,25 - 29 years,2,5,7
South Tipperary,2009,30 - 34 years,1,3,4
South Tipperary,2009,35 - 39 years,3,3,6
South Tipperary,2009,40 - 44 years,2,5,7
South Tipperary,2009,45 - 49 years,9,3,12
South Tipperary,2009,5 - 9 years,0,1,1
South Tipperary,2009,50 - 54 years,12,10,22
South Tipperary,2009,55 - 59 years,10,13,23
South Tipperary,2009,60 - 64 years,11,29,40
South Tipperary,2009,65 - 69 years,18,31,49
South Tipperary,2009,70 - 74 years,30,48,78
South Tipperary,2009,75 - 79 years,30,43,73
South Tipperary,2009,80 - 84 years,56,51,107
South Tipperary,2009,85 years and over,93,63,156
South Tipperary,2009,Under 1 year,4,2,6
South Tipperary,2010,1 - 4 years,0,2,2
South Tipperary,2010,10 - 14 years,1,1,2
South Tipperary,2010,15 - 19 years,2,1,3
South Tipperary,2010,20 - 24 years,1,5,6
South Tipperary,2010,25 - 29 years,2,3,5
South Tipperary,2010,30 - 34 years,1,3,4
South Tipperary,2010,35 - 39 years,6,6,12
South Tipperary,2010,40 - 44 years,5,2,7
South Tipperary,2010,45 - 49 years,5,12,17
South Tipperary,2010,5 - 9 years,1,2,3
South Tipperary,2010,50 - 54 years,6,11,17
South Tipperary,2010,55 - 59 years,6,14,20
South Tipperary,2010,60 - 64 years,12,17,29
South Tipperary,2010,65 - 69 years,18,30,48
South Tipperary,2010,70 - 74 years,25,34,59
South Tipperary,2010,75 - 79 years,37,61,98
South Tipperary,2010,80 - 84 years,55,62,117
South Tipperary,2010,85 years and over,117,86,203
South Tipperary,2010,Under 1 year,4,4,8
South Tipperary,2011,1 - 4 years,0,0,0
South Tipperary,2011,10 - 14 years,0,1,1
South Tipperary,2011,15 - 19 years,1,0,1
South Tipperary,2011,20 - 24 years,2,7,9
South Tipperary,2011,25 - 29 years,1,2,3
South Tipperary,2011,30 - 34 years,1,1,2
South Tipperary,2011,35 - 39 years,0,6,6
South Tipperary,2011,40 - 44 years,2,4,6
South Tipperary,2011,45 - 49 years,5,10,15
South Tipperary,2011,5 - 9 years,0,0,0
South Tipperary,2011,50 - 54 years,7,13,20
South Tipperary,2011,55 - 59 years,11,12,23
South Tipperary,2011,60 - 64 years,11,21,32
South Tipperary,2011,65 - 69 years,15,27,42
South Tipperary,2011,70 - 74 years,21,31,52
South Tipperary,2011,75 - 79 years,33,41,74
South Tipperary,2011,80 - 84 years,45,49,94
South Tipperary,2011,85 years and over,142,62,204
South Tipperary,2011,Under 1 year,3,2,5
South Tipperary,2012,1 - 4 years,0,1,1
South Tipperary,2012,10 - 14 years,0,1,1
South Tipperary,2012,15 - 19 years,1,2,3
South Tipperary,2012,20 - 24 years,2,3,5
South Tipperary,2012,25 - 29 years,2,2,4
South Tipperary,2012,30 - 34 years,1,1,2
South Tipperary,2012,35 - 39 years,3,1,4
South Tipperary,2012,40 - 44 years,2,6,8
South Tipperary,2012,45 - 49 years,5,9,14
South Tipperary,2012,5 - 9 years,1,0,1
South Tipperary,2012,50 - 54 years,6,11,17
South Tipperary,2012,55 - 59 years,13,10,23
South Tipperary,2012,60 - 64 years,9,20,29
South Tipperary,2012,65 - 69 years,20,28,48
South Tipperary,2012,70 - 74 years,18,35,53
South Tipperary,2012,75 - 79 years,43,56,99
South Tipperary,2012,80 - 84 years,37,57,94
South Tipperary,2012,85 years and over,128,85,213
South Tipperary,2012,Under 1 year,3,2,5
South Tipperary,2013,1 - 4 years,0,1,1
South Tipperary,2013,10 - 14 years,0,0,0
South Tipperary,2013,15 - 19 years,1,1,2
South Tipperary,2013,20 - 24 years,0,2,2
South Tipperary,2013,25 - 29 years,1,0,1
South Tipperary,2013,30 - 34 years,1,3,4
South Tipperary,2013,35 - 39 years,2,6,8
South Tipperary,2013,40 - 44 years,0,2,2
South Tipperary,2013,45 - 49 years,5,13,18
South Tipperary,2013,5 - 9 years,0,1,1
South Tipperary,2013,50 - 54 years,6,14,20
South Tipperary,2013,55 - 59 years,9,14,23
South Tipperary,2013,60 - 64 years,16,31,47
South Tipperary,2013,65 - 69 years,21,45,66
South Tipperary,2013,70 - 74 years,25,31,56
South Tipperary,2013,75 - 79 years,31,64,95
South Tipperary,2013,80 - 84 years,54,61,115
South Tipperary,2013,85 years and over,163,107,270
South Tipperary,2013,Under 1 year,1,1,2
South Tipperary,2014,1 - 4 years,0,1,1
South Tipperary,2014,10 - 14 years,0,1,1
South Tipperary,2014,15 - 19 years,1,2,3
South Tipperary,2014,20 - 24 years,0,2,2
South Tipperary,2014,25 - 29 years,2,7,9
South Tipperary,2014,30 - 34 years,2,5,7
South Tipperary,2014,35 - 39 years,2,3,5
South Tipperary,2014,40 - 44 years,3,6,9
South Tipperary,2014,45 - 49 years,2,3,5
South Tipperary,2014,5 - 9 years,1,1,2
South Tipperary,2014,50 - 54 years,3,8,11
South Tipperary,2014,55 - 59 years,11,10,21
South Tipperary,2014,60 - 64 years,25,20,45
South Tipperary,2014,65 - 69 years,22,38,60
South Tipperary,2014,70 - 74 years,31,47,78
South Tipperary,2014,75 - 79 years,27,45,72
South Tipperary,2014,80 - 84 years,51,63,114
South Tipperary,2014,85 years and over,137,72,209
South Tipperary,2014,Under 1 year,2,1,3
South Tipperary,2015,1 - 4 years,0,1,1
South Tipperary,2015,10 - 14 years,0,1,1
South Tipperary,2015,15 - 19 years,3,3,6
South Tipperary,2015,20 - 24 years,0,1,1
South Tipperary,2015,25 - 29 years,2,2,4
South Tipperary,2015,30 - 34 years,3,6,9
South Tipperary,2015,35 - 39 years,2,3,5
South Tipperary,2015,40 - 44 years,1,2,3
South Tipperary,2015,45 - 49 years,4,5,9
South Tipperary,2015,5 - 9 years,1,1,2
South Tipperary,2015,50 - 54 years,7,9,16
South Tipperary,2015,55 - 59 years,16,14,30
South Tipperary,2015,60 - 64 years,14,21,35
South Tipperary,2015,65 - 69 years,28,32,60
South Tipperary,2015,70 - 74 years,27,33,60
South Tipperary,2015,75 - 79 years,34,41,75
South Tipperary,2015,80 - 84 years,47,65,112
South Tipperary,2015,85 years and over,146,93,239
South Tipperary,2015,Under 1 year,2,1,3
South Tipperary,2016,1 - 4 years,0,1,1
South Tipperary,2016,10 - 14 years,0,1,1
South Tipperary,2016,15 - 19 years,1,1,2
South Tipperary,2016,20 - 24 years,0,5,5
South Tipperary,2016,25 - 29 years,3,4,7
South Tipperary,2016,30 - 34 years,2,3,5
South Tipperary,2016,35 - 39 years,2,4,6
South Tipperary,2016,40 - 44 years,2,3,5
South Tipperary,2016,45 - 49 years,3,6,9
South Tipperary,2016,5 - 9 years,1,1,2
South Tipperary,2016,50 - 54 years,5,11,16
South Tipperary,2016,55 - 59 years,12,21,33
South Tipperary,2016,60 - 64 years,18,24,42
South Tipperary,2016,65 - 69 years,27,28,55
South Tipperary,2016,70 - 74 years,35,41,76
South Tipperary,2016,75 - 79 years,34,53,87
South Tipperary,2016,80 - 84 years,63,59,122
South Tipperary,2016,85 years and over,151,102,253
South Tipperary,2016,Under 1 year,2,3,5
South Tipperary,2017,1 - 4 years,0,1,1
South Tipperary,2017,10 - 14 years,0,1,1
South Tipperary,2017,15 - 19 years,1,1,2
South Tipperary,2017,20 - 24 years,1,1,2
South Tipperary,2017,25 - 29 years,3,3,6
South Tipperary,2017,30 - 34 years,2,5,7
South Tipperary,2017,35 - 39 years,3,4,7
South Tipperary,2017,40 - 44 years,3,2,5
South Tipperary,2017,45 - 49 years,4,6,10
South Tipperary,2017,5 - 9 years,1,1,2
South Tipperary,2017,50 - 54 years,8,13,21
South Tipperary,2017,55 - 59 years,7,13,20
South Tipperary,2017,60 - 64 years,11,19,30
South Tipperary,2017,65 - 69 years,18,26,44
South Tipperary,2017,70 - 74 years,23,46,69
South Tipperary,2017,75 - 79 years,41,52,93
South Tipperary,2017,80 - 84 years,62,60,122
South Tipperary,2017,85 years and over,157,85,242
South Tipperary,2017,Under 1 year,4,4,8
South Tipperary,2018,1 - 4 years,0,1,1
South Tipperary,2018,10 - 14 years,0,1,1
South Tipperary,2018,15 - 19 years,1,1,2
South Tipperary,2018,20 - 24 years,1,1,2
South Tipperary,2018,25 - 29 years,3,3,6
South Tipperary,2018,30 - 34 years,2,5,7
South Tipperary,2018,35 - 39 years,3,4,7
South Tipperary,2018,40 - 44 years,3,2,5
South Tipperary,2018,45 - 49 years,4,6,10
South Tipperary,2018,5 - 9 years,1,1,2
South Tipperary,2018,50 - 54 years,8,13,21
South Tipperary,2018,55 - 59 years,7,13,20
South Tipperary,2018,60 - 64 years,11,19,30
South Tipperary,2018,65 - 69 years,18,26,44
South Tipperary,2018,70 - 74 years,23,46,69
South Tipperary,2018,75 - 79 years,41,52,93
South Tipperary,2018,80 - 84 years,62,60,122
South Tipperary,2018,85 years and over,157,85,242
South Tipperary,2018,Under 1 year,4,4,8
South Tipperary,2019,1 - 4 years,0,1,1
South Tipperary,2019,10 - 14 years,0,1,1
South Tipperary,2019,15 - 19 years,1,1,2
South Tipperary,2019,20 - 24 years,1,1,2
South Tipperary,2019,25 - 29 years,3,3,6
South Tipperary,2019,30 - 34 years,2,5,7
South Tipperary,2019,35 - 39 years,3,4,7
South Tipperary,2019,40 - 44 years,3,2,5
South Tipperary,2019,45 - 49 years,4,6,10
South Tipperary,2019,5 - 9 years,1,1,2
South Tipperary,2019,50 - 54 years,8,13,21
South Tipperary,2019,55 - 59 years,7,13,20
South Tipperary,2019,60 - 64 years,11,19,30
South Tipperary,2019,65 - 69 years,18,26,44
South Tipperary,2019,70 - 74 years,23,46,69
South Tipperary,2019,75 - 79 years,41,52,93
South Tipperary,2019,80 - 84 years,62,60,122
South Tipperary,2019,85 years and over,157,85,242
South Tipperary,2019,Under 1 year,4,4,8
South Tipperary,2020,1 - 4 years,0,1,1
South Tipperary,2020,10 - 14 years,0,1,1
South Tipperary,2020,15 - 19 years,1,1,2
South Tipperary,2020,20 - 24 years,1,1,2
South Tipperary,2020,25 - 29 years,3,3,6
South Tipperary,2020,30 - 34 years,2,5,7
South Tipperary,2020,35 - 39 years,3,4,7
South Tipperary,2020,40 - 44 years,3,2,5
South Tipperary,2020,45 - 49 years,4,6,10
South Tipperary,2020,5 - 9 years,1,1,2
South Tipperary,2020,50 - 54 years,8,13,21
South Tipperary,2020,55 - 59 years,7,13,20
South Tipperary,2020,60 - 64 years,11,19,30
South Tipperary,2020,65 - 69 years,18,26,44
South Tipperary,2020,70 - 74 years,23,46,69
South Tipperary,2020,75 - 79 years,41,52,93
South Tipperary,2020,80 - 84 years,62,60,122
South Tipperary,2020,85 years and over,157,85,242
South Tipperary,2020,Under 1 year,4,4,8
Templemore Town,2007,1 - 4 years,0,0,0
Templemore Town,2007,10 - 14 years,0,1,1
Templemore Town,2007,15 - 19 years,0,1,1
Templemore Town,2007,20 - 24 years,0,0,0
Templemore Town,2007,25 - 29 years,0,0,0
Templemore Town,2007,30 - 34 years,1,0,1
Templemore Town,2007,35 - 39 years,0,0,0
Templemore Town,2007,40 - 44 years,0,0,0
Templemore Town,2007,45 - 49 years,0,0,0
Templemore Town,2007,5 - 9 years,0,0,0
Templemore Town,2007,50 - 54 years,0,1,1
Templemore Town,2007,55 - 59 years,1,1,2
Templemore Town,2007,60 - 64 years,1,3,4
Templemore Town,2007,65 - 69 years,2,1,3
Templemore Town,2007,70 - 74 years,1,3,4
Templemore Town,2007,75 - 79 years,1,2,3
Templemore Town,2007,80 - 84 years,3,3,6
Templemore Town,2007,85 years and over,8,6,14
Templemore Town,2007,Under 1 year,0,0,0
Templemore Town,2008,1 - 4 years,0,0,0
Templemore Town,2008,10 - 14 years,0,1,1
Templemore Town,2008,15 - 19 years,0,1,1
Templemore Town,2008,20 - 24 years,0,0,0
Templemore Town,2008,25 - 29 years,0,0,0
Templemore Town,2008,30 - 34 years,1,0,1
Templemore Town,2008,35 - 39 years,0,1,1
Templemore Town,2008,40 - 44 years,0,0,0
Templemore Town,2008,45 - 49 years,0,0,0
Templemore Town,2008,5 - 9 years,0,0,0
Templemore Town,2008,50 - 54 years,0,1,1
Templemore Town,2008,55 - 59 years,1,1,2
Templemore Town,2008,60 - 64 years,1,3,4
Templemore Town,2008,65 - 69 years,2,2,4
Templemore Town,2008,70 - 74 years,2,3,5
Templemore Town,2008,75 - 79 years,2,1,3
Templemore Town,2008,80 - 84 years,4,2,6
Templemore Town,2008,85 years and over,11,3,14
Templemore Town,2008,Under 1 year,0,0,0
Templemore Town,2009,1 - 4 years,0,0,0
Templemore Town,2009,10 - 14 years,0,1,1
Templemore Town,2009,15 - 19 years,0,1,1
Templemore Town,2009,20 - 24 years,0,0,0
Templemore Town,2009,25 - 29 years,0,0,0
Templemore Town,2009,30 - 34 years,1,0,1
Templemore Town,2009,35 - 39 years,0,1,1
Templemore Town,2009,40 - 44 years,0,0,0
Templemore Town,2009,45 - 49 years,0,0,0
Templemore Town,2009,5 - 9 years,0,0,0
Templemore Town,2009,50 - 54 years,0,1,1
Templemore Town,2009,55 - 59 years,1,1,2
Templemore Town,2009,60 - 64 years,1,3,4
Templemore Town,2009,65 - 69 years,2,1,3
Templemore Town,2009,70 - 74 years,2,3,5
Templemore Town,2009,75 - 79 years,4,1,5
Templemore Town,2009,80 - 84 years,3,1,4
Templemore Town,2009,85 years and over,1,6,7
Templemore Town,2009,Under 1 year,0,0,0
Templemore Town,2010,1 - 4 years,0,1,1
Templemore Town,2010,10 - 14 years,0,1,1
Templemore Town,2010,15 - 19 years,0,1,1
Templemore Town,2010,20 - 24 years,0,0,0
Templemore Town,2010,25 - 29 years,0,0,0
Templemore Town,2010,30 - 34 years,1,0,1
Templemore Town,2010,35 - 39 years,0,1,1
Templemore Town,2010,40 - 44 years,0,0,0
Templemore Town,2010,45 - 49 years,0,0,0
Templemore Town,2010,5 - 9 years,0,0,0
Templemore Town,2010,50 - 54 years,0,1,1
Templemore Town,2010,55 - 59 years,1,1,2
Templemore Town,2010,60 - 64 years,1,3,4
Templemore Town,2010,65 - 69 years,2,1,3
Templemore Town,2010,70 - 74 years,1,3,4
Templemore Town,2010,75 - 79 years,3,3,6
Templemore Town,2010,80 - 84 years,3,1,4
Templemore Town,2010,85 years and over,1,6,7
Templemore Town,2010,Under 1 year,0,1,1
Templemore Town,2011,1 - 4 years,0,0,0
Templemore Town,2011,10 - 14 years,0,0,0
Templemore Town,2011,15 - 19 years,0,0,0
Templemore Town,2011,20 - 24 years,0,0,0
Templemore Town,2011,25 - 29 years,0,0,0
Templemore Town,2011,30 - 34 years,0,0,0
Templemore Town,2011,35 - 39 years,0,0,0
Templemore Town,2011,40 - 44 years,0,0,0
Templemore Town,2011,45 - 49 years,0,0,0
Templemore Town,2011,5 - 9 years,0,0,0
Templemore Town,2011,50 - 54 years,0,0,0
Templemore Town,2011,55 - 59 years,0,0,0
Templemore Town,2011,60 - 64 years,0,2,2
Templemore Town,2011,65 - 69 years,0,1,1
Templemore Town,2011,70 - 74 years,0,1,1
Templemore Town,2011,75 - 79 years,1,3,4
Templemore Town,2011,80 - 84 years,2,2,4
Templemore Town,2011,85 years and over,2,0,2
Templemore Town,2011,Under 1 year,0,0,0
Templemore Town,2012,1 - 4 years,0,0,0
Templemore Town,2012,10 - 14 years,0,0,0
Templemore Town,2012,15 - 19 years,0,0,0
Templemore Town,2012,20 - 24 years,0,0,0
Templemore Town,2012,25 - 29 years,0,0,0
Templemore Town,2012,30 - 34 years,0,0,0
Templemore Town,2012,35 - 39 years,0,0,0
Templemore Town,2012,40 - 44 years,0,0,0
Templemore Town,2012,45 - 49 years,1,0,1
Templemore Town,2012,5 - 9 years,0,0,0
Templemore Town,2012,50 - 54 years,0,0,0
Templemore Town,2012,55 - 59 years,1,0,1
Templemore Town,2012,60 - 64 years,0,1,1
Templemore Town,2012,65 - 69 years,2,1,3
Templemore Town,2012,70 - 74 years,2,1,3
Templemore Town,2012,75 - 79 years,1,1,2
Templemore Town,2012,80 - 84 years,2,2,4
Templemore Town,2012,85 years and over,1,0,1
Templemore Town,2012,Under 1 year,0,1,1
Templemore Town,2013,1 - 4 years,0,0,0
Templemore Town,2013,10 - 14 years,0,0,0
Templemore Town,2013,15 - 19 years,0,0,0
Templemore Town,2013,20 - 24 years,0,0,0
Templemore Town,2013,25 - 29 years,0,0,0
Templemore Town,2013,30 - 34 years,0,0,0
Templemore Town,2013,35 - 39 years,0,0,0
Templemore Town,2013,40 - 44 years,1,0,1
Templemore Town,2013,45 - 49 years,0,0,0
Templemore Town,2013,5 - 9 years,0,0,0
Templemore Town,2013,50 - 54 years,0,0,0
Templemore Town,2013,55 - 59 years,0,0,0
Templemore Town,2013,60 - 64 years,1,0,1
Templemore Town,2013,65 - 69 years,1,1,2
Templemore Town,2013,70 - 74 years,2,2,4
Templemore Town,2013,75 - 79 years,1,0,1
Templemore Town,2013,80 - 84 years,1,1,2
Templemore Town,2013,85 years and over,4,3,7
Templemore Town,2013,Under 1 year,0,1,1
Templemore Town,2014,1 - 4 years,0,0,0
Templemore Town,2014,10 - 14 years,0,0,0
Templemore Town,2014,15 - 19 years,0,0,0
Templemore Town,2014,20 - 24 years,0,0,0
Templemore Town,2014,25 - 29 years,0,0,0
Templemore Town,2014,30 - 34 years,0,0,0
Templemore Town,2014,35 - 39 years,0,0,0
Templemore Town,2014,40 - 44 years,1,1,2
Templemore Town,2014,45 - 49 years,0,1,1
Templemore Town,2014,5 - 9 years,0,0,0
Templemore Town,2014,50 - 54 years,0,0,0
Templemore Town,2014,55 - 59 years,0,2,2
Templemore Town,2014,60 - 64 years,1,1,2
Templemore Town,2014,65 - 69 years,1,1,2
Templemore Town,2014,70 - 74 years,1,1,2
Templemore Town,2014,75 - 79 years,1,1,2
Templemore Town,2014,80 - 84 years,1,2,3
Templemore Town,2014,85 years and over,6,1,7
Templemore Town,2014,Under 1 year,0,1,1
Templemore Town,2015,1 - 4 years,0,0,0
Templemore Town,2015,10 - 14 years,0,0,0
Templemore Town,2015,15 - 19 years,0,0,0
Templemore Town,2015,20 - 24 years,0,0,0
Templemore Town,2015,25 - 29 years,0,0,0
Templemore Town,2015,30 - 34 years,0,0,0
Templemore Town,2015,35 - 39 years,0,0,0
Templemore Town,2015,40 - 44 years,1,1,2
Templemore Town,2015,45 - 49 years,0,1,1
Templemore Town,2015,5 - 9 years,0,0,0
Templemore Town,2015,50 - 54 years,0,0,0
Templemore Town,2015,55 - 59 years,0,2,2
Templemore Town,2015,60 - 64 years,1,1,2
Templemore Town,2015,65 - 69 years,1,1,2
Templemore Town,2015,70 - 74 years,1,1,2
Templemore Town,2015,75 - 79 years,1,1,2
Templemore Town,2015,80 - 84 years,1,2,3
Templemore Town,2015,85 years and over,6,1,7
Templemore Town,2015,Under 1 year,0,1,1
Templemore Town,2016,1 - 4 years,0,0,0
Templemore Town,2016,10 - 14 years,0,0,0
Templemore Town,2016,15 - 19 years,0,0,0
Templemore Town,2016,20 - 24 years,0,0,0
Templemore Town,2016,25 - 29 years,0,0,0
Templemore Town,2016,30 - 34 years,0,0,0
Templemore Town,2016,35 - 39 years,0,0,0
Templemore Town,2016,40 - 44 years,1,1,2
Templemore Town,2016,45 - 49 years,0,1,1
Templemore Town,2016,5 - 9 years,0,0,0
Templemore Town,2016,50 - 54 years,0,0,0
Templemore Town,2016,55 - 59 years,0,2,2
Templemore Town,2016,60 - 64 years,1,1,2
Templemore Town,2016,65 - 69 years,1,1,2
Templemore Town,2016,70 - 74 years,1,1,2
Templemore Town,2016,75 - 79 years,1,1,2
Templemore Town,2016,80 - 84 years,1,2,3
Templemore Town,2016,85 years and over,6,1,7
Templemore Town,2016,Under 1 year,0,1,1
Templemore Town,2017,1 - 4 years,0,0,0
Templemore Town,2017,10 - 14 years,0,0,0
Templemore Town,2017,15 - 19 years,0,0,0
Templemore Town,2017,20 - 24 years,0,0,0
Templemore Town,2017,25 - 29 years,0,0,0
Templemore Town,2017,30 - 34 years,0,0,0
Templemore Town,2017,35 - 39 years,0,0,0
Templemore Town,2017,40 - 44 years,1,1,2
Templemore Town,2017,45 - 49 years,0,1,1
Templemore Town,2017,5 - 9 years,0,0,0
Templemore Town,2017,50 - 54 years,0,0,0
Templemore Town,2017,55 - 59 years,1,2,3
Templemore Town,2017,60 - 64 years,1,1,2
Templemore Town,2017,65 - 69 years,1,1,2
Templemore Town,2017,70 - 74 years,1,1,2
Templemore Town,2017,75 - 79 years,4,3,7
Templemore Town,2017,80 - 84 years,2,1,3
Templemore Town,2017,85 years and over,11,1,12
Templemore Town,2017,Under 1 year,0,1,1
Templemore Town,2018,1 - 4 years,0,0,0
Templemore Town,2018,10 - 14 years,0,0,0
Templemore Town,2018,15 - 19 years,0,0,0
Templemore Town,2018,20 - 24 years,0,0,0
Templemore Town,2018,25 - 29 years,0,0,0
Templemore Town,2018,30 - 34 years,0,1,1
Templemore Town,2018,35 - 39 years,0,0,0
Templemore Town,2018,40 - 44 years,0,0,0
Templemore Town,2018,45 - 49 years,0,0,0
Templemore Town,2018,5 - 9 years,0,0,0
Templemore Town,2018,50 - 54 years,1,0,1
Templemore Town,2018,55 - 59 years,1,0,1
Templemore Town,2018,60 - 64 years,2,0,2
Templemore Town,2018,65 - 69 years,1,1,2
Templemore Town,2018,70 - 74 years,1,2,3
Templemore Town,2018,75 - 79 years,0,3,3
Templemore Town,2018,80 - 84 years,6,2,8
Templemore Town,2018,85 years and over,2,7,9
Templemore Town,2018,Under 1 year,0,0,0
Templemore Town,2019,1 - 4 years,0,0,0
Templemore Town,2019,10 - 14 years,0,0,0
Templemore Town,2019,15 - 19 years,0,0,0
Templemore Town,2019,20 - 24 years,0,0,0
Templemore Town,2019,25 - 29 years,0,0,0
Templemore Town,2019,30 - 34 years,0,1,1
Templemore Town,2019,35 - 39 years,0,0,0
Templemore Town,2019,40 - 44 years,0,0,0
Templemore Town,2019,45 - 49 years,0,0,0
Templemore Town,2019,5 - 9 years,0,0,0
Templemore Town,2019,50 - 54 years,1,0,1
Templemore Town,2019,55 - 59 years,1,0,1
Templemore Town,2019,60 - 64 years,2,0,2
Templemore Town,2019,65 - 69 years,1,1,2
Templemore Town,2019,70 - 74 years,1,2,3
Templemore Town,2019,75 - 79 years,0,3,3
Templemore Town,2019,80 - 84 years,6,2,8
Templemore Town,2019,85 years and over,2,7,9
Templemore Town,2019,Under 1 year,0,0,0
Templemore Town,2020,1 - 4 years,0,0,0
Templemore Town,2020,10 - 14 years,0,0,0
Templemore Town,2020,15 - 19 years,0,0,0
Templemore Town,2020,20 - 24 years,0,0,0
Templemore Town,2020,25 - 29 years,0,0,0
Templemore Town,2020,30 - 34 years,0,1,1
Templemore Town,2020,35 - 39 years,0,0,0
Templemore Town,2020,40 - 44 years,0,0,0
Templemore Town,2020,45 - 49 years,0,0,0
Templemore Town,2020,5 - 9 years,0,0,0
Templemore Town,2020,50 - 54 years,1,0,1
Templemore Town,2020,55 - 59 years,1,0,1
Templemore Town,2020,60 - 64 years,2,0,2
Templemore Town,2020,65 - 69 years,1,1,2
Templemore Town,2020,70 - 74 years,1,2,3
Templemore Town,2020,75 - 79 years,0,3,3
Templemore Town,2020,80 - 84 years,6,2,8
Templemore Town,2020,85 years and over,2,7,9
Templemore Town,2020,Under 1 year,0,0,0
Thurles Town,2007,1 - 4 years,0,0,0
Thurles Town,2007,10 - 14 years,0,0,0
Thurles Town,2007,15 - 19 years,0,0,0
Thurles Town,2007,20 - 24 years,1,1,2
Thurles Town,2007,25 - 29 years,0,2,2
Thurles Town,2007,30 - 34 years,0,2,2
Thurles Town,2007,35 - 39 years,0,0,0
Thurles Town,2007,40 - 44 years,0,1,1
Thurles Town,2007,45 - 49 years,1,0,1
Thurles Town,2007,5 - 9 years,1,0,1
Thurles Town,2007,50 - 54 years,1,2,3
Thurles Town,2007,55 - 59 years,1,3,4
Thurles Town,2007,60 - 64 years,6,8,14
Thurles Town,2007,65 - 69 years,5,6,11
Thurles Town,2007,70 - 74 years,13,6,19
Thurles Town,2007,75 - 79 years,10,11,21
Thurles Town,2007,80 - 84 years,12,15,27
Thurles Town,2007,85 years and over,33,12,45
Thurles Town,2007,Under 1 year,0,1,1
Thurles Town,2008,1 - 4 years,0,0,0
Thurles Town,2008,10 - 14 years,0,0,0
Thurles Town,2008,15 - 19 years,0,0,0
Thurles Town,2008,20 - 24 years,1,1,2
Thurles Town,2008,25 - 29 years,0,2,2
Thurles Town,2008,30 - 34 years,0,2,2
Thurles Town,2008,35 - 39 years,1,0,1
Thurles Town,2008,40 - 44 years,0,4,4
Thurles Town,2008,45 - 49 years,2,2,4
Thurles Town,2008,5 - 9 years,1,0,1
Thurles Town,2008,50 - 54 years,2,3,5
Thurles Town,2008,55 - 59 years,1,6,7
Thurles Town,2008,60 - 64 years,1,7,8
Thurles Town,2008,65 - 69 years,6,6,12
Thurles Town,2008,70 - 74 years,7,23,30
Thurles Town,2008,75 - 79 years,11,16,27
Thurles Town,2008,80 - 84 years,16,20,36
Thurles Town,2008,85 years and over,30,33,63
Thurles Town,2008,Under 1 year,0,2,2
Thurles Town,2009,1 - 4 years,0,0,0
Thurles Town,2009,10 - 14 years,0,0,0
Thurles Town,2009,15 - 19 years,0,0,0
Thurles Town,2009,20 - 24 years,1,1,2
Thurles Town,2009,25 - 29 years,0,1,1
Thurles Town,2009,30 - 34 years,0,1,1
Thurles Town,2009,35 - 39 years,1,0,1
Thurles Town,2009,40 - 44 years,0,1,1
Thurles Town,2009,45 - 49 years,1,1,2
Thurles Town,2009,5 - 9 years,1,0,1
Thurles Town,2009,50 - 54 years,2,3,5
Thurles Town,2009,55 - 59 years,2,3,5
Thurles Town,2009,60 - 64 years,3,3,6
Thurles Town,2009,65 - 69 years,5,4,9
Thurles Town,2009,70 - 74 years,3,2,5
Thurles Town,2009,75 - 79 years,5,5,10
Thurles Town,2009,80 - 84 years,9,5,14
Thurles Town,2009,85 years and over,13,7,20
Thurles Town,2009,Under 1 year,0,2,2
Thurles Town,2010,1 - 4 years,0,0,0
Thurles Town,2010,10 - 14 years,0,0,0
Thurles Town,2010,15 - 19 years,0,0,0
Thurles Town,2010,20 - 24 years,1,1,2
Thurles Town,2010,25 - 29 years,0,1,1
Thurles Town,2010,30 - 34 years,0,1,1
Thurles Town,2010,35 - 39 years,1,0,1
Thurles Town,2010,40 - 44 years,0,1,1
Thurles Town,2010,45 - 49 years,1,1,2
Thurles Town,2010,5 - 9 years,1,0,1
Thurles Town,2010,50 - 54 years,3,1,4
Thurles Town,2010,55 - 59 years,4,1,5
Thurles Town,2010,60 - 64 years,2,1,3
Thurles Town,2010,65 - 69 years,5,5,10
Thurles Town,2010,70 - 74 years,1,6,7
Thurles Town,2010,75 - 79 years,3,6,9
Thurles Town,2010,80 - 84 years,13,10,23
Thurles Town,2010,85 years and over,18,13,31
Thurles Town,2010,Under 1 year,0,2,2
Thurles Town,2011,1 - 4 years,0,0,0
Thurles Town,2011,10 - 14 years,0,0,0
Thurles Town,2011,15 - 19 years,0,0,0
Thurles Town,2011,20 - 24 years,0,1,1
Thurles Town,2011,25 - 29 years,1,0,1
Thurles Town,2011,30 - 34 years,0,0,0
Thurles Town,2011,35 - 39 years,0,0,0
Thurles Town,2011,40 - 44 years,0,0,0
Thurles Town,2011,45 - 49 years,0,0,0
Thurles Town,2011,5 - 9 years,0,0,0
Thurles Town,2011,50 - 54 years,2,1,3
Thurles Town,2011,55 - 59 years,2,2,4
Thurles Town,2011,60 - 64 years,0,7,7
Thurles Town,2011,65 - 69 years,1,2,3
Thurles Town,2011,70 - 74 years,0,2,2
Thurles Town,2011,75 - 79 years,4,10,14
Thurles Town,2011,80 - 84 years,3,3,6
Thurles Town,2011,85 years and over,20,6,26
Thurles Town,2011,Under 1 year,0,0,0
Thurles Town,2012,1 - 4 years,0,0,0
Thurles Town,2012,10 - 14 years,0,0,0
Thurles Town,2012,15 - 19 years,0,0,0
Thurles Town,2012,20 - 24 years,0,1,1
Thurles Town,2012,25 - 29 years,1,0,1
Thurles Town,2012,30 - 34 years,0,0,0
Thurles Town,2012,35 - 39 years,0,0,0
Thurles Town,2012,40 - 44 years,0,0,0
Thurles Town,2012,45 - 49 years,3,1,4
Thurles Town,2012,5 - 9 years,0,0,0
Thurles Town,2012,50 - 54 years,3,2,5
Thurles Town,2012,55 - 59 years,1,3,4
Thurles Town,2012,60 - 64 years,0,9,9
Thurles Town,2012,65 - 69 years,1,7,8
Thurles Town,2012,70 - 74 years,5,3,8
Thurles Town,2012,75 - 79 years,6,3,9
Thurles Town,2012,80 - 84 years,7,5,12
Thurles Town,2012,85 years and over,13,9,22
Thurles Town,2012,Under 1 year,1,0,1
Thurles Town,2013,1 - 4 years,0,0,0
Thurles Town,2013,10 - 14 years,0,0,0
Thurles Town,2013,15 - 19 years,1,0,1
Thurles Town,2013,20 - 24 years,0,1,1
Thurles Town,2013,25 - 29 years,0,0,0
Thurles Town,2013,30 - 34 years,0,0,0
Thurles Town,2013,35 - 39 years,0,0,0
Thurles Town,2013,40 - 44 years,0,0,0
Thurles Town,2013,45 - 49 years,0,0,0
Thurles Town,2013,5 - 9 years,0,0,0
Thurles Town,2013,50 - 54 years,1,0,1
Thurles Town,2013,55 - 59 years,3,4,7
Thurles Town,2013,60 - 64 years,2,3,5
Thurles Town,2013,65 - 69 years,1,4,5
Thurles Town,2013,70 - 74 years,2,3,5
Thurles Town,2013,75 - 79 years,6,5,11
Thurles Town,2013,80 - 84 years,9,8,17
Thurles Town,2013,85 years and over,22,4,26
Thurles Town,2013,Under 1 year,0,0,0
Thurles Town,2014,1 - 4 years,0,0,0
Thurles Town,2014,10 - 14 years,0,0,0
Thurles Town,2014,15 - 19 years,1,0,1
Thurles Town,2014,20 - 24 years,0,1,1
Thurles Town,2014,25 - 29 years,0,1,1
Thurles Town,2014,30 - 34 years,0,0,0
Thurles Town,2014,35 - 39 years,0,0,0
Thurles Town,2014,40 - 44 years,1,0,1
Thurles Town,2014,45 - 49 years,0,1,1
Thurles Town,2014,5 - 9 years,0,0,0
Thurles Town,2014,50 - 54 years,1,0,1
Thurles Town,2014,55 - 59 years,2,3,5
Thurles Town,2014,60 - 64 years,1,5,6
Thurles Town,2014,65 - 69 years,2,1,3
Thurles Town,2014,70 - 74 years,2,7,9
Thurles Town,2014,75 - 79 years,2,4,6
Thurles Town,2014,80 - 84 years,8,4,12
Thurles Town,2014,85 years and over,21,10,31
Thurles Town,2014,Under 1 year,0,1,1
Thurles Town,2015,1 - 4 years,0,0,0
Thurles Town,2015,10 - 14 years,0,0,0
Thurles Town,2015,15 - 19 years,1,0,1
Thurles Town,2015,20 - 24 years,0,1,1
Thurles Town,2015,25 - 29 years,0,1,1
Thurles Town,2015,30 - 34 years,0,0,0
Thurles Town,2015,35 - 39 years,0,0,0
Thurles Town,2015,40 - 44 years,1,0,1
Thurles Town,2015,45 - 49 years,0,1,1
Thurles Town,2015,5 - 9 years,0,0,0
Thurles Town,2015,50 - 54 years,1,0,1
Thurles Town,2015,55 - 59 years,2,3,5
Thurles Town,2015,60 - 64 years,1,5,6
Thurles Town,2015,65 - 69 years,2,1,3
Thurles Town,2015,70 - 74 years,2,7,9
Thurles Town,2015,75 - 79 years,2,4,6
Thurles Town,2015,80 - 84 years,8,4,12
Thurles Town,2015,85 years and over,21,10,31
Thurles Town,2015,Under 1 year,0,1,1
Thurles Town,2016,1 - 4 years,0,0,0
Thurles Town,2016,10 - 14 years,0,0,0
Thurles Town,2016,15 - 19 years,1,0,1
Thurles Town,2016,20 - 24 years,0,1,1
Thurles Town,2016,25 - 29 years,0,1,1
Thurles Town,2016,30 - 34 years,0,0,0
Thurles Town,2016,35 - 39 years,0,0,0
Thurles Town,2016,40 - 44 years,1,0,1
Thurles Town,2016,45 - 49 years,0,1,1
Thurles Town,2016,5 - 9 years,0,0,0
Thurles Town,2016,50 - 54 years,1,0,1
Thurles Town,2016,55 - 59 years,2,3,5
Thurles Town,2016,60 - 64 years,1,5,6
Thurles Town,2016,65 - 69 years,2,1,3
Thurles Town,2016,70 - 74 years,2,7,9
Thurles Town,2016,75 - 79 years,2,4,6
Thurles Town,2016,80 - 84 years,8,4,12
Thurles Town,2016,85 years and over,21,10,31
Thurles Town,2016,Under 1 year,0,1,1
Thurles Town,2017,1 - 4 years,0,0,0
Thurles Town,2017,10 - 14 years,1,0,1
Thurles Town,2017,15 - 19 years,1,0,1
Thurles Town,2017,20 - 24 years,0,1,1
Thurles Town,2017,25 - 29 years,0,1,1
Thurles Town,2017,30 - 34 years,0,0,0
Thurles Town,2017,35 - 39 years,0,0,0
Thurles Town,2017,40 - 44 years,1,0,1
Thurles Town,2017,45 - 49 years,0,1,1
Thurles Town,2017,5 - 9 years,0,0,0
Thurles Town,2017,50 - 54 years,1,0,1
Thurles Town,2017,55 - 59 years,2,2,4
Thurles Town,2017,60 - 64 years,2,4,6
Thurles Town,2017,65 - 69 years,1,4,5
Thurles Town,2017,70 - 74 years,5,5,10
Thurles Town,2017,75 - 79 years,2,4,6
Thurles Town,2017,80 - 84 years,6,6,12
Thurles Town,2017,85 years and over,6,14,20
Thurles Town,2017,Under 1 year,0,1,1
Thurles Town,2018,1 - 4 years,0,0,0
Thurles Town,2018,10 - 14 years,0,0,0
Thurles Town,2018,15 - 19 years,0,0,0
Thurles Town,2018,20 - 24 years,0,0,0
Thurles Town,2018,25 - 29 years,0,0,0
Thurles Town,2018,30 - 34 years,0,0,0
Thurles Town,2018,35 - 39 years,0,0,0
Thurles Town,2018,40 - 44 years,0,2,2
Thurles Town,2018,45 - 49 years,0,1,1
Thurles Town,2018,5 - 9 years,0,0,0
Thurles Town,2018,50 - 54 years,2,0,2
Thurles Town,2018,55 - 59 years,1,5,6
Thurles Town,2018,60 - 64 years,4,4,8
Thurles Town,2018,65 - 69 years,7,5,12
Thurles Town,2018,70 - 74 years,5,4,9
Thurles Town,2018,75 - 79 years,3,6,9
Thurles Town,2018,80 - 84 years,5,11,16
Thurles Town,2018,85 years and over,16,11,27
Thurles Town,2018,Under 1 year,0,0,0
Thurles Town,2019,1 - 4 years,0,0,0
Thurles Town,2019,10 - 14 years,0,0,0
Thurles Town,2019,15 - 19 years,0,0,0
Thurles Town,2019,20 - 24 years,0,0,0
Thurles Town,2019,25 - 29 years,0,0,0
Thurles Town,2019,30 - 34 years,0,0,0
Thurles Town,2019,35 - 39 years,0,0,0
Thurles Town,2019,40 - 44 years,0,2,2
Thurles Town,2019,45 - 49 years,0,1,1
Thurles Town,2019,5 - 9 years,0,0,0
Thurles Town,2019,50 - 54 years,2,0,2
Thurles Town,2019,55 - 59 years,1,5,6
Thurles Town,2019,60 - 64 years,4,4,8
Thurles Town,2019,65 - 69 years,7,5,12
Thurles Town,2019,70 - 74 years,5,4,9
Thurles Town,2019,75 - 79 years,3,6,9
Thurles Town,2019,80 - 84 years,5,11,16
Thurles Town,2019,85 years and over,16,11,27
Thurles Town,2019,Under 1 year,0,0,0
Thurles Town,2020,1 - 4 years,0,0,0
Thurles Town,2020,10 - 14 years,0,0,0
Thurles Town,2020,15 - 19 years,0,0,0
Thurles Town,2020,20 - 24 years,0,0,0
Thurles Town,2020,25 - 29 years,0,0,0
Thurles Town,2020,30 - 34 years,0,0,0
Thurles Town,2020,35 - 39 years,0,0,0
Thurles Town,2020,40 - 44 years,0,2,2
Thurles Town,2020,45 - 49 years,0,1,1
Thurles Town,2020,5 - 9 years,0,0,0
Thurles Town,2020,50 - 54 years,2,0,2
Thurles Town,2020,55 - 59 years,1,5,6
Thurles Town,2020,60 - 64 years,4,4,8
Thurles Town,2020,65 - 69 years,7,5,12
Thurles Town,2020,70 - 74 years,5,4,9
Thurles Town,2020,75 - 79 years,3,6,9
Thurles Town,2020,80 - 84 years,5,11,16
Thurles Town,2020,85 years and over,16,11,27
Thurles Town,2020,Under 1 year,0,0,0
Tipperary Town,2007,1 - 4 years,0,0,0
Tipperary Town,2007,10 - 14 years,0,0,0
Tipperary Town,2007,15 - 19 years,0,0,0
Tipperary Town,2007,20 - 24 years,0,0,0
Tipperary Town,2007,25 - 29 years,0,0,0
Tipperary Town,2007,30 - 34 years,0,0,0
Tipperary Town,2007,35 - 39 years,1,1,2
Tipperary Town,2007,40 - 44 years,0,0,0
Tipperary Town,2007,45 - 49 years,1,0,1
Tipperary Town,2007,5 - 9 years,0,0,0
Tipperary Town,2007,50 - 54 years,1,2,3
Tipperary Town,2007,55 - 59 years,0,2,2
Tipperary Town,2007,60 - 64 years,2,0,2
Tipperary Town,2007,65 - 69 years,2,0,2
Tipperary Town,2007,70 - 74 years,5,3,8
Tipperary Town,2007,75 - 79 years,4,5,9
Tipperary Town,2007,80 - 84 years,7,6,13
Tipperary Town,2007,85 years and over,10,6,16
Tipperary Town,2007,Under 1 year,0,1,1
Tipperary Town,2008,1 - 4 years,0,0,0
Tipperary Town,2008,10 - 14 years,0,0,0
Tipperary Town,2008,15 - 19 years,0,0,0
Tipperary Town,2008,20 - 24 years,0,0,0
Tipperary Town,2008,25 - 29 years,0,0,0
Tipperary Town,2008,30 - 34 years,1,1,2
Tipperary Town,2008,35 - 39 years,1,1,2
Tipperary Town,2008,40 - 44 years,0,0,0
Tipperary Town,2008,45 - 49 years,1,0,1
Tipperary Town,2008,5 - 9 years,0,0,0
Tipperary Town,2008,50 - 54 years,1,2,3
Tipperary Town,2008,55 - 59 years,0,2,2
Tipperary Town,2008,60 - 64 years,2,3,5
Tipperary Town,2008,65 - 69 years,2,5,7
Tipperary Town,2008,70 - 74 years,2,4,6
Tipperary Town,2008,75 - 79 years,4,7,11
Tipperary Town,2008,80 - 84 years,8,4,12
Tipperary Town,2008,85 years and over,7,8,15
Tipperary Town,2008,Under 1 year,0,1,1
Tipperary Town,2009,1 - 4 years,0,0,0
Tipperary Town,2009,10 - 14 years,0,0,0
Tipperary Town,2009,15 - 19 years,0,0,0
Tipperary Town,2009,20 - 24 years,0,0,0
Tipperary Town,2009,25 - 29 years,1,0,1
Tipperary Town,2009,30 - 34 years,1,1,2
Tipperary Town,2009,35 - 39 years,1,1,2
Tipperary Town,2009,40 - 44 years,0,0,0
Tipperary Town,2009,45 - 49 years,1,0,1
Tipperary Town,2009,5 - 9 years,0,0,0
Tipperary Town,2009,50 - 54 years,1,3,4
Tipperary Town,2009,55 - 59 years,2,2,4
Tipperary Town,2009,60 - 64 years,2,3,5
Tipperary Town,2009,65 - 69 years,2,2,4
Tipperary Town,2009,70 - 74 years,2,3,5
Tipperary Town,2009,75 - 79 years,4,5,9
Tipperary Town,2009,80 - 84 years,2,5,7
Tipperary Town,2009,85 years and over,5,6,11
Tipperary Town,2009,Under 1 year,1,1,2
Tipperary Town,2010,1 - 4 years,0,0,0
Tipperary Town,2010,10 - 14 years,0,0,0
Tipperary Town,2010,15 - 19 years,0,0,0
Tipperary Town,2010,20 - 24 years,0,0,0
Tipperary Town,2010,25 - 29 years,1,0,1
Tipperary Town,2010,30 - 34 years,1,1,2
Tipperary Town,2010,35 - 39 years,1,1,2
Tipperary Town,2010,40 - 44 years,0,0,0
Tipperary Town,2010,45 - 49 years,1,1,2
Tipperary Town,2010,5 - 9 years,0,1,1
Tipperary Town,2010,50 - 54 years,1,1,2
Tipperary Town,2010,55 - 59 years,2,1,3
Tipperary Town,2010,60 - 64 years,1,1,2
Tipperary Town,2010,65 - 69 years,5,5,10
Tipperary Town,2010,70 - 74 years,2,5,7
Tipperary Town,2010,75 - 79 years,3,4,7
Tipperary Town,2010,80 - 84 years,8,5,13
Tipperary Town,2010,85 years and over,10,7,17
Tipperary Town,2010,Under 1 year,1,1,2
Tipperary Town,2011,1 - 4 years,0,0,0
Tipperary Town,2011,10 - 14 years,0,0,0
Tipperary Town,2011,15 - 19 years,0,0,0
Tipperary Town,2011,20 - 24 years,0,0,0
Tipperary Town,2011,25 - 29 years,0,0,0
Tipperary Town,2011,30 - 34 years,0,0,0
Tipperary Town,2011,35 - 39 years,0,0,0
Tipperary Town,2011,40 - 44 years,0,1,1
Tipperary Town,2011,45 - 49 years,0,3,3
Tipperary Town,2011,5 - 9 years,0,0,0
Tipperary Town,2011,50 - 54 years,0,1,1
Tipperary Town,2011,55 - 59 years,0,0,0
Tipperary Town,2011,60 - 64 years,0,2,2
Tipperary Town,2011,65 - 69 years,2,1,3
Tipperary Town,2011,70 - 74 years,0,5,5
Tipperary Town,2011,75 - 79 years,2,0,2
Tipperary Town,2011,80 - 84 years,3,2,5
Tipperary Town,2011,85 years and over,16,1,17
Tipperary Town,2011,Under 1 year,0,0,0
Tipperary Town,2012,1 - 4 years,0,0,0
Tipperary Town,2012,10 - 14 years,0,0,0
Tipperary Town,2012,15 - 19 years,0,0,0
Tipperary Town,2012,20 - 24 years,0,0,0
Tipperary Town,2012,25 - 29 years,0,1,1
Tipperary Town,2012,30 - 34 years,0,0,0
Tipperary Town,2012,35 - 39 years,0,1,1
Tipperary Town,2012,40 - 44 years,0,1,1
Tipperary Town,2012,45 - 49 years,0,3,3
Tipperary Town,2012,5 - 9 years,0,0,0
Tipperary Town,2012,50 - 54 years,0,1,1
Tipperary Town,2012,55 - 59 years,3,1,4
Tipperary Town,2012,60 - 64 years,2,4,6
Tipperary Town,2012,65 - 69 years,1,1,2
Tipperary Town,2012,70 - 74 years,1,5,6
Tipperary Town,2012,75 - 79 years,7,5,12
Tipperary Town,2012,80 - 84 years,2,6,8
Tipperary Town,2012,85 years and over,14,11,25
Tipperary Town,2012,Under 1 year,0,0,0
Tipperary Town,2013,1 - 4 years,0,0,0
Tipperary Town,2013,10 - 14 years,0,0,0
Tipperary Town,2013,15 - 19 years,0,0,0
Tipperary Town,2013,20 - 24 years,0,0,0
Tipperary Town,2013,25 - 29 years,0,0,0
Tipperary Town,2013,30 - 34 years,0,0,0
Tipperary Town,2013,35 - 39 years,0,0,0
Tipperary Town,2013,40 - 44 years,0,0,0
Tipperary Town,2013,45 - 49 years,0,1,1
Tipperary Town,2013,5 - 9 years,0,0,0
Tipperary Town,2013,50 - 54 years,2,0,2
Tipperary Town,2013,55 - 59 years,0,0,0
Tipperary Town,2013,60 - 64 years,2,1,3
Tipperary Town,2013,65 - 69 years,2,3,5
Tipperary Town,2013,70 - 74 years,3,1,4
Tipperary Town,2013,75 - 79 years,3,3,6
Tipperary Town,2013,80 - 84 years,3,1,4
Tipperary Town,2013,85 years and over,13,8,21
Tipperary Town,2013,Under 1 year,0,0,0
Tipperary Town,2014,1 - 4 years,0,0,0
Tipperary Town,2014,10 - 14 years,0,0,0
Tipperary Town,2014,15 - 19 years,0,0,0
Tipperary Town,2014,20 - 24 years,0,0,0
Tipperary Town,2014,25 - 29 years,0,0,0
Tipperary Town,2014,30 - 34 years,0,0,0
Tipperary Town,2014,35 - 39 years,0,0,0
Tipperary Town,2014,40 - 44 years,1,0,1
Tipperary Town,2014,45 - 49 years,1,1,2
Tipperary Town,2014,5 - 9 years,0,0,0
Tipperary Town,2014,50 - 54 years,1,1,2
Tipperary Town,2014,55 - 59 years,1,1,2
Tipperary Town,2014,60 - 64 years,3,2,5
Tipperary Town,2014,65 - 69 years,2,9,11
Tipperary Town,2014,70 - 74 years,4,4,8
Tipperary Town,2014,75 - 79 years,3,2,5
Tipperary Town,2014,80 - 84 years,3,8,11
Tipperary Town,2014,85 years and over,17,6,23
Tipperary Town,2014,Under 1 year,0,0,0
Tipperary Town,2015,1 - 4 years,0,0,0
Tipperary Town,2015,10 - 14 years,0,0,0
Tipperary Town,2015,15 - 19 years,0,0,0
Tipperary Town,2015,20 - 24 years,0,0,0
Tipperary Town,2015,25 - 29 years,0,0,0
Tipperary Town,2015,30 - 34 years,0,0,0
Tipperary Town,2015,35 - 39 years,0,0,0
Tipperary Town,2015,40 - 44 years,1,0,1
Tipperary Town,2015,45 - 49 years,1,1,2
Tipperary Town,2015,5 - 9 years,0,0,0
Tipperary Town,2015,50 - 54 years,1,1,2
Tipperary Town,2015,55 - 59 years,1,1,2
Tipperary Town,2015,60 - 64 years,3,2,5
Tipperary Town,2015,65 - 69 years,2,9,11
Tipperary Town,2015,70 - 74 years,4,4,8
Tipperary Town,2015,75 - 79 years,3,2,5
Tipperary Town,2015,80 - 84 years,3,8,11
Tipperary Town,2015,85 years and over,17,6,23
Tipperary Town,2015,Under 1 year,0,0,0
Tipperary Town,2016,1 - 4 years,0,0,0
Tipperary Town,2016,10 - 14 years,0,0,0
Tipperary Town,2016,15 - 19 years,0,0,0
Tipperary Town,2016,20 - 24 years,0,0,0
Tipperary Town,2016,25 - 29 years,0,0,0
Tipperary Town,2016,30 - 34 years,0,0,0
Tipperary Town,2016,35 - 39 years,0,0,0
Tipperary Town,2016,40 - 44 years,1,0,1
Tipperary Town,2016,45 - 49 years,1,1,2
Tipperary Town,2016,5 - 9 years,0,0,0
Tipperary Town,2016,50 - 54 years,1,1,2
Tipperary Town,2016,55 - 59 years,1,1,2
Tipperary Town,2016,60 - 64 years,3,2,5
Tipperary Town,2016,65 - 69 years,2,9,11
Tipperary Town,2016,70 - 74 years,4,4,8
Tipperary Town,2016,75 - 79 years,3,2,5
Tipperary Town,2016,80 - 84 years,3,8,11
Tipperary Town,2016,85 years and over,17,6,23
Tipperary Town,2016,Under 1 year,0,0,0
Tipperary Town,2017,1 - 4 years,0,0,0
Tipperary Town,2017,10 - 14 years,0,0,0
Tipperary Town,2017,15 - 19 years,0,0,0
Tipperary Town,2017,20 - 24 years,0,0,0
Tipperary Town,2017,25 - 29 years,0,0,0
Tipperary Town,2017,30 - 34 years,0,1,1
Tipperary Town,2017,35 - 39 years,0,0,0
Tipperary Town,2017,40 - 44 years,1,0,1
Tipperary Town,2017,45 - 49 years,1,1,2
Tipperary Town,2017,5 - 9 years,0,0,0
Tipperary Town,2017,50 - 54 years,1,1,2
Tipperary Town,2017,55 - 59 years,1,1,2
Tipperary Town,2017,60 - 64 years,1,3,4
Tipperary Town,2017,65 - 69 years,6,2,8
Tipperary Town,2017,70 - 74 years,1,6,7
Tipperary Town,2017,75 - 79 years,5,7,12
Tipperary Town,2017,80 - 84 years,5,5,10
Tipperary Town,2017,85 years and over,11,12,23
Tipperary Town,2017,Under 1 year,0,1,1
Tipperary Town,2018,1 - 4 years,0,0,0
Tipperary Town,2018,10 - 14 years,0,0,0
Tipperary Town,2018,15 - 19 years,0,0,0
Tipperary Town,2018,20 - 24 years,0,0,0
Tipperary Town,2018,25 - 29 years,0,0,0
Tipperary Town,2018,30 - 34 years,0,0,0
Tipperary Town,2018,35 - 39 years,0,0,0
Tipperary Town,2018,40 - 44 years,0,0,0
Tipperary Town,2018,45 - 49 years,1,0,1
Tipperary Town,2018,5 - 9 years,0,0,0
Tipperary Town,2018,50 - 54 years,0,0,0
Tipperary Town,2018,55 - 59 years,2,1,3
Tipperary Town,2018,60 - 64 years,0,3,3
Tipperary Town,2018,65 - 69 years,2,3,5
Tipperary Town,2018,70 - 74 years,4,2,6
Tipperary Town,2018,75 - 79 years,5,5,10
Tipperary Town,2018,80 - 84 years,5,8,13
Tipperary Town,2018,85 years and over,8,3,11
Tipperary Town,2018,Under 1 year,0,0,0
Tipperary Town,2019,1 - 4 years,0,0,0
Tipperary Town,2019,10 - 14 years,0,0,0
Tipperary Town,2019,15 - 19 years,0,0,0
Tipperary Town,2019,20 - 24 years,0,0,0
Tipperary Town,2019,25 - 29 years,0,0,0
Tipperary Town,2019,30 - 34 years,0,0,0
Tipperary Town,2019,35 - 39 years,0,0,0
Tipperary Town,2019,40 - 44 years,0,0,0
Tipperary Town,2019,45 - 49 years,1,0,1
Tipperary Town,2019,5 - 9 years,0,0,0
Tipperary Town,2019,50 - 54 years,0,0,0
Tipperary Town,2019,55 - 59 years,2,1,3
Tipperary Town,2019,60 - 64 years,0,3,3
Tipperary Town,2019,65 - 69 years,2,3,5
Tipperary Town,2019,70 - 74 years,4,2,6
Tipperary Town,2019,75 - 79 years,5,5,10
Tipperary Town,2019,80 - 84 years,5,8,13
Tipperary Town,2019,85 years and over,8,3,11
Tipperary Town,2019,Under 1 year,0,0,0
Tipperary Town,2020,1 - 4 years,0,0,0
Tipperary Town,2020,10 - 14 years,0,0,0
Tipperary Town,2020,15 - 19 years,0,0,0
Tipperary Town,2020,20 - 24 years,0,0,0
Tipperary Town,2020,25 - 29 years,0,0,0
Tipperary Town,2020,30 - 34 years,0,0,0
Tipperary Town,2020,35 - 39 years,0,0,0
Tipperary Town,2020,40 - 44 years,0,0,0
Tipperary Town,2020,45 - 49 years,1,0,1
Tipperary Town,2020,5 - 9 years,0,0,0
Tipperary Town,2020,50 - 54 years,0,0,0
Tipperary Town,2020,55 - 59 years,2,1,3
Tipperary Town,2020,60 - 64 years,0,3,3
Tipperary Town,2020,65 - 69 years,2,3,5
Tipperary Town,2020,70 - 74 years,4,2,6
Tipperary Town,2020,75 - 79 years,5,5,10
Tipperary Town,2020,80 - 84 years,5,8,13
Tipperary Town,2020,85 years and over,8,3,11
Tipperary Town,2020,Under 1 year,0,0,0
Tralee Town,2007,1 - 4 years,0,0,0
Tralee Town,2007,10 - 14 years,1,1,2
Tralee Town,2007,15 - 19 years,0,1,1
Tralee Town,2007,20 - 24 years,0,1,1
Tralee Town,2007,25 - 29 years,0,1,1
Tralee Town,2007,30 - 34 years,0,1,1
Tralee Town,2007,35 - 39 years,0,1,1
Tralee Town,2007,40 - 44 years,1,1,2
Tralee Town,2007,45 - 49 years,2,3,5
Tralee Town,2007,5 - 9 years,0,0,0
Tralee Town,2007,50 - 54 years,2,4,6
Tralee Town,2007,55 - 59 years,2,4,6
Tralee Town,2007,60 - 64 years,3,10,13
Tralee Town,2007,65 - 69 years,6,10,16
Tralee Town,2007,70 - 74 years,17,12,29
Tralee Town,2007,75 - 79 years,14,17,31
Tralee Town,2007,80 - 84 years,18,28,46
Tralee Town,2007,85 years and over,37,12,49
Tralee Town,2007,Under 1 year,1,0,1
Tralee Town,2008,1 - 4 years,1,2,3
Tralee Town,2008,10 - 14 years,1,1,2
Tralee Town,2008,15 - 19 years,0,1,1
Tralee Town,2008,20 - 24 years,0,1,1
Tralee Town,2008,25 - 29 years,0,1,1
Tralee Town,2008,30 - 34 years,0,1,1
Tralee Town,2008,35 - 39 years,2,1,3
Tralee Town,2008,40 - 44 years,1,3,4
Tralee Town,2008,45 - 49 years,2,4,6
Tralee Town,2008,5 - 9 years,0,0,0
Tralee Town,2008,50 - 54 years,1,8,9
Tralee Town,2008,55 - 59 years,3,2,5
Tralee Town,2008,60 - 64 years,4,10,14
Tralee Town,2008,65 - 69 years,3,10,13
Tralee Town,2008,70 - 74 years,7,14,21
Tralee Town,2008,75 - 79 years,18,17,35
Tralee Town,2008,80 - 84 years,17,21,38
Tralee Town,2008,85 years and over,31,27,58
Tralee Town,2008,Under 1 year,1,2,3
Tralee Town,2009,1 - 4 years,1,2,3
Tralee Town,2009,10 - 14 years,1,1,2
Tralee Town,2009,15 - 19 years,0,1,1
Tralee Town,2009,20 - 24 years,0,2,2
Tralee Town,2009,25 - 29 years,0,3,3
Tralee Town,2009,30 - 34 years,0,1,1
Tralee Town,2009,35 - 39 years,1,1,2
Tralee Town,2009,40 - 44 years,1,3,4
Tralee Town,2009,45 - 49 years,2,4,6
Tralee Town,2009,5 - 9 years,0,0,0
Tralee Town,2009,50 - 54 years,3,2,5
Tralee Town,2009,55 - 59 years,2,2,4
Tralee Town,2009,60 - 64 years,6,2,8
Tralee Town,2009,65 - 69 years,4,8,12
Tralee Town,2009,70 - 74 years,7,9,16
Tralee Town,2009,75 - 79 years,11,9,20
Tralee Town,2009,80 - 84 years,21,17,38
Tralee Town,2009,85 years and over,26,15,41
Tralee Town,2009,Under 1 year,1,2,3
Tralee Town,2010,1 - 4 years,1,2,3
Tralee Town,2010,10 - 14 years,1,1,2
Tralee Town,2010,15 - 19 years,0,1,1
Tralee Town,2010,20 - 24 years,0,1,1
Tralee Town,2010,25 - 29 years,0,3,3
Tralee Town,2010,30 - 34 years,1,1,2
Tralee Town,2010,35 - 39 years,1,2,3
Tralee Town,2010,40 - 44 years,1,1,2
Tralee Town,2010,45 - 49 years,1,4,5
Tralee Town,2010,5 - 9 years,0,0,0
Tralee Town,2010,50 - 54 years,1,3,4
Tralee Town,2010,55 - 59 years,3,4,7
Tralee Town,2010,60 - 64 years,3,11,14
Tralee Town,2010,65 - 69 years,10,7,17
Tralee Town,2010,70 - 74 years,5,11,16
Tralee Town,2010,75 - 79 years,8,8,16
Tralee Town,2010,80 - 84 years,17,10,27
Tralee Town,2010,85 years and over,31,16,47
Tralee Town,2010,Under 1 year,1,1,2
Tralee Town,2011,1 - 4 years,0,1,1
Tralee Town,2011,10 - 14 years,0,0,0
Tralee Town,2011,15 - 19 years,2,1,3
Tralee Town,2011,20 - 24 years,0,2,2
Tralee Town,2011,25 - 29 years,1,3,4
Tralee Town,2011,30 - 34 years,0,0,0
Tralee Town,2011,35 - 39 years,1,2,3
Tralee Town,2011,40 - 44 years,0,1,1
Tralee Town,2011,45 - 49 years,1,0,1
Tralee Town,2011,5 - 9 years,0,0,0
Tralee Town,2011,50 - 54 years,3,3,6
Tralee Town,2011,55 - 59 years,3,2,5
Tralee Town,2011,60 - 64 years,8,6,14
Tralee Town,2011,65 - 69 years,4,7,11
Tralee Town,2011,70 - 74 years,3,12,15
Tralee Town,2011,75 - 79 years,14,9,23
Tralee Town,2011,80 - 84 years,9,10,19
Tralee Town,2011,85 years and over,23,12,35
Tralee Town,2011,Under 1 year,0,0,0
Tralee Town,2012,1 - 4 years,0,1,1
Tralee Town,2012,10 - 14 years,0,0,0
Tralee Town,2012,15 - 19 years,2,1,3
Tralee Town,2012,20 - 24 years,1,5,6
Tralee Town,2012,25 - 29 years,1,1,2
Tralee Town,2012,30 - 34 years,1,0,1
Tralee Town,2012,35 - 39 years,1,2,3
Tralee Town,2012,40 - 44 years,2,3,5
Tralee Town,2012,45 - 49 years,3,1,4
Tralee Town,2012,5 - 9 years,0,0,0
Tralee Town,2012,50 - 54 years,3,1,4
Tralee Town,2012,55 - 59 years,3,7,10
Tralee Town,2012,60 - 64 years,5,7,12
Tralee Town,2012,65 - 69 years,4,9,13
Tralee Town,2012,70 - 74 years,10,6,16
Tralee Town,2012,75 - 79 years,16,14,30
Tralee Town,2012,80 - 84 years,17,16,33
Tralee Town,2012,85 years and over,40,20,60
Tralee Town,2012,Under 1 year,1,0,1
Tralee Town,2013,1 - 4 years,0,0,0
Tralee Town,2013,10 - 14 years,0,0,0
Tralee Town,2013,15 - 19 years,1,1,2
Tralee Town,2013,20 - 24 years,0,2,2
Tralee Town,2013,25 - 29 years,3,2,5
Tralee Town,2013,30 - 34 years,0,1,1
Tralee Town,2013,35 - 39 years,0,1,1
Tralee Town,2013,40 - 44 years,0,1,1
Tralee Town,2013,45 - 49 years,5,1,6
Tralee Town,2013,5 - 9 years,0,0,0
Tralee Town,2013,50 - 54 years,2,3,5
Tralee Town,2013,55 - 59 years,6,6,12
Tralee Town,2013,60 - 64 years,2,6,8
Tralee Town,2013,65 - 69 years,6,7,13
Tralee Town,2013,70 - 74 years,9,10,19
Tralee Town,2013,75 - 79 years,11,11,22
Tralee Town,2013,80 - 84 years,12,11,23
Tralee Town,2013,85 years and over,33,19,52
Tralee Town,2013,Under 1 year,0,1,1
Tralee Town,2014,1 - 4 years,0,0,0
Tralee Town,2014,10 - 14 years,0,0,0
Tralee Town,2014,15 - 19 years,1,1,2
Tralee Town,2014,20 - 24 years,1,2,3
Tralee Town,2014,25 - 29 years,1,1,2
Tralee Town,2014,30 - 34 years,1,1,2
Tralee Town,2014,35 - 39 years,1,1,2
Tralee Town,2014,40 - 44 years,0,4,4
Tralee Town,2014,45 - 49 years,1,2,3
Tralee Town,2014,5 - 9 years,0,0,0
Tralee Town,2014,50 - 54 years,4,3,7
Tralee Town,2014,55 - 59 years,6,4,10
Tralee Town,2014,60 - 64 years,8,6,14
Tralee Town,2014,65 - 69 years,6,9,15
Tralee Town,2014,70 - 74 years,15,13,28
Tralee Town,2014,75 - 79 years,14,16,30
Tralee Town,2014,80 - 84 years,15,22,37
Tralee Town,2014,85 years and over,32,14,46
Tralee Town,2014,Under 1 year,1,1,2
Tralee Town,2015,1 - 4 years,0,0,0
Tralee Town,2015,10 - 14 years,0,0,0
Tralee Town,2015,15 - 19 years,1,1,2
Tralee Town,2015,20 - 24 years,1,2,3
Tralee Town,2015,25 - 29 years,1,1,2
Tralee Town,2015,30 - 34 years,1,1,2
Tralee Town,2015,35 - 39 years,1,1,2
Tralee Town,2015,40 - 44 years,0,4,4
Tralee Town,2015,45 - 49 years,1,2,3
Tralee Town,2015,5 - 9 years,0,0,0
Tralee Town,2015,50 - 54 years,4,3,7
Tralee Town,2015,55 - 59 years,6,4,10
Tralee Town,2015,60 - 64 years,8,6,14
Tralee Town,2015,65 - 69 years,6,9,15
Tralee Town,2015,70 - 74 years,15,13,28
Tralee Town,2015,75 - 79 years,14,16,30
Tralee Town,2015,80 - 84 years,15,22,37
Tralee Town,2015,85 years and over,32,14,46
Tralee Town,2015,Under 1 year,1,1,2
Tralee Town,2016,1 - 4 years,0,0,0
Tralee Town,2016,10 - 14 years,0,0,0
Tralee Town,2016,15 - 19 years,1,1,2
Tralee Town,2016,20 - 24 years,1,2,3
Tralee Town,2016,25 - 29 years,1,1,2
Tralee Town,2016,30 - 34 years,1,1,2
Tralee Town,2016,35 - 39 years,1,1,2
Tralee Town,2016,40 - 44 years,0,4,4
Tralee Town,2016,45 - 49 years,1,2,3
Tralee Town,2016,5 - 9 years,0,0,0
Tralee Town,2016,50 - 54 years,4,3,7
Tralee Town,2016,55 - 59 years,6,4,10
Tralee Town,2016,60 - 64 years,8,6,14
Tralee Town,2016,65 - 69 years,6,9,15
Tralee Town,2016,70 - 74 years,15,13,28
Tralee Town,2016,75 - 79 years,14,16,30
Tralee Town,2016,80 - 84 years,15,22,37
Tralee Town,2016,85 years and over,32,14,46
Tralee Town,2016,Under 1 year,1,1,2
Tralee Town,2017,1 - 4 years,0,0,0
Tralee Town,2017,10 - 14 years,0,0,0
Tralee Town,2017,15 - 19 years,1,1,2
Tralee Town,2017,20 - 24 years,1,2,3
Tralee Town,2017,25 - 29 years,1,1,2
Tralee Town,2017,30 - 34 years,1,1,2
Tralee Town,2017,35 - 39 years,1,1,2
Tralee Town,2017,40 - 44 years,0,4,4
Tralee Town,2017,45 - 49 years,1,2,3
Tralee Town,2017,5 - 9 years,0,0,0
Tralee Town,2017,50 - 54 years,4,7,11
Tralee Town,2017,55 - 59 years,4,4,8
Tralee Town,2017,60 - 64 years,6,3,9
Tralee Town,2017,65 - 69 years,1,5,6
Tralee Town,2017,70 - 74 years,11,11,22
Tralee Town,2017,75 - 79 years,9,17,26
Tralee Town,2017,80 - 84 years,12,20,32
Tralee Town,2017,85 years and over,43,24,67
Tralee Town,2017,Under 1 year,1,1,2
Tralee Town,2018,1 - 4 years,0,0,0
Tralee Town,2018,10 - 14 years,0,0,0
Tralee Town,2018,15 - 19 years,0,0,0
Tralee Town,2018,20 - 24 years,0,1,1
Tralee Town,2018,25 - 29 years,0,2,2
Tralee Town,2018,30 - 34 years,0,3,3
Tralee Town,2018,35 - 39 years,0,2,2
Tralee Town,2018,40 - 44 years,0,3,3
Tralee Town,2018,45 - 49 years,1,3,4
Tralee Town,2018,5 - 9 years,0,0,0
Tralee Town,2018,50 - 54 years,3,8,11
Tralee Town,2018,55 - 59 years,5,5,10
Tralee Town,2018,60 - 64 years,7,9,16
Tralee Town,2018,65 - 69 years,7,10,17
Tralee Town,2018,70 - 74 years,9,17,26
Tralee Town,2018,75 - 79 years,14,21,35
Tralee Town,2018,80 - 84 years,19,14,33
Tralee Town,2018,85 years and over,44,18,62
Tralee Town,2018,Under 1 year,0,0,0
Tralee Town,2019,1 - 4 years,0,0,0
Tralee Town,2019,10 - 14 years,0,0,0
Tralee Town,2019,15 - 19 years,0,0,0
Tralee Town,2019,20 - 24 years,0,1,1
Tralee Town,2019,25 - 29 years,0,2,2
Tralee Town,2019,30 - 34 years,0,3,3
Tralee Town,2019,35 - 39 years,0,2,2
Tralee Town,2019,40 - 44 years,0,3,3
Tralee Town,2019,45 - 49 years,1,3,4
Tralee Town,2019,5 - 9 years,0,0,0
Tralee Town,2019,50 - 54 years,3,8,11
Tralee Town,2019,55 - 59 years,5,5,10
Tralee Town,2019,60 - 64 years,7,9,16
Tralee Town,2019,65 - 69 years,7,10,17
Tralee Town,2019,70 - 74 years,9,17,26
Tralee Town,2019,75 - 79 years,14,21,35
Tralee Town,2019,80 - 84 years,19,14,33
Tralee Town,2019,85 years and over,44,18,62
Tralee Town,2019,Under 1 year,0,0,0
Tralee Town,2020,1 - 4 years,0,0,0
Tralee Town,2020,10 - 14 years,0,0,0
Tralee Town,2020,15 - 19 years,0,0,0
Tralee Town,2020,20 - 24 years,0,1,1
Tralee Town,2020,25 - 29 years,0,2,2
Tralee Town,2020,30 - 34 years,0,3,3
Tralee Town,2020,35 - 39 years,0,2,2
Tralee Town,2020,40 - 44 years,0,3,3
Tralee Town,2020,45 - 49 years,1,3,4
Tralee Town,2020,5 - 9 years,0,0,0
Tralee Town,2020,50 - 54 years,3,8,11
Tralee Town,2020,55 - 59 years,5,5,10
Tralee Town,2020,60 - 64 years,7,9,16
Tralee Town,2020,65 - 69 years,7,10,17
Tralee Town,2020,70 - 74 years,9,17,26
Tralee Town,2020,75 - 79 years,14,21,35
Tralee Town,2020,80 - 84 years,19,14,33
Tralee Town,2020,85 years and over,44,18,62
Tralee Town,2020,Under 1 year,0,0,0
Trim Town,2007,1 - 4 years,0,0,0
Trim Town,2007,10 - 14 years,0,0,0
Trim Town,2007,15 - 19 years,0,0,0
Trim Town,2007,20 - 24 years,0,0,0
Trim Town,2007,25 - 29 years,0,0,0
Trim Town,2007,30 - 34 years,0,0,0
Trim Town,2007,35 - 39 years,0,0,0
Trim Town,2007,40 - 44 years,0,0,0
Trim Town,2007,45 - 49 years,2,0,2
Trim Town,2007,5 - 9 years,0,0,0
Trim Town,2007,50 - 54 years,0,1,1
Trim Town,2007,55 - 59 years,1,1,2
Trim Town,2007,60 - 64 years,0,2,2
Trim Town,2007,65 - 69 years,2,3,5
Trim Town,2007,70 - 74 years,2,0,2
Trim Town,2007,75 - 79 years,4,4,8
Trim Town,2007,80 - 84 years,5,5,10
Trim Town,2007,85 years and over,12,4,16
Trim Town,2007,Under 1 year,0,1,1
Trim Town,2008,1 - 4 years,0,0,0
Trim Town,2008,10 - 14 years,0,1,1
Trim Town,2008,15 - 19 years,0,0,0
Trim Town,2008,20 - 24 years,0,0,0
Trim Town,2008,25 - 29 years,0,0,0
Trim Town,2008,30 - 34 years,0,0,0
Trim Town,2008,35 - 39 years,1,1,2
Trim Town,2008,40 - 44 years,1,0,1
Trim Town,2008,45 - 49 years,2,0,2
Trim Town,2008,5 - 9 years,0,0,0
Trim Town,2008,50 - 54 years,0,2,2
Trim Town,2008,55 - 59 years,1,1,2
Trim Town,2008,60 - 64 years,2,2,4
Trim Town,2008,65 - 69 years,2,2,4
Trim Town,2008,70 - 74 years,1,4,5
Trim Town,2008,75 - 79 years,5,7,12
Trim Town,2008,80 - 84 years,4,5,9
Trim Town,2008,85 years and over,10,7,17
Trim Town,2008,Under 1 year,1,1,2
Trim Town,2009,1 - 4 years,0,0,0
Trim Town,2009,10 - 14 years,0,1,1
Trim Town,2009,15 - 19 years,0,0,0
Trim Town,2009,20 - 24 years,0,1,1
Trim Town,2009,25 - 29 years,1,0,1
Trim Town,2009,30 - 34 years,0,0,0
Trim Town,2009,35 - 39 years,1,1,2
Trim Town,2009,40 - 44 years,1,1,2
Trim Town,2009,45 - 49 years,2,0,2
Trim Town,2009,5 - 9 years,0,0,0
Trim Town,2009,50 - 54 years,0,1,1
Trim Town,2009,55 - 59 years,1,1,2
Trim Town,2009,60 - 64 years,1,2,3
Trim Town,2009,65 - 69 years,2,1,3
Trim Town,2009,70 - 74 years,2,4,6
Trim Town,2009,75 - 79 years,2,2,4
Trim Town,2009,80 - 84 years,4,1,5
Trim Town,2009,85 years and over,2,3,5
Trim Town,2009,Under 1 year,1,1,2
Trim Town,2010,1 - 4 years,0,0,0
Trim Town,2010,10 - 14 years,0,1,1
Trim Town,2010,15 - 19 years,0,0,0
Trim Town,2010,20 - 24 years,0,1,1
Trim Town,2010,25 - 29 years,1,0,1
Trim Town,2010,30 - 34 years,1,0,1
Trim Town,2010,35 - 39 years,1,1,2
Trim Town,2010,40 - 44 years,1,1,2
Trim Town,2010,45 - 49 years,2,1,3
Trim Town,2010,5 - 9 years,0,0,0
Trim Town,2010,50 - 54 years,0,1,1
Trim Town,2010,55 - 59 years,3,1,4
Trim Town,2010,60 - 64 years,1,2,3
Trim Town,2010,65 - 69 years,2,1,3
Trim Town,2010,70 - 74 years,1,3,4
Trim Town,2010,75 - 79 years,3,2,5
Trim Town,2010,80 - 84 years,2,1,3
Trim Town,2010,85 years and over,13,1,14
Trim Town,2010,Under 1 year,1,1,2
Trim Town,2011,1 - 4 years,0,0,0
Trim Town,2011,10 - 14 years,0,0,0
Trim Town,2011,15 - 19 years,0,0,0
Trim Town,2011,20 - 24 years,0,0,0
Trim Town,2011,25 - 29 years,0,0,0
Trim Town,2011,30 - 34 years,0,0,0
Trim Town,2011,35 - 39 years,0,0,0
Trim Town,2011,40 - 44 years,0,0,0
Trim Town,2011,45 - 49 years,0,0,0
Trim Town,2011,5 - 9 years,0,0,0
Trim Town,2011,50 - 54 years,0,0,0
Trim Town,2011,55 - 59 years,0,1,1
Trim Town,2011,60 - 64 years,0,0,0
Trim Town,2011,65 - 69 years,0,0,0
Trim Town,2011,70 - 74 years,2,3,5
Trim Town,2011,75 - 79 years,1,2,3
Trim Town,2011,80 - 84 years,2,1,3
Trim Town,2011,85 years and over,4,2,6
Trim Town,2011,Under 1 year,0,0,0
Trim Town,2012,1 - 4 years,0,0,0
Trim Town,2012,10 - 14 years,0,1,1
Trim Town,2012,15 - 19 years,0,0,0
Trim Town,2012,20 - 24 years,0,0,0
Trim Town,2012,25 - 29 years,0,0,0
Trim Town,2012,30 - 34 years,0,0,0
Trim Town,2012,35 - 39 years,0,1,1
Trim Town,2012,40 - 44 years,0,0,0
Trim Town,2012,45 - 49 years,2,0,2
Trim Town,2012,5 - 9 years,0,0,0
Trim Town,2012,50 - 54 years,0,1,1
Trim Town,2012,55 - 59 years,1,2,3
Trim Town,2012,60 - 64 years,2,6,8
Trim Town,2012,65 - 69 years,3,2,5
Trim Town,2012,70 - 74 years,2,4,6
Trim Town,2012,75 - 79 years,4,3,7
Trim Town,2012,80 - 84 years,2,5,7
Trim Town,2012,85 years and over,10,7,17
Trim Town,2012,Under 1 year,0,0,0
Trim Town,2013,1 - 4 years,0,0,0
Trim Town,2013,10 - 14 years,0,0,0
Trim Town,2013,15 - 19 years,0,0,0
Trim Town,2013,20 - 24 years,0,0,0
Trim Town,2013,25 - 29 years,0,0,0
Trim Town,2013,30 - 34 years,0,0,0
Trim Town,2013,35 - 39 years,0,0,0
Trim Town,2013,40 - 44 years,0,0,0
Trim Town,2013,45 - 49 years,0,0,0
Trim Town,2013,5 - 9 years,0,0,0
Trim Town,2013,50 - 54 years,0,0,0
Trim Town,2013,55 - 59 years,0,2,2
Trim Town,2013,60 - 64 years,0,3,3
Trim Town,2013,65 - 69 years,5,1,6
Trim Town,2013,70 - 74 years,1,1,2
Trim Town,2013,75 - 79 years,0,4,4
Trim Town,2013,80 - 84 years,4,2,6
Trim Town,2013,85 years and over,10,2,12
Trim Town,2013,Under 1 year,0,0,0
Trim Town,2014,1 - 4 years,0,0,0
Trim Town,2014,10 - 14 years,0,0,0
Trim Town,2014,15 - 19 years,0,0,0
Trim Town,2014,20 - 24 years,0,0,0
Trim Town,2014,25 - 29 years,0,0,0
Trim Town,2014,30 - 34 years,0,0,0
Trim Town,2014,35 - 39 years,0,0,0
Trim Town,2014,40 - 44 years,0,1,1
Trim Town,2014,45 - 49 years,0,0,0
Trim Town,2014,5 - 9 years,0,0,0
Trim Town,2014,50 - 54 years,0,0,0
Trim Town,2014,55 - 59 years,0,2,2
Trim Town,2014,60 - 64 years,0,1,1
Trim Town,2014,65 - 69 years,5,1,6
Trim Town,2014,70 - 74 years,1,1,2
Trim Town,2014,75 - 79 years,0,2,2
Trim Town,2014,80 - 84 years,6,1,7
Trim Town,2014,85 years and over,3,1,4
Trim Town,2014,Under 1 year,0,1,1
Trim Town,2015,1 - 4 years,0,0,0
Trim Town,2015,10 - 14 years,0,0,0
Trim Town,2015,15 - 19 years,0,0,0
Trim Town,2015,20 - 24 years,0,0,0
Trim Town,2015,25 - 29 years,0,0,0
Trim Town,2015,30 - 34 years,0,0,0
Trim Town,2015,35 - 39 years,0,0,0
Trim Town,2015,40 - 44 years,0,1,1
Trim Town,2015,45 - 49 years,0,0,0
Trim Town,2015,5 - 9 years,0,0,0
Trim Town,2015,50 - 54 years,0,0,0
Trim Town,2015,55 - 59 years,0,2,2
Trim Town,2015,60 - 64 years,0,1,1
Trim Town,2015,65 - 69 years,5,1,6
Trim Town,2015,70 - 74 years,1,1,2
Trim Town,2015,75 - 79 years,0,2,2
Trim Town,2015,80 - 84 years,6,1,7
Trim Town,2015,85 years and over,3,1,4
Trim Town,2015,Under 1 year,0,1,1
Trim Town,2016,1 - 4 years,0,0,0
Trim Town,2016,10 - 14 years,0,0,0
Trim Town,2016,15 - 19 years,0,0,0
Trim Town,2016,20 - 24 years,0,0,0
Trim Town,2016,25 - 29 years,0,0,0
Trim Town,2016,30 - 34 years,0,0,0
Trim Town,2016,35 - 39 years,0,0,0
Trim Town,2016,40 - 44 years,0,1,1
Trim Town,2016,45 - 49 years,0,0,0
Trim Town,2016,5 - 9 years,0,0,0
Trim Town,2016,50 - 54 years,0,0,0
Trim Town,2016,55 - 59 years,0,2,2
Trim Town,2016,60 - 64 years,0,1,1
Trim Town,2016,65 - 69 years,5,1,6
Trim Town,2016,70 - 74 years,1,1,2
Trim Town,2016,75 - 79 years,0,2,2
Trim Town,2016,80 - 84 years,6,1,7
Trim Town,2016,85 years and over,3,1,4
Trim Town,2016,Under 1 year,0,1,1
Trim Town,2017,1 - 4 years,0,0,0
Trim Town,2017,10 - 14 years,0,0,0
Trim Town,2017,15 - 19 years,0,0,0
Trim Town,2017,20 - 24 years,0,0,0
Trim Town,2017,25 - 29 years,0,0,0
Trim Town,2017,30 - 34 years,0,0,0
Trim Town,2017,35 - 39 years,0,0,0
Trim Town,2017,40 - 44 years,0,1,1
Trim Town,2017,45 - 49 years,0,0,0
Trim Town,2017,5 - 9 years,0,0,0
Trim Town,2017,50 - 54 years,0,0,0
Trim Town,2017,55 - 59 years,0,2,2
Trim Town,2017,60 - 64 years,0,1,1
Trim Town,2017,65 - 69 years,5,2,7
Trim Town,2017,70 - 74 years,1,3,4
Trim Town,2017,75 - 79 years,0,2,2
Trim Town,2017,80 - 84 years,6,2,8
Trim Town,2017,85 years and over,5,2,7
Trim Town,2017,Under 1 year,0,1,1
Trim Town,2018,1 - 4 years,0,0,0
Trim Town,2018,10 - 14 years,0,0,0
Trim Town,2018,15 - 19 years,0,0,0
Trim Town,2018,20 - 24 years,0,1,1
Trim Town,2018,25 - 29 years,0,0,0
Trim Town,2018,30 - 34 years,0,0,0
Trim Town,2018,35 - 39 years,0,0,0
Trim Town,2018,40 - 44 years,0,0,0
Trim Town,2018,45 - 49 years,0,0,0
Trim Town,2018,5 - 9 years,0,0,0
Trim Town,2018,50 - 54 years,0,2,2
Trim Town,2018,55 - 59 years,1,0,1
Trim Town,2018,60 - 64 years,0,1,1
Trim Town,2018,65 - 69 years,3,3,6
Trim Town,2018,70 - 74 years,2,2,4
Trim Town,2018,75 - 79 years,1,3,4
Trim Town,2018,80 - 84 years,1,2,3
Trim Town,2018,85 years and over,3,7,10
Trim Town,2018,Under 1 year,0,0,0
Trim Town,2019,1 - 4 years,0,0,0
Trim Town,2019,10 - 14 years,0,0,0
Trim Town,2019,15 - 19 years,0,0,0
Trim Town,2019,20 - 24 years,0,1,1
Trim Town,2019,25 - 29 years,0,0,0
Trim Town,2019,30 - 34 years,0,0,0
Trim Town,2019,35 - 39 years,0,0,0
Trim Town,2019,40 - 44 years,0,0,0
Trim Town,2019,45 - 49 years,0,0,0
Trim Town,2019,5 - 9 years,0,0,0
Trim Town,2019,50 - 54 years,0,2,2
Trim Town,2019,55 - 59 years,1,0,1
Trim Town,2019,60 - 64 years,0,1,1
Trim Town,2019,65 - 69 years,3,3,6
Trim Town,2019,70 - 74 years,2,2,4
Trim Town,2019,75 - 79 years,1,3,4
Trim Town,2019,80 - 84 years,1,2,3
Trim Town,2019,85 years and over,3,7,10
Trim Town,2019,Under 1 year,0,0,0
Trim Town,2020,1 - 4 years,0,0,0
Trim Town,2020,10 - 14 years,0,0,0
Trim Town,2020,15 - 19 years,0,0,0
Trim Town,2020,20 - 24 years,0,1,1
Trim Town,2020,25 - 29 years,0,0,0
Trim Town,2020,30 - 34 years,0,0,0
Trim Town,2020,35 - 39 years,0,0,0
Trim Town,2020,40 - 44 years,0,0,0
Trim Town,2020,45 - 49 years,0,0,0
Trim Town,2020,5 - 9 years,0,0,0
Trim Town,2020,50 - 54 years,0,2,2
Trim Town,2020,55 - 59 years,1,0,1
Trim Town,2020,60 - 64 years,0,1,1
Trim Town,2020,65 - 69 years,3,3,6
Trim Town,2020,70 - 74 years,2,2,4
Trim Town,2020,75 - 79 years,1,3,4
Trim Town,2020,80 - 84 years,1,2,3
Trim Town,2020,85 years and over,3,7,10
Trim Town,2020,Under 1 year,0,0,0
Tullamore Town,2007,1 - 4 years,0,0,0
Tullamore Town,2007,10 - 14 years,0,0,0
Tullamore Town,2007,15 - 19 years,0,0,0
Tullamore Town,2007,20 - 24 years,0,1,1
Tullamore Town,2007,25 - 29 years,0,2,2
Tullamore Town,2007,30 - 34 years,1,2,3
Tullamore Town,2007,35 - 39 years,0,0,0
Tullamore Town,2007,40 - 44 years,1,1,2
Tullamore Town,2007,45 - 49 years,0,1,1
Tullamore Town,2007,5 - 9 years,0,0,0
Tullamore Town,2007,50 - 54 years,2,2,4
Tullamore Town,2007,55 - 59 years,0,2,2
Tullamore Town,2007,60 - 64 years,4,7,11
Tullamore Town,2007,65 - 69 years,3,6,9
Tullamore Town,2007,70 - 74 years,3,9,12
Tullamore Town,2007,75 - 79 years,7,13,20
Tullamore Town,2007,80 - 84 years,19,6,25
Tullamore Town,2007,85 years and over,24,11,35
Tullamore Town,2007,Under 1 year,1,1,2
Tullamore Town,2008,1 - 4 years,0,0,0
Tullamore Town,2008,10 - 14 years,0,0,0
Tullamore Town,2008,15 - 19 years,0,0,0
Tullamore Town,2008,20 - 24 years,0,2,2
Tullamore Town,2008,25 - 29 years,0,2,2
Tullamore Town,2008,30 - 34 years,1,1,2
Tullamore Town,2008,35 - 39 years,0,0,0
Tullamore Town,2008,40 - 44 years,2,1,3
Tullamore Town,2008,45 - 49 years,3,1,4
Tullamore Town,2008,5 - 9 years,0,0,0
Tullamore Town,2008,50 - 54 years,4,2,6
Tullamore Town,2008,55 - 59 years,3,4,7
Tullamore Town,2008,60 - 64 years,3,6,9
Tullamore Town,2008,65 - 69 years,3,10,13
Tullamore Town,2008,70 - 74 years,4,11,15
Tullamore Town,2008,75 - 79 years,9,16,25
Tullamore Town,2008,80 - 84 years,14,13,27
Tullamore Town,2008,85 years and over,23,10,33
Tullamore Town,2008,Under 1 year,1,1,2
Tullamore Town,2009,1 - 4 years,0,0,0
Tullamore Town,2009,10 - 14 years,0,0,0
Tullamore Town,2009,15 - 19 years,0,0,0
Tullamore Town,2009,20 - 24 years,0,1,1
Tullamore Town,2009,25 - 29 years,0,1,1
Tullamore Town,2009,30 - 34 years,1,2,3
Tullamore Town,2009,35 - 39 years,0,0,0
Tullamore Town,2009,40 - 44 years,2,1,3
Tullamore Town,2009,45 - 49 years,3,2,5
Tullamore Town,2009,5 - 9 years,0,0,0
Tullamore Town,2009,50 - 54 years,1,2,3
Tullamore Town,2009,55 - 59 years,1,4,5
Tullamore Town,2009,60 - 64 years,3,5,8
Tullamore Town,2009,65 - 69 years,4,3,7
Tullamore Town,2009,70 - 74 years,6,7,13
Tullamore Town,2009,75 - 79 years,12,7,19
Tullamore Town,2009,80 - 84 years,8,7,15
Tullamore Town,2009,85 years and over,16,4,20
Tullamore Town,2009,Under 1 year,1,1,2
Tullamore Town,2010,1 - 4 years,0,0,0
Tullamore Town,2010,10 - 14 years,0,0,0
Tullamore Town,2010,15 - 19 years,0,0,0
Tullamore Town,2010,20 - 24 years,0,1,1
Tullamore Town,2010,25 - 29 years,1,1,2
Tullamore Town,2010,30 - 34 years,1,1,2
Tullamore Town,2010,35 - 39 years,0,1,1
Tullamore Town,2010,40 - 44 years,2,1,3
Tullamore Town,2010,45 - 49 years,3,2,5
Tullamore Town,2010,5 - 9 years,0,0,0
Tullamore Town,2010,50 - 54 years,1,3,4
Tullamore Town,2010,55 - 59 years,1,3,4
Tullamore Town,2010,60 - 64 years,2,2,4
Tullamore Town,2010,65 - 69 years,1,3,4
Tullamore Town,2010,70 - 74 years,3,3,6
Tullamore Town,2010,75 - 79 years,9,6,15
Tullamore Town,2010,80 - 84 years,8,8,16
Tullamore Town,2010,85 years and over,11,4,15
Tullamore Town,2010,Under 1 year,1,1,2
Tullamore Town,2011,1 - 4 years,1,0,1
Tullamore Town,2011,10 - 14 years,0,0,0
Tullamore Town,2011,15 - 19 years,0,1,1
Tullamore Town,2011,20 - 24 years,0,0,0
Tullamore Town,2011,25 - 29 years,0,2,2
Tullamore Town,2011,30 - 34 years,0,1,1
Tullamore Town,2011,35 - 39 years,1,0,1
Tullamore Town,2011,40 - 44 years,1,0,1
Tullamore Town,2011,45 - 49 years,1,2,3
Tullamore Town,2011,5 - 9 years,0,0,0
Tullamore Town,2011,50 - 54 years,2,1,3
Tullamore Town,2011,55 - 59 years,0,1,1
Tullamore Town,2011,60 - 64 years,2,4,6
Tullamore Town,2011,65 - 69 years,2,2,4
Tullamore Town,2011,70 - 74 years,2,7,9
Tullamore Town,2011,75 - 79 years,4,7,11
Tullamore Town,2011,80 - 84 years,3,5,8
Tullamore Town,2011,85 years and over,12,2,14
Tullamore Town,2011,Under 1 year,0,1,1
Tullamore Town,2012,1 - 4 years,1,0,1
Tullamore Town,2012,10 - 14 years,1,0,1
Tullamore Town,2012,15 - 19 years,0,1,1
Tullamore Town,2012,20 - 24 years,0,0,0
Tullamore Town,2012,25 - 29 years,0,2,2
Tullamore Town,2012,30 - 34 years,0,1,1
Tullamore Town,2012,35 - 39 years,1,0,1
Tullamore Town,2012,40 - 44 years,1,2,3
Tullamore Town,2012,45 - 49 years,1,1,2
Tullamore Town,2012,5 - 9 years,0,0,0
Tullamore Town,2012,50 - 54 years,2,3,5
Tullamore Town,2012,55 - 59 years,2,2,4
Tullamore Town,2012,60 - 64 years,3,5,8
Tullamore Town,2012,65 - 69 years,1,3,4
Tullamore Town,2012,70 - 74 years,4,7,11
Tullamore Town,2012,75 - 79 years,3,7,10
Tullamore Town,2012,80 - 84 years,9,9,18
Tullamore Town,2012,85 years and over,21,11,32
Tullamore Town,2012,Under 1 year,0,1,1
Tullamore Town,2013,1 - 4 years,0,0,0
Tullamore Town,2013,10 - 14 years,0,0,0
Tullamore Town,2013,15 - 19 years,1,0,1
Tullamore Town,2013,20 - 24 years,0,0,0
Tullamore Town,2013,25 - 29 years,0,0,0
Tullamore Town,2013,30 - 34 years,1,0,1
Tullamore Town,2013,35 - 39 years,0,1,1
Tullamore Town,2013,40 - 44 years,0,0,0
Tullamore Town,2013,45 - 49 years,1,6,7
Tullamore Town,2013,5 - 9 years,0,0,0
Tullamore Town,2013,50 - 54 years,0,1,1
Tullamore Town,2013,55 - 59 years,1,0,1
Tullamore Town,2013,60 - 64 years,3,4,7
Tullamore Town,2013,65 - 69 years,1,1,2
Tullamore Town,2013,70 - 74 years,6,3,9
Tullamore Town,2013,75 - 79 years,6,8,14
Tullamore Town,2013,80 - 84 years,5,3,8
Tullamore Town,2013,85 years and over,18,12,30
Tullamore Town,2013,Under 1 year,0,0,0
Tullamore Town,2014,1 - 4 years,1,0,1
Tullamore Town,2014,10 - 14 years,0,1,1
Tullamore Town,2014,15 - 19 years,1,0,1
Tullamore Town,2014,20 - 24 years,0,0,0
Tullamore Town,2014,25 - 29 years,1,0,1
Tullamore Town,2014,30 - 34 years,1,0,1
Tullamore Town,2014,35 - 39 years,0,1,1
Tullamore Town,2014,40 - 44 years,0,1,1
Tullamore Town,2014,45 - 49 years,2,1,3
Tullamore Town,2014,5 - 9 years,0,0,0
Tullamore Town,2014,50 - 54 years,1,1,2
Tullamore Town,2014,55 - 59 years,1,6,7
Tullamore Town,2014,60 - 64 years,1,2,3
Tullamore Town,2014,65 - 69 years,2,3,5
Tullamore Town,2014,70 - 74 years,5,5,10
Tullamore Town,2014,75 - 79 years,6,4,10
Tullamore Town,2014,80 - 84 years,9,6,15
Tullamore Town,2014,85 years and over,19,11,30
Tullamore Town,2014,Under 1 year,0,1,1
Tullamore Town,2015,1 - 4 years,1,0,1
Tullamore Town,2015,10 - 14 years,0,1,1
Tullamore Town,2015,15 - 19 years,1,0,1
Tullamore Town,2015,20 - 24 years,0,0,0
Tullamore Town,2015,25 - 29 years,1,0,1
Tullamore Town,2015,30 - 34 years,1,0,1
Tullamore Town,2015,35 - 39 years,0,1,1
Tullamore Town,2015,40 - 44 years,0,1,1
Tullamore Town,2015,45 - 49 years,2,1,3
Tullamore Town,2015,5 - 9 years,0,0,0
Tullamore Town,2015,50 - 54 years,1,1,2
Tullamore Town,2015,55 - 59 years,1,6,7
Tullamore Town,2015,60 - 64 years,1,2,3
Tullamore Town,2015,65 - 69 years,2,3,5
Tullamore Town,2015,70 - 74 years,5,5,10
Tullamore Town,2015,75 - 79 years,6,4,10
Tullamore Town,2015,80 - 84 years,9,6,15
Tullamore Town,2015,85 years and over,19,11,30
Tullamore Town,2015,Under 1 year,0,1,1
Tullamore Town,2016,1 - 4 years,1,0,1
Tullamore Town,2016,10 - 14 years,0,1,1
Tullamore Town,2016,15 - 19 years,1,0,1
Tullamore Town,2016,20 - 24 years,0,0,0
Tullamore Town,2016,25 - 29 years,1,0,1
Tullamore Town,2016,30 - 34 years,1,0,1
Tullamore Town,2016,35 - 39 years,0,1,1
Tullamore Town,2016,40 - 44 years,0,1,1
Tullamore Town,2016,45 - 49 years,2,1,3
Tullamore Town,2016,5 - 9 years,0,0,0
Tullamore Town,2016,50 - 54 years,1,1,2
Tullamore Town,2016,55 - 59 years,1,6,7
Tullamore Town,2016,60 - 64 years,1,2,3
Tullamore Town,2016,65 - 69 years,2,3,5
Tullamore Town,2016,70 - 74 years,5,5,10
Tullamore Town,2016,75 - 79 years,6,4,10
Tullamore Town,2016,80 - 84 years,9,6,15
Tullamore Town,2016,85 years and over,19,11,30
Tullamore Town,2016,Under 1 year,0,1,1
Tullamore Town,2017,1 - 4 years,1,0,1
Tullamore Town,2017,10 - 14 years,0,1,1
Tullamore Town,2017,15 - 19 years,1,0,1
Tullamore Town,2017,20 - 24 years,1,0,1
Tullamore Town,2017,25 - 29 years,1,0,1
Tullamore Town,2017,30 - 34 years,1,0,1
Tullamore Town,2017,35 - 39 years,2,1,3
Tullamore Town,2017,40 - 44 years,0,1,1
Tullamore Town,2017,45 - 49 years,2,1,3
Tullamore Town,2017,5 - 9 years,0,0,0
Tullamore Town,2017,50 - 54 years,1,2,3
Tullamore Town,2017,55 - 59 years,4,1,5
Tullamore Town,2017,60 - 64 years,2,2,4
Tullamore Town,2017,65 - 69 years,3,5,8
Tullamore Town,2017,70 - 74 years,7,4,11
Tullamore Town,2017,75 - 79 years,10,1,11
Tullamore Town,2017,80 - 84 years,11,8,19
Tullamore Town,2017,85 years and over,23,9,32
Tullamore Town,2017,Under 1 year,2,1,3
Tullamore Town,2018,1 - 4 years,0,0,0
Tullamore Town,2018,10 - 14 years,0,0,0
Tullamore Town,2018,15 - 19 years,0,0,0
Tullamore Town,2018,20 - 24 years,0,0,0
Tullamore Town,2018,25 - 29 years,0,1,1
Tullamore Town,2018,30 - 34 years,0,1,1
Tullamore Town,2018,35 - 39 years,1,0,1
Tullamore Town,2018,40 - 44 years,0,3,3
Tullamore Town,2018,45 - 49 years,2,2,4
Tullamore Town,2018,5 - 9 years,0,0,0
Tullamore Town,2018,50 - 54 years,2,2,4
Tullamore Town,2018,55 - 59 years,1,5,6
Tullamore Town,2018,60 - 64 years,0,4,4
Tullamore Town,2018,65 - 69 years,2,7,9
Tullamore Town,2018,70 - 74 years,7,8,15
Tullamore Town,2018,75 - 79 years,4,4,8
Tullamore Town,2018,80 - 84 years,10,12,22
Tullamore Town,2018,85 years and over,22,16,38
Tullamore Town,2018,Under 1 year,1,0,1
Tullamore Town,2019,1 - 4 years,0,0,0
Tullamore Town,2019,10 - 14 years,0,0,0
Tullamore Town,2019,15 - 19 years,0,0,0
Tullamore Town,2019,20 - 24 years,0,0,0
Tullamore Town,2019,25 - 29 years,0,1,1
Tullamore Town,2019,30 - 34 years,0,1,1
Tullamore Town,2019,35 - 39 years,1,0,1
Tullamore Town,2019,40 - 44 years,0,3,3
Tullamore Town,2019,45 - 49 years,2,2,4
Tullamore Town,2019,5 - 9 years,0,0,0
Tullamore Town,2019,50 - 54 years,2,2,4
Tullamore Town,2019,55 - 59 years,1,5,6
Tullamore Town,2019,60 - 64 years,0,4,4
Tullamore Town,2019,65 - 69 years,2,7,9
Tullamore Town,2019,70 - 74 years,7,8,15
Tullamore Town,2019,75 - 79 years,4,4,8
Tullamore Town,2019,80 - 84 years,10,12,22
Tullamore Town,2019,85 years and over,22,16,38
Tullamore Town,2019,Under 1 year,1,0,1
Tullamore Town,2020,1 - 4 years,0,0,0
Tullamore Town,2020,10 - 14 years,0,0,0
Tullamore Town,2020,15 - 19 years,0,0,0
Tullamore Town,2020,20 - 24 years,0,0,0
Tullamore Town,2020,25 - 29 years,0,1,1
Tullamore Town,2020,30 - 34 years,0,1,1
Tullamore Town,2020,35 - 39 years,1,0,1
Tullamore Town,2020,40 - 44 years,0,3,3
Tullamore Town,2020,45 - 49 years,2,2,4
Tullamore Town,2020,5 - 9 years,0,0,0
Tullamore Town,2020,50 - 54 years,2,2,4
Tullamore Town,2020,55 - 59 years,1,5,6
Tullamore Town,2020,60 - 64 years,0,4,4
Tullamore Town,2020,65 - 69 years,2,7,9
Tullamore Town,2020,70 - 74 years,7,8,15
Tullamore Town,2020,75 - 79 years,4,4,8
Tullamore Town,2020,80 - 84 years,10,12,22
Tullamore Town,2020,85 years and over,22,16,38
Tullamore Town,2020,Under 1 year,1,0,1
Ulster (pt),2007,1 - 4 years,5,4,9
Ulster (pt),2007,10 - 14 years,0,0,0
Ulster (pt),2007,15 - 19 years,3,13,16
Ulster (pt),2007,20 - 24 years,0,3,3
Ulster (pt),2007,25 - 29 years,3,6,9
Ulster (pt),2007,30 - 34 years,2,12,14
Ulster (pt),2007,35 - 39 years,5,10,15
Ulster (pt),2007,40 - 44 years,6,12,18
Ulster (pt),2007,45 - 49 years,11,18,29
Ulster (pt),2007,5 - 9 years,2,2,4
Ulster (pt),2007,50 - 54 years,22,17,39
Ulster (pt),2007,55 - 59 years,32,59,91
Ulster (pt),2007,60 - 64 years,48,56,104
Ulster (pt),2007,65 - 69 years,48,78,126
Ulster (pt),2007,70 - 74 years,83,122,205
Ulster (pt),2007,75 - 79 years,119,164,283
Ulster (pt),2007,80 - 84 years,177,193,370
Ulster (pt),2007,85 years and over,419,254,673
Ulster (pt),2007,Under 1 year,2,7,9
Ulster (pt),2008,1 - 4 years,1,1,2
Ulster (pt),2008,10 - 14 years,0,0,0
Ulster (pt),2008,15 - 19 years,2,5,7
Ulster (pt),2008,20 - 24 years,4,11,15
Ulster (pt),2008,25 - 29 years,8,10,18
Ulster (pt),2008,30 - 34 years,5,11,16
Ulster (pt),2008,35 - 39 years,7,8,15
Ulster (pt),2008,40 - 44 years,13,14,27
Ulster (pt),2008,45 - 49 years,25,12,37
Ulster (pt),2008,5 - 9 years,1,1,2
Ulster (pt),2008,50 - 54 years,20,25,45
Ulster (pt),2008,55 - 59 years,33,46,79
Ulster (pt),2008,60 - 64 years,35,73,108
Ulster (pt),2008,65 - 69 years,48,94,142
Ulster (pt),2008,70 - 74 years,59,110,169
Ulster (pt),2008,75 - 79 years,100,164,264
Ulster (pt),2008,80 - 84 years,162,193,355
Ulster (pt),2008,85 years and over,393,235,628
Ulster (pt),2008,Under 1 year,9,7,16
Ulster (pt),2009,1 - 4 years,1,3,4
Ulster (pt),2009,10 - 14 years,0,2,2
Ulster (pt),2009,15 - 19 years,4,5,9
Ulster (pt),2009,20 - 24 years,4,10,14
Ulster (pt),2009,25 - 29 years,6,15,21
Ulster (pt),2009,30 - 34 years,8,8,16
Ulster (pt),2009,35 - 39 years,10,14,24
Ulster (pt),2009,40 - 44 years,8,13,21
Ulster (pt),2009,45 - 49 years,16,21,37
Ulster (pt),2009,5 - 9 years,1,1,2
Ulster (pt),2009,50 - 54 years,15,40,55
Ulster (pt),2009,55 - 59 years,31,53,84
Ulster (pt),2009,60 - 64 years,51,74,125
Ulster (pt),2009,65 - 69 years,60,78,138
Ulster (pt),2009,70 - 74 years,72,121,193
Ulster (pt),2009,75 - 79 years,105,144,249
Ulster (pt),2009,80 - 84 years,169,194,363
Ulster (pt),2009,85 years and over,399,244,643
Ulster (pt),2009,Under 1 year,6,8,14
Ulster (pt),2010,1 - 4 years,1,3,4
Ulster (pt),2010,10 - 14 years,1,2,3
Ulster (pt),2010,15 - 19 years,4,2,6
Ulster (pt),2010,20 - 24 years,4,8,12
Ulster (pt),2010,25 - 29 years,3,6,9
Ulster (pt),2010,30 - 34 years,1,9,10
Ulster (pt),2010,35 - 39 years,2,14,16
Ulster (pt),2010,40 - 44 years,8,17,25
Ulster (pt),2010,45 - 49 years,7,17,24
Ulster (pt),2010,5 - 9 years,1,1,2
Ulster (pt),2010,50 - 54 years,18,25,43
Ulster (pt),2010,55 - 59 years,39,56,95
Ulster (pt),2010,60 - 64 years,41,70,111
Ulster (pt),2010,65 - 69 years,57,101,158
Ulster (pt),2010,70 - 74 years,69,107,176
Ulster (pt),2010,75 - 79 years,105,150,255
Ulster (pt),2010,80 - 84 years,173,183,356
Ulster (pt),2010,85 years and over,419,243,662
Ulster (pt),2010,Under 1 year,8,8,16
Ulster (pt),2011,1 - 4 years,1,1,2
Ulster (pt),2011,10 - 14 years,1,0,1
Ulster (pt),2011,15 - 19 years,4,6,10
Ulster (pt),2011,20 - 24 years,3,9,12
Ulster (pt),2011,25 - 29 years,3,9,12
Ulster (pt),2011,30 - 34 years,4,11,15
Ulster (pt),2011,35 - 39 years,7,11,18
Ulster (pt),2011,40 - 44 years,8,16,24
Ulster (pt),2011,45 - 49 years,11,23,34
Ulster (pt),2011,5 - 9 years,1,1,2
Ulster (pt),2011,50 - 54 years,16,34,50
Ulster (pt),2011,55 - 59 years,17,56,73
Ulster (pt),2011,60 - 64 years,53,88,141
Ulster (pt),2011,65 - 69 years,72,77,149
Ulster (pt),2011,70 - 74 years,72,116,188
Ulster (pt),2011,75 - 79 years,86,166,252
Ulster (pt),2011,80 - 84 years,164,176,340
Ulster (pt),2011,85 years and over,386,298,684
Ulster (pt),2011,Under 1 year,7,6,13
Ulster (pt),2012,1 - 4 years,1,3,4
Ulster (pt),2012,10 - 14 years,3,3,6
Ulster (pt),2012,15 - 19 years,3,3,6
Ulster (pt),2012,20 - 24 years,3,8,11
Ulster (pt),2012,25 - 29 years,2,11,13
Ulster (pt),2012,30 - 34 years,4,7,11
Ulster (pt),2012,35 - 39 years,5,7,12
Ulster (pt),2012,40 - 44 years,8,9,17
Ulster (pt),2012,45 - 49 years,11,22,33
Ulster (pt),2012,5 - 9 years,1,1,2
Ulster (pt),2012,50 - 54 years,21,23,44
Ulster (pt),2012,55 - 59 years,26,50,76
Ulster (pt),2012,60 - 64 years,47,77,124
Ulster (pt),2012,65 - 69 years,53,100,153
Ulster (pt),2012,70 - 74 years,63,111,174
Ulster (pt),2012,75 - 79 years,111,160,271
Ulster (pt),2012,80 - 84 years,176,185,361
Ulster (pt),2012,85 years and over,462,286,748
Ulster (pt),2012,Under 1 year,11,5,16
Ulster (pt),2013,1 - 4 years,0,1,1
Ulster (pt),2013,10 - 14 years,1,1,2
Ulster (pt),2013,15 - 19 years,0,4,4
Ulster (pt),2013,20 - 24 years,0,5,5
Ulster (pt),2013,25 - 29 years,2,6,8
Ulster (pt),2013,30 - 34 years,8,13,21
Ulster (pt),2013,35 - 39 years,5,8,13
Ulster (pt),2013,40 - 44 years,10,16,26
Ulster (pt),2013,45 - 49 years,16,15,31
Ulster (pt),2013,5 - 9 years,1,1,2
Ulster (pt),2013,50 - 54 years,24,22,46
Ulster (pt),2013,55 - 59 years,20,48,68
Ulster (pt),2013,60 - 64 years,44,70,114
Ulster (pt),2013,65 - 69 years,55,102,157
Ulster (pt),2013,70 - 74 years,64,111,175
Ulster (pt),2013,75 - 79 years,101,133,234
Ulster (pt),2013,80 - 84 years,150,180,330
Ulster (pt),2013,85 years and over,458,315,773
Ulster (pt),2013,Under 1 year,6,14,20
Ulster (pt),2014,1 - 4 years,1,3,4
Ulster (pt),2014,10 - 14 years,1,1,2
Ulster (pt),2014,15 - 19 years,1,1,2
Ulster (pt),2014,20 - 24 years,0,7,7
Ulster (pt),2014,25 - 29 years,3,8,11
Ulster (pt),2014,30 - 34 years,3,8,11
Ulster (pt),2014,35 - 39 years,5,10,15
Ulster (pt),2014,40 - 44 years,8,15,23
Ulster (pt),2014,45 - 49 years,10,15,25
Ulster (pt),2014,5 - 9 years,1,1,2
Ulster (pt),2014,50 - 54 years,21,37,58
Ulster (pt),2014,55 - 59 years,24,44,68
Ulster (pt),2014,60 - 64 years,35,51,86
Ulster (pt),2014,65 - 69 years,66,103,169
Ulster (pt),2014,70 - 74 years,80,126,206
Ulster (pt),2014,75 - 79 years,93,161,254
Ulster (pt),2014,80 - 84 years,156,171,327
Ulster (pt),2014,85 years and over,456,319,775
Ulster (pt),2014,Under 1 year,4,12,16
Ulster (pt),2015,1 - 4 years,1,1,2
Ulster (pt),2015,10 - 14 years,1,1,2
Ulster (pt),2015,15 - 19 years,1,1,2
Ulster (pt),2015,20 - 24 years,2,5,7
Ulster (pt),2015,25 - 29 years,2,5,7
Ulster (pt),2015,30 - 34 years,6,7,13
Ulster (pt),2015,35 - 39 years,6,12,18
Ulster (pt),2015,40 - 44 years,5,11,16
Ulster (pt),2015,45 - 49 years,11,23,34
Ulster (pt),2015,5 - 9 years,1,1,2
Ulster (pt),2015,50 - 54 years,22,25,47
Ulster (pt),2015,55 - 59 years,26,40,66
Ulster (pt),2015,60 - 64 years,38,72,110
Ulster (pt),2015,65 - 69 years,54,88,142
Ulster (pt),2015,70 - 74 years,74,137,211
Ulster (pt),2015,75 - 79 years,102,140,242
Ulster (pt),2015,80 - 84 years,172,192,364
Ulster (pt),2015,85 years and over,470,290,760
Ulster (pt),2015,Under 1 year,8,11,19
Ulster (pt),2016,1 - 4 years,1,2,3
Ulster (pt),2016,10 - 14 years,1,0,1
Ulster (pt),2016,15 - 19 years,3,4,7
Ulster (pt),2016,20 - 24 years,2,6,8
Ulster (pt),2016,25 - 29 years,2,4,6
Ulster (pt),2016,30 - 34 years,4,11,15
Ulster (pt),2016,35 - 39 years,4,12,16
Ulster (pt),2016,40 - 44 years,11,12,23
Ulster (pt),2016,45 - 49 years,13,21,34
Ulster (pt),2016,5 - 9 years,1,2,3
Ulster (pt),2016,50 - 54 years,24,31,55
Ulster (pt),2016,55 - 59 years,27,47,74
Ulster (pt),2016,60 - 64 years,40,62,102
Ulster (pt),2016,65 - 69 years,55,94,149
Ulster (pt),2016,70 - 74 years,94,139,233
Ulster (pt),2016,75 - 79 years,118,130,248
Ulster (pt),2016,80 - 84 years,158,177,335
Ulster (pt),2016,85 years and over,467,301,768
Ulster (pt),2016,Under 1 year,5,8,13
Ulster (pt),2017,1 - 4 years,1,1,2
Ulster (pt),2017,10 - 14 years,1,0,1
Ulster (pt),2017,15 - 19 years,2,1,3
Ulster (pt),2017,20 - 24 years,1,5,6
Ulster (pt),2017,25 - 29 years,2,4,6
Ulster (pt),2017,30 - 34 years,1,8,9
Ulster (pt),2017,35 - 39 years,3,7,10
Ulster (pt),2017,40 - 44 years,8,15,23
Ulster (pt),2017,45 - 49 years,12,29,41
Ulster (pt),2017,5 - 9 years,4,1,5
Ulster (pt),2017,50 - 54 years,22,33,55
Ulster (pt),2017,55 - 59 years,15,35,50
Ulster (pt),2017,60 - 64 years,33,70,103
Ulster (pt),2017,65 - 69 years,63,92,155
Ulster (pt),2017,70 - 74 years,82,137,219
Ulster (pt),2017,75 - 79 years,111,160,271
Ulster (pt),2017,80 - 84 years,156,193,349
Ulster (pt),2017,85 years and over,471,315,786
Ulster (pt),2017,Under 1 year,9,9,18
Ulster (pt),2018,1 - 4 years,1,0,1
Ulster (pt),2018,10 - 14 years,1,0,1
Ulster (pt),2018,15 - 19 years,1,2,3
Ulster (pt),2018,20 - 24 years,1,6,7
Ulster (pt),2018,25 - 29 years,2,5,7
Ulster (pt),2018,30 - 34 years,4,6,10
Ulster (pt),2018,35 - 39 years,1,11,12
Ulster (pt),2018,40 - 44 years,10,10,20
Ulster (pt),2018,45 - 49 years,12,17,29
Ulster (pt),2018,5 - 9 years,0,0,0
Ulster (pt),2018,50 - 54 years,23,30,53
Ulster (pt),2018,55 - 59 years,32,47,79
Ulster (pt),2018,60 - 64 years,29,66,95
Ulster (pt),2018,65 - 69 years,71,100,171
Ulster (pt),2018,70 - 74 years,77,126,203
Ulster (pt),2018,75 - 79 years,115,168,283
Ulster (pt),2018,80 - 84 years,154,195,349
Ulster (pt),2018,85 years and over,461,315,776
Ulster (pt),2018,Under 1 year,3,6,9
Ulster (pt),2019,1 - 4 years,2,2,4
Ulster (pt),2019,10 - 14 years,0,0,0
Ulster (pt),2019,15 - 19 years,4,4,8
Ulster (pt),2019,20 - 24 years,5,5,10
Ulster (pt),2019,25 - 29 years,5,5,10
Ulster (pt),2019,30 - 34 years,6,6,12
Ulster (pt),2019,35 - 39 years,8,8,16
Ulster (pt),2019,40 - 44 years,12,12,24
Ulster (pt),2019,45 - 49 years,24,24,48
Ulster (pt),2019,5 - 9 years,0,0,0
Ulster (pt),2019,50 - 54 years,39,39,78
Ulster (pt),2019,55 - 59 years,33,33,66
Ulster (pt),2019,60 - 64 years,77,77,154
Ulster (pt),2019,65 - 69 years,102,102,204
Ulster (pt),2019,70 - 74 years,153,153,306
Ulster (pt),2019,75 - 79 years,151,151,302
Ulster (pt),2019,80 - 84 years,172,172,344
Ulster (pt),2019,85 years and over,350,350,700
Ulster (pt),2019,Under 1 year,1,1,2
Ulster (pt),2020,1 - 4 years,1,3,4
Ulster (pt),2020,10 - 14 years,0,2,2
Ulster (pt),2020,15 - 19 years,4,4,8
Ulster (pt),2020,20 - 24 years,5,4,9
Ulster (pt),2020,25 - 29 years,1,7,8
Ulster (pt),2020,30 - 34 years,1,6,7
Ulster (pt),2020,35 - 39 years,5,6,11
Ulster (pt),2020,40 - 44 years,9,12,21
Ulster (pt),2020,45 - 49 years,14,15,29
Ulster (pt),2020,5 - 9 years,0,0,0
Ulster (pt),2020,50 - 54 years,18,18,36
Ulster (pt),2020,55 - 59 years,35,48,83
Ulster (pt),2020,60 - 64 years,45,56,101
Ulster (pt),2020,65 - 69 years,51,97,148
Ulster (pt),2020,70 - 74 years,77,135,212
Ulster (pt),2020,75 - 79 years,115,178,293
Ulster (pt),2020,80 - 84 years,165,197,362
Ulster (pt),2020,85 years and over,484,375,859
Ulster (pt),2020,Under 1 year,4,1,5
Waterford City,2007,1 - 4 years,0,0,0
Waterford City,2007,10 - 14 years,1,0,1
Waterford City,2007,15 - 19 years,0,2,2
Waterford City,2007,20 - 24 years,0,4,4
Waterford City,2007,25 - 29 years,0,3,3
Waterford City,2007,30 - 34 years,1,2,3
Waterford City,2007,35 - 39 years,0,3,3
Waterford City,2007,40 - 44 years,2,3,5
Waterford City,2007,45 - 49 years,1,4,5
Waterford City,2007,5 - 9 years,0,0,0
Waterford City,2007,50 - 54 years,4,3,7
Waterford City,2007,55 - 59 years,7,8,15
Waterford City,2007,60 - 64 years,10,17,27
Waterford City,2007,65 - 69 years,6,12,18
Waterford City,2007,70 - 74 years,16,22,38
Waterford City,2007,75 - 79 years,18,29,47
Waterford City,2007,80 - 84 years,34,22,56
Waterford City,2007,85 years and over,44,20,64
Waterford City,2007,Under 1 year,0,2,2
Waterford City,2008,1 - 4 years,1,0,1
Waterford City,2008,10 - 14 years,1,0,1
Waterford City,2008,15 - 19 years,0,1,1
Waterford City,2008,20 - 24 years,0,1,1
Waterford City,2008,25 - 29 years,0,3,3
Waterford City,2008,30 - 34 years,1,3,4
Waterford City,2008,35 - 39 years,1,3,4
Waterford City,2008,40 - 44 years,1,2,3
Waterford City,2008,45 - 49 years,1,2,3
Waterford City,2008,5 - 9 years,0,0,0
Waterford City,2008,50 - 54 years,4,7,11
Waterford City,2008,55 - 59 years,10,8,18
Waterford City,2008,60 - 64 years,7,10,17
Waterford City,2008,65 - 69 years,7,20,27
Waterford City,2008,70 - 74 years,17,23,40
Waterford City,2008,75 - 79 years,14,20,34
Waterford City,2008,80 - 84 years,29,16,45
Waterford City,2008,85 years and over,50,24,74
Waterford City,2008,Under 1 year,0,2,2
Waterford City,2009,1 - 4 years,1,0,1
Waterford City,2009,10 - 14 years,1,0,1
Waterford City,2009,15 - 19 years,0,2,2
Waterford City,2009,20 - 24 years,1,2,3
Waterford City,2009,25 - 29 years,0,5,5
Waterford City,2009,30 - 34 years,1,1,2
Waterford City,2009,35 - 39 years,1,3,4
Waterford City,2009,40 - 44 years,2,2,4
Waterford City,2009,45 - 49 years,2,6,8
Waterford City,2009,5 - 9 years,0,0,0
Waterford City,2009,50 - 54 years,4,7,11
Waterford City,2009,55 - 59 years,9,8,17
Waterford City,2009,60 - 64 years,5,9,14
Waterford City,2009,65 - 69 years,5,19,24
Waterford City,2009,70 - 74 years,9,18,27
Waterford City,2009,75 - 79 years,23,34,57
Waterford City,2009,80 - 84 years,18,32,50
Waterford City,2009,85 years and over,42,22,64
Waterford City,2009,Under 1 year,1,2,3
Waterford City,2010,1 - 4 years,1,1,2
Waterford City,2010,10 - 14 years,1,0,1
Waterford City,2010,15 - 19 years,2,2,4
Waterford City,2010,20 - 24 years,1,2,3
Waterford City,2010,25 - 29 years,0,4,4
Waterford City,2010,30 - 34 years,1,1,2
Waterford City,2010,35 - 39 years,1,2,3
Waterford City,2010,40 - 44 years,3,5,8
Waterford City,2010,45 - 49 years,4,4,8
Waterford City,2010,5 - 9 years,0,0,0
Waterford City,2010,50 - 54 years,3,8,11
Waterford City,2010,55 - 59 years,4,11,15
Waterford City,2010,60 - 64 years,8,9,17
Waterford City,2010,65 - 69 years,9,13,22
Waterford City,2010,70 - 74 years,15,19,34
Waterford City,2010,75 - 79 years,14,20,34
Waterford City,2010,80 - 84 years,21,18,39
Waterford City,2010,85 years and over,63,34,97
Waterford City,2010,Under 1 year,2,2,4
Waterford City,2011,1 - 4 years,0,0,0
Waterford City,2011,10 - 14 years,0,0,0
Waterford City,2011,15 - 19 years,0,1,1
Waterford City,2011,20 - 24 years,0,1,1
Waterford City,2011,25 - 29 years,0,2,2
Waterford City,2011,30 - 34 years,0,3,3
Waterford City,2011,35 - 39 years,0,3,3
Waterford City,2011,40 - 44 years,1,5,6
Waterford City,2011,45 - 49 years,2,1,3
Waterford City,2011,5 - 9 years,0,0,0
Waterford City,2011,50 - 54 years,0,8,8
Waterford City,2011,55 - 59 years,7,12,19
Waterford City,2011,60 - 64 years,4,7,11
Waterford City,2011,65 - 69 years,5,19,24
Waterford City,2011,70 - 74 years,12,25,37
Waterford City,2011,75 - 79 years,24,27,51
Waterford City,2011,80 - 84 years,29,30,59
Waterford City,2011,85 years and over,66,40,106
Waterford City,2011,Under 1 year,1,1,2
Waterford City,2012,1 - 4 years,0,0,0
Waterford City,2012,10 - 14 years,0,0,0
Waterford City,2012,15 - 19 years,0,2,2
Waterford City,2012,20 - 24 years,0,3,3
Waterford City,2012,25 - 29 years,1,2,3
Waterford City,2012,30 - 34 years,0,3,3
Waterford City,2012,35 - 39 years,2,3,5
Waterford City,2012,40 - 44 years,2,2,4
Waterford City,2012,45 - 49 years,1,6,7
Waterford City,2012,5 - 9 years,0,1,1
Waterford City,2012,50 - 54 years,0,7,7
Waterford City,2012,55 - 59 years,7,4,11
Waterford City,2012,60 - 64 years,6,8,14
Waterford City,2012,65 - 69 years,5,14,19
Waterford City,2012,70 - 74 years,13,10,23
Waterford City,2012,75 - 79 years,19,21,40
Waterford City,2012,80 - 84 years,33,13,46
Waterford City,2012,85 years and over,69,29,98
Waterford City,2012,Under 1 year,3,1,4
Waterford City,2013,1 - 4 years,0,2,2
Waterford City,2013,10 - 14 years,0,0,0
Waterford City,2013,15 - 19 years,1,0,1
Waterford City,2013,20 - 24 years,0,0,0
Waterford City,2013,25 - 29 years,1,1,2
Waterford City,2013,30 - 34 years,0,2,2
Waterford City,2013,35 - 39 years,1,1,2
Waterford City,2013,40 - 44 years,3,1,4
Waterford City,2013,45 - 49 years,5,5,10
Waterford City,2013,5 - 9 years,0,0,0
Waterford City,2013,50 - 54 years,4,2,6
Waterford City,2013,55 - 59 years,5,13,18
Waterford City,2013,60 - 64 years,6,4,10
Waterford City,2013,65 - 69 years,9,19,28
Waterford City,2013,70 - 74 years,22,25,47
Waterford City,2013,75 - 79 years,22,27,49
Waterford City,2013,80 - 84 years,26,33,59
Waterford City,2013,85 years and over,71,33,104
Waterford City,2013,Under 1 year,2,2,4
Waterford City,2014,1 - 4 years,0,1,1
Waterford City,2014,10 - 14 years,0,0,0
Waterford City,2014,15 - 19 years,1,0,1
Waterford City,2014,20 - 24 years,0,2,2
Waterford City,2014,25 - 29 years,1,1,2
Waterford City,2014,30 - 34 years,0,3,3
Waterford City,2014,35 - 39 years,1,2,3
Waterford City,2014,40 - 44 years,3,3,6
Waterford City,2014,45 - 49 years,8,4,12
Waterford City,2014,5 - 9 years,0,1,1
Waterford City,2014,50 - 54 years,7,1,8
Waterford City,2014,55 - 59 years,10,12,22
Waterford City,2014,60 - 64 years,7,10,17
Waterford City,2014,65 - 69 years,17,19,36
Waterford City,2014,70 - 74 years,10,17,27
Waterford City,2014,75 - 79 years,15,31,46
Waterford City,2014,80 - 84 years,28,37,65
Waterford City,2014,85 years and over,60,33,93
Waterford City,2014,Under 1 year,1,1,2
Waterford City,2015,1 - 4 years,0,1,1
Waterford City,2015,10 - 14 years,0,0,0
Waterford City,2015,15 - 19 years,1,0,1
Waterford City,2015,20 - 24 years,0,2,2
Waterford City,2015,25 - 29 years,4,4,8
Waterford City,2015,30 - 34 years,1,3,4
Waterford City,2015,35 - 39 years,2,2,4
Waterford City,2015,40 - 44 years,5,6,11
Waterford City,2015,45 - 49 years,2,3,5
Waterford City,2015,5 - 9 years,0,2,2
Waterford City,2015,50 - 54 years,4,10,14
Waterford City,2015,55 - 59 years,5,7,12
Waterford City,2015,60 - 64 years,8,15,23
Waterford City,2015,65 - 69 years,8,17,25
Waterford City,2015,70 - 74 years,11,30,41
Waterford City,2015,75 - 79 years,28,27,55
Waterford City,2015,80 - 84 years,23,32,55
Waterford City,2015,85 years and over,81,32,113
Waterford City,2015,Under 1 year,1,1,2
Waterford City,2016,1 - 4 years,0,1,1
Waterford City,2016,10 - 14 years,0,0,0
Waterford City,2016,15 - 19 years,1,0,1
Waterford City,2016,20 - 24 years,0,1,1
Waterford City,2016,25 - 29 years,4,2,6
Waterford City,2016,30 - 34 years,1,1,2
Waterford City,2016,35 - 39 years,2,3,5
Waterford City,2016,40 - 44 years,5,1,6
Waterford City,2016,45 - 49 years,4,6,10
Waterford City,2016,5 - 9 years,0,2,2
Waterford City,2016,50 - 54 years,2,10,12
Waterford City,2016,55 - 59 years,2,4,6
Waterford City,2016,60 - 64 years,5,11,16
Waterford City,2016,65 - 69 years,5,17,22
Waterford City,2016,70 - 74 years,17,24,41
Waterford City,2016,75 - 79 years,24,35,59
Waterford City,2016,80 - 84 years,39,30,69
Waterford City,2016,85 years and over,80,37,117
Waterford City,2016,Under 1 year,1,2,3
Waterford City,2017,1 - 4 years,0,1,1
Waterford City,2017,10 - 14 years,0,0,0
Waterford City,2017,15 - 19 years,1,1,2
Waterford City,2017,20 - 24 years,1,1,2
Waterford City,2017,25 - 29 years,1,2,3
Waterford City,2017,30 - 34 years,4,1,5
Waterford City,2017,35 - 39 years,2,2,4
Waterford City,2017,40 - 44 years,5,3,8
Waterford City,2017,45 - 49 years,1,5,6
Waterford City,2017,5 - 9 years,0,2,2
Waterford City,2017,50 - 54 years,3,8,11
Waterford City,2017,55 - 59 years,4,4,8
Waterford City,2017,60 - 64 years,3,7,10
Waterford City,2017,65 - 69 years,3,18,21
Waterford City,2017,70 - 74 years,12,18,30
Waterford City,2017,75 - 79 years,26,27,53
Waterford City,2017,80 - 84 years,31,30,61
Waterford City,2017,85 years and over,63,43,106
Waterford City,2017,Under 1 year,1,2,3
Waterford City,2018,1 - 4 years,0,0,0
Waterford City,2018,10 - 14 years,0,0,0
Waterford City,2018,15 - 19 years,0,0,0
Waterford City,2018,20 - 24 years,0,0,0
Waterford City,2018,25 - 29 years,1,0,1
Waterford City,2018,30 - 34 years,0,3,3
Waterford City,2018,35 - 39 years,3,1,4
Waterford City,2018,40 - 44 years,4,6,10
Waterford City,2018,45 - 49 years,3,4,7
Waterford City,2018,5 - 9 years,0,0,0
Waterford City,2018,50 - 54 years,5,7,12
Waterford City,2018,55 - 59 years,9,12,21
Waterford City,2018,60 - 64 years,8,11,19
Waterford City,2018,65 - 69 years,12,9,21
Waterford City,2018,70 - 74 years,20,25,45
Waterford City,2018,75 - 79 years,18,27,45
Waterford City,2018,80 - 84 years,32,28,60
Waterford City,2018,85 years and over,58,42,100
Waterford City,2018,Under 1 year,0,1,1
Waterford City,2019,1 - 4 years,0,0,0
Waterford City,2019,10 - 14 years,0,0,0
Waterford City,2019,15 - 19 years,0,0,0
Waterford City,2019,20 - 24 years,0,0,0
Waterford City,2019,25 - 29 years,2,0,2
Waterford City,2019,30 - 34 years,0,3,3
Waterford City,2019,35 - 39 years,1,0,1
Waterford City,2019,40 - 44 years,1,6,7
Waterford City,2019,45 - 49 years,3,5,8
Waterford City,2019,5 - 9 years,0,0,0
Waterford City,2019,50 - 54 years,5,8,13
Waterford City,2019,55 - 59 years,3,14,17
Waterford City,2019,60 - 64 years,6,8,14
Waterford City,2019,65 - 69 years,13,10,23
Waterford City,2019,70 - 74 years,24,22,46
Waterford City,2019,75 - 79 years,20,25,45
Waterford City,2019,80 - 84 years,38,23,61
Waterford City,2019,85 years and over,65,38,103
Waterford City,2019,Under 1 year,1,1,2
Waterford City,2020,1 - 4 years,0,1,1
Waterford City,2020,10 - 14 years,0,0,0
Waterford City,2020,15 - 19 years,0,0,0
Waterford City,2020,20 - 24 years,0,0,0
Waterford City,2020,25 - 29 years,1,1,2
Waterford City,2020,30 - 34 years,1,1,2
Waterford City,2020,35 - 39 years,1,1,2
Waterford City,2020,40 - 44 years,1,2,3
Waterford City,2020,45 - 49 years,3,2,5
Waterford City,2020,5 - 9 years,0,1,1
Waterford City,2020,50 - 54 years,7,6,13
Waterford City,2020,55 - 59 years,6,8,14
Waterford City,2020,60 - 64 years,6,10,16
Waterford City,2020,65 - 69 years,11,14,25
Waterford City,2020,70 - 74 years,13,24,37
Waterford City,2020,75 - 79 years,20,20,40
Waterford City,2020,80 - 84 years,25,32,57
Waterford City,2020,85 years and over,71,37,108
Waterford City,2020,Under 1 year,1,2,3
Waterford County,2007,1 - 4 years,1,1,2
Waterford County,2007,10 - 14 years,1,1,2
Waterford County,2007,15 - 19 years,1,1,2
Waterford County,2007,20 - 24 years,0,3,3
Waterford County,2007,25 - 29 years,3,0,3
Waterford County,2007,30 - 34 years,1,1,2
Waterford County,2007,35 - 39 years,1,2,3
Waterford County,2007,40 - 44 years,2,2,4
Waterford County,2007,45 - 49 years,2,10,12
Waterford County,2007,5 - 9 years,0,0,0
Waterford County,2007,50 - 54 years,6,5,11
Waterford County,2007,55 - 59 years,11,5,16
Waterford County,2007,60 - 64 years,13,16,29
Waterford County,2007,65 - 69 years,11,22,33
Waterford County,2007,70 - 74 years,17,22,39
Waterford County,2007,75 - 79 years,34,27,61
Waterford County,2007,80 - 84 years,38,38,76
Waterford County,2007,85 years and over,87,46,133
Waterford County,2007,Under 1 year,1,1,2
Waterford County,2008,1 - 4 years,1,1,2
Waterford County,2008,10 - 14 years,1,1,2
Waterford County,2008,15 - 19 years,1,1,2
Waterford County,2008,20 - 24 years,1,3,4
Waterford County,2008,25 - 29 years,1,3,4
Waterford County,2008,30 - 34 years,1,4,5
Waterford County,2008,35 - 39 years,4,3,7
Waterford County,2008,40 - 44 years,2,3,5
Waterford County,2008,45 - 49 years,2,6,8
Waterford County,2008,5 - 9 years,1,1,2
Waterford County,2008,50 - 54 years,5,8,13
Waterford County,2008,55 - 59 years,7,12,19
Waterford County,2008,60 - 64 years,11,12,23
Waterford County,2008,65 - 69 years,18,26,44
Waterford County,2008,70 - 74 years,15,24,39
Waterford County,2008,75 - 79 years,22,27,49
Waterford County,2008,80 - 84 years,38,38,76
Waterford County,2008,85 years and over,89,58,147
Waterford County,2008,Under 1 year,3,3,6
Waterford County,2009,1 - 4 years,1,1,2
Waterford County,2009,10 - 14 years,2,1,3
Waterford County,2009,15 - 19 years,1,1,2
Waterford County,2009,20 - 24 years,2,1,3
Waterford County,2009,25 - 29 years,1,3,4
Waterford County,2009,30 - 34 years,2,4,6
Waterford County,2009,35 - 39 years,1,5,6
Waterford County,2009,40 - 44 years,2,5,7
Waterford County,2009,45 - 49 years,3,5,8
Waterford County,2009,5 - 9 years,1,1,2
Waterford County,2009,50 - 54 years,5,7,12
Waterford County,2009,55 - 59 years,14,11,25
Waterford County,2009,60 - 64 years,11,17,28
Waterford County,2009,65 - 69 years,11,21,32
Waterford County,2009,70 - 74 years,21,32,53
Waterford County,2009,75 - 79 years,23,36,59
Waterford County,2009,80 - 84 years,47,55,102
Waterford County,2009,85 years and over,92,46,138
Waterford County,2009,Under 1 year,3,2,5
Waterford County,2010,1 - 4 years,1,1,2
Waterford County,2010,10 - 14 years,2,1,3
Waterford County,2010,15 - 19 years,1,1,2
Waterford County,2010,20 - 24 years,2,1,3
Waterford County,2010,25 - 29 years,1,2,3
Waterford County,2010,30 - 34 years,1,5,6
Waterford County,2010,35 - 39 years,1,6,7
Waterford County,2010,40 - 44 years,4,1,5
Waterford County,2010,45 - 49 years,4,5,9
Waterford County,2010,5 - 9 years,1,1,2
Waterford County,2010,50 - 54 years,5,8,13
Waterford County,2010,55 - 59 years,11,9,20
Waterford County,2010,60 - 64 years,10,23,33
Waterford County,2010,65 - 69 years,10,18,28
Waterford County,2010,70 - 74 years,15,24,39
Waterford County,2010,75 - 79 years,23,44,67
Waterford County,2010,80 - 84 years,46,39,85
Waterford County,2010,85 years and over,93,45,138
Waterford County,2010,Under 1 year,1,2,3
Waterford County,2011,1 - 4 years,0,0,0
Waterford County,2011,10 - 14 years,0,0,0
Waterford County,2011,15 - 19 years,1,1,2
Waterford County,2011,20 - 24 years,1,0,1
Waterford County,2011,25 - 29 years,0,4,4
Waterford County,2011,30 - 34 years,2,1,3
Waterford County,2011,35 - 39 years,2,3,5
Waterford County,2011,40 - 44 years,0,1,1
Waterford County,2011,45 - 49 years,6,5,11
Waterford County,2011,5 - 9 years,1,0,1
Waterford County,2011,50 - 54 years,3,14,17
Waterford County,2011,55 - 59 years,4,12,16
Waterford County,2011,60 - 64 years,12,18,30
Waterford County,2011,65 - 69 years,13,22,35
Waterford County,2011,70 - 74 years,18,34,52
Waterford County,2011,75 - 79 years,30,33,63
Waterford County,2011,80 - 84 years,43,44,87
Waterford County,2011,85 years and over,75,44,119
Waterford County,2011,Under 1 year,0,5,5
Waterford County,2012,1 - 4 years,0,0,0
Waterford County,2012,10 - 14 years,1,0,1
Waterford County,2012,15 - 19 years,1,2,3
Waterford County,2012,20 - 24 years,1,4,5
Waterford County,2012,25 - 29 years,0,2,2
Waterford County,2012,30 - 34 years,1,2,3
Waterford County,2012,35 - 39 years,2,3,5
Waterford County,2012,40 - 44 years,2,2,4
Waterford County,2012,45 - 49 years,4,3,7
Waterford County,2012,5 - 9 years,1,0,1
Waterford County,2012,50 - 54 years,7,10,17
Waterford County,2012,55 - 59 years,9,5,14
Waterford County,2012,60 - 64 years,9,19,28
Waterford County,2012,65 - 69 years,12,23,35
Waterford County,2012,70 - 74 years,21,22,43
Waterford County,2012,75 - 79 years,32,39,71
Waterford County,2012,80 - 84 years,38,53,91
Waterford County,2012,85 years and over,104,64,168
Waterford County,2012,Under 1 year,1,3,4
Waterford County,2013,1 - 4 years,2,0,2
Waterford County,2013,10 - 14 years,0,0,0
Waterford County,2013,15 - 19 years,0,0,0
Waterford County,2013,20 - 24 years,1,1,2
Waterford County,2013,25 - 29 years,0,2,2
Waterford County,2013,30 - 34 years,0,0,0
Waterford County,2013,35 - 39 years,3,4,7
Waterford County,2013,40 - 44 years,1,6,7
Waterford County,2013,45 - 49 years,3,7,10
Waterford County,2013,5 - 9 years,0,0,0
Waterford County,2013,50 - 54 years,3,10,13
Waterford County,2013,55 - 59 years,10,14,24
Waterford County,2013,60 - 64 years,10,11,21
Waterford County,2013,65 - 69 years,9,19,28
Waterford County,2013,70 - 74 years,20,37,57
Waterford County,2013,75 - 79 years,26,41,67
Waterford County,2013,80 - 84 years,32,38,70
Waterford County,2013,85 years and over,87,63,150
Waterford County,2013,Under 1 year,3,1,4
Waterford County,2014,1 - 4 years,1,1,2
Waterford County,2014,10 - 14 years,0,0,0
Waterford County,2014,15 - 19 years,0,1,1
Waterford County,2014,20 - 24 years,1,3,4
Waterford County,2014,25 - 29 years,0,2,2
Waterford County,2014,30 - 34 years,0,3,3
Waterford County,2014,35 - 39 years,3,3,6
Waterford County,2014,40 - 44 years,2,3,5
Waterford County,2014,45 - 49 years,5,2,7
Waterford County,2014,5 - 9 years,0,0,0
Waterford County,2014,50 - 54 years,7,11,18
Waterford County,2014,55 - 59 years,10,10,20
Waterford County,2014,60 - 64 years,12,21,33
Waterford County,2014,65 - 69 years,11,24,35
Waterford County,2014,70 - 74 years,20,25,45
Waterford County,2014,75 - 79 years,24,29,53
Waterford County,2014,80 - 84 years,35,40,75
Waterford County,2014,85 years and over,100,64,164
Waterford County,2014,Under 1 year,3,2,5
Waterford County,2015,1 - 4 years,1,1,2
Waterford County,2015,10 - 14 years,0,0,0
Waterford County,2015,15 - 19 years,0,1,1
Waterford County,2015,20 - 24 years,1,2,3
Waterford County,2015,25 - 29 years,0,2,2
Waterford County,2015,30 - 34 years,3,3,6
Waterford County,2015,35 - 39 years,3,3,6
Waterford County,2015,40 - 44 years,2,5,7
Waterford County,2015,45 - 49 years,4,2,6
Waterford County,2015,5 - 9 years,0,0,0
Waterford County,2015,50 - 54 years,6,6,12
Waterford County,2015,55 - 59 years,9,8,17
Waterford County,2015,60 - 64 years,5,9,14
Waterford County,2015,65 - 69 years,11,22,33
Waterford County,2015,70 - 74 years,22,24,46
Waterford County,2015,75 - 79 years,27,24,51
Waterford County,2015,80 - 84 years,29,37,66
Waterford County,2015,85 years and over,105,62,167
Waterford County,2015,Under 1 year,3,2,5
Waterford County,2016,1 - 4 years,1,1,2
Waterford County,2016,10 - 14 years,0,0,0
Waterford County,2016,15 - 19 years,0,1,1
Waterford County,2016,20 - 24 years,1,2,3
Waterford County,2016,25 - 29 years,1,2,3
Waterford County,2016,30 - 34 years,1,1,2
Waterford County,2016,35 - 39 years,1,2,3
Waterford County,2016,40 - 44 years,3,3,6
Waterford County,2016,45 - 49 years,2,3,5
Waterford County,2016,5 - 9 years,0,0,0
Waterford County,2016,50 - 54 years,3,5,8
Waterford County,2016,55 - 59 years,5,12,17
Waterford County,2016,60 - 64 years,7,8,15
Waterford County,2016,65 - 69 years,11,25,36
Waterford County,2016,70 - 74 years,24,28,52
Waterford County,2016,75 - 79 years,19,41,60
Waterford County,2016,80 - 84 years,34,48,82
Waterford County,2016,85 years and over,92,85,177
Waterford County,2016,Under 1 year,3,3,6
Waterford County,2017,1 - 4 years,1,1,2
Waterford County,2017,10 - 14 years,1,1,2
Waterford County,2017,15 - 19 years,1,1,2
Waterford County,2017,20 - 24 years,1,1,2
Waterford County,2017,25 - 29 years,1,1,2
Waterford County,2017,30 - 34 years,1,2,3
Waterford County,2017,35 - 39 years,2,2,4
Waterford County,2017,40 - 44 years,1,4,5
Waterford County,2017,45 - 49 years,2,4,6
Waterford County,2017,5 - 9 years,1,0,1
Waterford County,2017,50 - 54 years,7,9,16
Waterford County,2017,55 - 59 years,7,9,16
Waterford County,2017,60 - 64 years,5,13,18
Waterford County,2017,65 - 69 years,8,15,23
Waterford County,2017,70 - 74 years,13,27,40
Waterford County,2017,75 - 79 years,21,43,64
Waterford County,2017,80 - 84 years,28,38,66
Waterford County,2017,85 years and over,94,77,171
Waterford County,2017,Under 1 year,2,1,3
Waterford County,2018,1 - 4 years,0,0,0
Waterford County,2018,10 - 14 years,0,0,0
Waterford County,2018,15 - 19 years,1,2,3
Waterford County,2018,20 - 24 years,0,1,1
Waterford County,2018,25 - 29 years,0,1,1
Waterford County,2018,30 - 34 years,0,2,2
Waterford County,2018,35 - 39 years,1,5,6
Waterford County,2018,40 - 44 years,2,7,9
Waterford County,2018,45 - 49 years,2,6,8
Waterford County,2018,5 - 9 years,0,0,0
Waterford County,2018,50 - 54 years,3,7,10
Waterford County,2018,55 - 59 years,6,7,13
Waterford County,2018,60 - 64 years,7,13,20
Waterford County,2018,65 - 69 years,5,21,26
Waterford County,2018,70 - 74 years,18,27,45
Waterford County,2018,75 - 79 years,31,38,69
Waterford County,2018,80 - 84 years,40,44,84
Waterford County,2018,85 years and over,111,66,177
Waterford County,2018,Under 1 year,0,0,0
Waterford County,2019,1 - 4 years,0,0,0
Waterford County,2019,10 - 14 years,0,0,0
Waterford County,2019,15 - 19 years,0,2,2
Waterford County,2019,20 - 24 years,0,0,0
Waterford County,2019,25 - 29 years,0,2,2
Waterford County,2019,30 - 34 years,0,1,1
Waterford County,2019,35 - 39 years,1,6,7
Waterford County,2019,40 - 44 years,3,6,9
Waterford County,2019,45 - 49 years,5,6,11
Waterford County,2019,5 - 9 years,0,1,1
Waterford County,2019,50 - 54 years,7,7,14
Waterford County,2019,55 - 59 years,7,9,16
Waterford County,2019,60 - 64 years,9,17,26
Waterford County,2019,65 - 69 years,11,20,31
Waterford County,2019,70 - 74 years,26,29,55
Waterford County,2019,75 - 79 years,20,40,60
Waterford County,2019,80 - 84 years,33,48,81
Waterford County,2019,85 years and over,99,70,169
Waterford County,2019,Under 1 year,0,0,0
Waterford County,2020,1 - 4 years,1,0,1
Waterford County,2020,10 - 14 years,0,0,0
Waterford County,2020,15 - 19 years,1,2,3
Waterford County,2020,20 - 24 years,1,1,2
Waterford County,2020,25 - 29 years,0,2,2
Waterford County,2020,30 - 34 years,0,1,1
Waterford County,2020,35 - 39 years,1,2,3
Waterford County,2020,40 - 44 years,2,4,6
Waterford County,2020,45 - 49 years,4,4,8
Waterford County,2020,5 - 9 years,0,1,1
Waterford County,2020,50 - 54 years,2,9,11
Waterford County,2020,55 - 59 years,11,8,19
Waterford County,2020,60 - 64 years,11,16,27
Waterford County,2020,65 - 69 years,16,24,40
Waterford County,2020,70 - 74 years,24,31,55
Waterford County,2020,75 - 79 years,20,40,60
Waterford County,2020,80 - 84 years,38,50,88
Waterford County,2020,85 years and over,109,72,181
Waterford County,2020,Under 1 year,1,4,5
Westmeath,2007,1 - 4 years,1,1,2
Westmeath,2007,10 - 14 years,0,0,0
Westmeath,2007,15 - 19 years,2,3,5
Westmeath,2007,20 - 24 years,1,3,4
Westmeath,2007,25 - 29 years,1,3,4
Westmeath,2007,30 - 34 years,2,2,4
Westmeath,2007,35 - 39 years,0,5,5
Westmeath,2007,40 - 44 years,2,6,8
Westmeath,2007,45 - 49 years,2,3,5
Westmeath,2007,5 - 9 years,0,0,0
Westmeath,2007,50 - 54 years,11,10,21
Westmeath,2007,55 - 59 years,9,20,29
Westmeath,2007,60 - 64 years,8,19,27
Westmeath,2007,65 - 69 years,13,23,36
Westmeath,2007,70 - 74 years,26,27,53
Westmeath,2007,75 - 79 years,37,47,84
Westmeath,2007,80 - 84 years,46,31,77
Westmeath,2007,85 years and over,95,62,157
Westmeath,2007,Under 1 year,2,3,5
Westmeath,2008,1 - 4 years,1,1,2
Westmeath,2008,10 - 14 years,0,0,0
Westmeath,2008,15 - 19 years,2,3,5
Westmeath,2008,20 - 24 years,3,1,4
Westmeath,2008,25 - 29 years,1,6,7
Westmeath,2008,30 - 34 years,1,2,3
Westmeath,2008,35 - 39 years,2,1,3
Westmeath,2008,40 - 44 years,3,1,4
Westmeath,2008,45 - 49 years,6,6,12
Westmeath,2008,5 - 9 years,0,0,0
Westmeath,2008,50 - 54 years,13,8,21
Westmeath,2008,55 - 59 years,11,14,25
Westmeath,2008,60 - 64 years,10,24,34
Westmeath,2008,65 - 69 years,10,28,38
Westmeath,2008,70 - 74 years,16,32,48
Westmeath,2008,75 - 79 years,30,42,72
Westmeath,2008,80 - 84 years,49,40,89
Westmeath,2008,85 years and over,117,45,162
Westmeath,2008,Under 1 year,2,2,4
Westmeath,2009,1 - 4 years,1,1,2
Westmeath,2009,10 - 14 years,0,0,0
Westmeath,2009,15 - 19 years,1,3,4
Westmeath,2009,20 - 24 years,2,1,3
Westmeath,2009,25 - 29 years,1,4,5
Westmeath,2009,30 - 34 years,2,3,5
Westmeath,2009,35 - 39 years,1,6,7
Westmeath,2009,40 - 44 years,3,5,8
Westmeath,2009,45 - 49 years,5,14,19
Westmeath,2009,5 - 9 years,1,0,1
Westmeath,2009,50 - 54 years,5,7,12
Westmeath,2009,55 - 59 years,10,17,27
Westmeath,2009,60 - 64 years,6,20,26
Westmeath,2009,65 - 69 years,10,20,30
Westmeath,2009,70 - 74 years,22,26,48
Westmeath,2009,75 - 79 years,37,31,68
Westmeath,2009,80 - 84 years,49,47,96
Westmeath,2009,85 years and over,94,53,147
Westmeath,2009,Under 1 year,2,5,7
Westmeath,2010,1 - 4 years,1,1,2
Westmeath,2010,10 - 14 years,0,0,0
Westmeath,2010,15 - 19 years,1,2,3
Westmeath,2010,20 - 24 years,2,4,6
Westmeath,2010,25 - 29 years,2,2,4
Westmeath,2010,30 - 34 years,1,2,3
Westmeath,2010,35 - 39 years,1,8,9
Westmeath,2010,40 - 44 years,1,1,2
Westmeath,2010,45 - 49 years,1,6,7
Westmeath,2010,5 - 9 years,1,0,1
Westmeath,2010,50 - 54 years,11,11,22
Westmeath,2010,55 - 59 years,9,10,19
Westmeath,2010,60 - 64 years,13,26,39
Westmeath,2010,65 - 69 years,15,25,40
Westmeath,2010,70 - 74 years,21,31,52
Westmeath,2010,75 - 79 years,31,34,65
Westmeath,2010,80 - 84 years,43,50,93
Westmeath,2010,85 years and over,108,70,178
Westmeath,2010,Under 1 year,2,1,3
Westmeath,2011,1 - 4 years,2,0,2
Westmeath,2011,10 - 14 years,0,0,0
Westmeath,2011,15 - 19 years,0,0,0
Westmeath,2011,20 - 24 years,0,1,1
Westmeath,2011,25 - 29 years,3,3,6
Westmeath,2011,30 - 34 years,0,7,7
Westmeath,2011,35 - 39 years,2,1,3
Westmeath,2011,40 - 44 years,5,3,8
Westmeath,2011,45 - 49 years,6,4,10
Westmeath,2011,5 - 9 years,0,0,0
Westmeath,2011,50 - 54 years,8,10,18
Westmeath,2011,55 - 59 years,12,13,25
Westmeath,2011,60 - 64 years,13,16,29
Westmeath,2011,65 - 69 years,13,27,40
Westmeath,2011,70 - 74 years,24,30,54
Westmeath,2011,75 - 79 years,35,49,84
Westmeath,2011,80 - 84 years,45,41,86
Westmeath,2011,85 years and over,105,66,171
Westmeath,2011,Under 1 year,3,3,6
Westmeath,2012,1 - 4 years,2,0,2
Westmeath,2012,10 - 14 years,0,0,0
Westmeath,2012,15 - 19 years,0,1,1
Westmeath,2012,20 - 24 years,0,2,2
Westmeath,2012,25 - 29 years,3,4,7
Westmeath,2012,30 - 34 years,0,2,2
Westmeath,2012,35 - 39 years,2,1,3
Westmeath,2012,40 - 44 years,5,4,9
Westmeath,2012,45 - 49 years,3,5,8
Westmeath,2012,5 - 9 years,0,0,0
Westmeath,2012,50 - 54 years,7,6,13
Westmeath,2012,55 - 59 years,8,17,25
Westmeath,2012,60 - 64 years,13,11,24
Westmeath,2012,65 - 69 years,21,31,52
Westmeath,2012,70 - 74 years,30,33,63
Westmeath,2012,75 - 79 years,35,39,74
Westmeath,2012,80 - 84 years,50,54,104
Westmeath,2012,85 years and over,140,73,213
Westmeath,2012,Under 1 year,2,5,7
Westmeath,2013,1 - 4 years,0,0,0
Westmeath,2013,10 - 14 years,0,0,0
Westmeath,2013,15 - 19 years,0,0,0
Westmeath,2013,20 - 24 years,1,1,2
Westmeath,2013,25 - 29 years,1,4,5
Westmeath,2013,30 - 34 years,1,6,7
Westmeath,2013,35 - 39 years,3,6,9
Westmeath,2013,40 - 44 years,3,6,9
Westmeath,2013,45 - 49 years,3,4,7
Westmeath,2013,5 - 9 years,1,0,1
Westmeath,2013,50 - 54 years,4,8,12
Westmeath,2013,55 - 59 years,11,11,22
Westmeath,2013,60 - 64 years,12,29,41
Westmeath,2013,65 - 69 years,15,22,37
Westmeath,2013,70 - 74 years,15,36,51
Westmeath,2013,75 - 79 years,33,39,72
Westmeath,2013,80 - 84 years,50,59,109
Westmeath,2013,85 years and over,121,88,209
Westmeath,2013,Under 1 year,2,6,8
Westmeath,2014,1 - 4 years,0,0,0
Westmeath,2014,10 - 14 years,0,1,1
Westmeath,2014,15 - 19 years,0,0,0
Westmeath,2014,20 - 24 years,1,2,3
Westmeath,2014,25 - 29 years,2,2,4
Westmeath,2014,30 - 34 years,1,4,5
Westmeath,2014,35 - 39 years,3,6,9
Westmeath,2014,40 - 44 years,1,5,6
Westmeath,2014,45 - 49 years,7,10,17
Westmeath,2014,5 - 9 years,1,1,2
Westmeath,2014,50 - 54 years,9,9,18
Westmeath,2014,55 - 59 years,6,13,19
Westmeath,2014,60 - 64 years,10,17,27
Westmeath,2014,65 - 69 years,19,23,42
Westmeath,2014,70 - 74 years,20,35,55
Westmeath,2014,75 - 79 years,26,47,73
Westmeath,2014,80 - 84 years,54,60,114
Westmeath,2014,85 years and over,136,84,220
Westmeath,2014,Under 1 year,2,1,3
Westmeath,2015,1 - 4 years,1,0,1
Westmeath,2015,10 - 14 years,0,1,1
Westmeath,2015,15 - 19 years,1,0,1
Westmeath,2015,20 - 24 years,1,3,4
Westmeath,2015,25 - 29 years,2,2,4
Westmeath,2015,30 - 34 years,1,4,5
Westmeath,2015,35 - 39 years,1,3,4
Westmeath,2015,40 - 44 years,3,1,4
Westmeath,2015,45 - 49 years,5,5,10
Westmeath,2015,5 - 9 years,1,1,2
Westmeath,2015,50 - 54 years,4,12,16
Westmeath,2015,55 - 59 years,6,9,15
Westmeath,2015,60 - 64 years,9,10,19
Westmeath,2015,65 - 69 years,17,24,41
Westmeath,2015,70 - 74 years,28,26,54
Westmeath,2015,75 - 79 years,26,50,76
Westmeath,2015,80 - 84 years,34,40,74
Westmeath,2015,85 years and over,137,89,226
Westmeath,2015,Under 1 year,2,3,5
Westmeath,2016,1 - 4 years,1,0,1
Westmeath,2016,10 - 14 years,0,1,1
Westmeath,2016,15 - 19 years,1,2,3
Westmeath,2016,20 - 24 years,1,2,3
Westmeath,2016,25 - 29 years,2,5,7
Westmeath,2016,30 - 34 years,1,2,3
Westmeath,2016,35 - 39 years,5,4,9
Westmeath,2016,40 - 44 years,5,4,9
Westmeath,2016,45 - 49 years,3,5,8
Westmeath,2016,5 - 9 years,1,1,2
Westmeath,2016,50 - 54 years,3,6,9
Westmeath,2016,55 - 59 years,11,14,25
Westmeath,2016,60 - 64 years,12,26,38
Westmeath,2016,65 - 69 years,19,28,47
Westmeath,2016,70 - 74 years,35,29,64
Westmeath,2016,75 - 79 years,28,42,70
Westmeath,2016,80 - 84 years,47,55,102
Westmeath,2016,85 years and over,125,77,202
Westmeath,2016,Under 1 year,2,4,6
Westmeath,2017,1 - 4 years,1,0,1
Westmeath,2017,10 - 14 years,1,1,2
Westmeath,2017,15 - 19 years,1,2,3
Westmeath,2017,20 - 24 years,1,3,4
Westmeath,2017,25 - 29 years,2,5,7
Westmeath,2017,30 - 34 years,1,7,8
Westmeath,2017,35 - 39 years,5,2,7
Westmeath,2017,40 - 44 years,2,1,3
Westmeath,2017,45 - 49 years,3,4,7
Westmeath,2017,5 - 9 years,1,1,2
Westmeath,2017,50 - 54 years,6,8,14
Westmeath,2017,55 - 59 years,7,15,22
Westmeath,2017,60 - 64 years,8,14,22
Westmeath,2017,65 - 69 years,17,29,46
Westmeath,2017,70 - 74 years,21,35,56
Westmeath,2017,75 - 79 years,31,44,75
Westmeath,2017,80 - 84 years,56,48,104
Westmeath,2017,85 years and over,121,79,200
Westmeath,2017,Under 1 year,2,2,4
Westmeath,2018,1 - 4 years,0,0,0
Westmeath,2018,10 - 14 years,0,0,0
Westmeath,2018,15 - 19 years,0,2,2
Westmeath,2018,20 - 24 years,0,0,0
Westmeath,2018,25 - 29 years,1,2,3
Westmeath,2018,30 - 34 years,3,1,4
Westmeath,2018,35 - 39 years,1,2,3
Westmeath,2018,40 - 44 years,5,1,6
Westmeath,2018,45 - 49 years,5,8,13
Westmeath,2018,5 - 9 years,0,0,0
Westmeath,2018,50 - 54 years,7,10,17
Westmeath,2018,55 - 59 years,6,19,25
Westmeath,2018,60 - 64 years,12,24,36
Westmeath,2018,65 - 69 years,19,24,43
Westmeath,2018,70 - 74 years,26,38,64
Westmeath,2018,75 - 79 years,31,39,70
Westmeath,2018,80 - 84 years,40,53,93
Westmeath,2018,85 years and over,123,68,191
Westmeath,2018,Under 1 year,1,2,3
Westmeath,2019,1 - 4 years,0,0,0
Westmeath,2019,10 - 14 years,0,0,0
Westmeath,2019,15 - 19 years,0,1,1
Westmeath,2019,20 - 24 years,0,1,1
Westmeath,2019,25 - 29 years,1,1,2
Westmeath,2019,30 - 34 years,2,4,6
Westmeath,2019,35 - 39 years,2,5,7
Westmeath,2019,40 - 44 years,2,4,6
Westmeath,2019,45 - 49 years,5,5,10
Westmeath,2019,5 - 9 years,0,0,0
Westmeath,2019,50 - 54 years,9,12,21
Westmeath,2019,55 - 59 years,10,16,26
Westmeath,2019,60 - 64 years,15,25,40
Westmeath,2019,65 - 69 years,16,24,40
Westmeath,2019,70 - 74 years,24,40,64
Westmeath,2019,75 - 79 years,29,48,77
Westmeath,2019,80 - 84 years,38,44,82
Westmeath,2019,85 years and over,113,67,180
Westmeath,2019,Under 1 year,2,2,4
Westmeath,2020,1 - 4 years,0,0,0
Westmeath,2020,10 - 14 years,0,1,1
Westmeath,2020,15 - 19 years,1,1,2
Westmeath,2020,20 - 24 years,0,1,1
Westmeath,2020,25 - 29 years,1,2,3
Westmeath,2020,30 - 34 years,2,3,5
Westmeath,2020,35 - 39 years,5,7,12
Westmeath,2020,40 - 44 years,3,4,7
Westmeath,2020,45 - 49 years,3,4,7
Westmeath,2020,5 - 9 years,0,1,1
Westmeath,2020,50 - 54 years,6,9,15
Westmeath,2020,55 - 59 years,5,20,25
Westmeath,2020,60 - 64 years,18,26,44
Westmeath,2020,65 - 69 years,19,31,50
Westmeath,2020,70 - 74 years,36,39,75
Westmeath,2020,75 - 79 years,35,43,78
Westmeath,2020,80 - 84 years,43,44,87
Westmeath,2020,85 years and over,109,72,181
Westmeath,2020,Under 1 year,2,4,6
Westport Town,2007,1 - 4 years,0,0,0
Westport Town,2007,10 - 14 years,0,0,0
Westport Town,2007,15 - 19 years,1,0,1
Westport Town,2007,20 - 24 years,0,1,1
Westport Town,2007,25 - 29 years,0,0,0
Westport Town,2007,30 - 34 years,0,0,0
Westport Town,2007,35 - 39 years,0,0,0
Westport Town,2007,40 - 44 years,0,0,0
Westport Town,2007,45 - 49 years,0,0,0
Westport Town,2007,5 - 9 years,0,0,0
Westport Town,2007,50 - 54 years,0,3,3
Westport Town,2007,55 - 59 years,1,0,1
Westport Town,2007,60 - 64 years,1,2,3
Westport Town,2007,65 - 69 years,2,4,6
Westport Town,2007,70 - 74 years,4,6,10
Westport Town,2007,75 - 79 years,2,8,10
Westport Town,2007,80 - 84 years,8,6,14
Westport Town,2007,85 years and over,9,11,20
Westport Town,2007,Under 1 year,0,0,0
Westport Town,2008,1 - 4 years,0,0,0
Westport Town,2008,10 - 14 years,0,0,0
Westport Town,2008,15 - 19 years,1,2,3
Westport Town,2008,20 - 24 years,0,1,1
Westport Town,2008,25 - 29 years,1,1,2
Westport Town,2008,30 - 34 years,0,0,0
Westport Town,2008,35 - 39 years,0,0,0
Westport Town,2008,40 - 44 years,0,0,0
Westport Town,2008,45 - 49 years,0,0,0
Westport Town,2008,5 - 9 years,0,0,0
Westport Town,2008,50 - 54 years,1,1,2
Westport Town,2008,55 - 59 years,1,5,6
Westport Town,2008,60 - 64 years,1,7,8
Westport Town,2008,65 - 69 years,2,2,4
Westport Town,2008,70 - 74 years,3,4,7
Westport Town,2008,75 - 79 years,8,8,16
Westport Town,2008,80 - 84 years,12,9,21
Westport Town,2008,85 years and over,26,10,36
Westport Town,2008,Under 1 year,0,0,0
Westport Town,2009,1 - 4 years,0,0,0
Westport Town,2009,10 - 14 years,0,0,0
Westport Town,2009,15 - 19 years,1,1,2
Westport Town,2009,20 - 24 years,0,1,1
Westport Town,2009,25 - 29 years,1,1,2
Westport Town,2009,30 - 34 years,0,0,0
Westport Town,2009,35 - 39 years,0,1,1
Westport Town,2009,40 - 44 years,0,1,1
Westport Town,2009,45 - 49 years,0,0,0
Westport Town,2009,5 - 9 years,0,0,0
Westport Town,2009,50 - 54 years,1,1,2
Westport Town,2009,55 - 59 years,1,4,5
Westport Town,2009,60 - 64 years,1,7,8
Westport Town,2009,65 - 69 years,1,3,4
Westport Town,2009,70 - 74 years,4,4,8
Westport Town,2009,75 - 79 years,3,6,9
Westport Town,2009,80 - 84 years,2,9,11
Westport Town,2009,85 years and over,16,9,25
Westport Town,2009,Under 1 year,0,1,1
Westport Town,2010,1 - 4 years,0,0,0
Westport Town,2010,10 - 14 years,0,1,1
Westport Town,2010,15 - 19 years,1,1,2
Westport Town,2010,20 - 24 years,0,1,1
Westport Town,2010,25 - 29 years,1,1,2
Westport Town,2010,30 - 34 years,0,0,0
Westport Town,2010,35 - 39 years,0,1,1
Westport Town,2010,40 - 44 years,0,1,1
Westport Town,2010,45 - 49 years,0,0,0
Westport Town,2010,5 - 9 years,0,0,0
Westport Town,2010,50 - 54 years,2,1,3
Westport Town,2010,55 - 59 years,1,2,3
Westport Town,2010,60 - 64 years,3,1,4
Westport Town,2010,65 - 69 years,2,1,3
Westport Town,2010,70 - 74 years,3,1,4
Westport Town,2010,75 - 79 years,5,1,6
Westport Town,2010,80 - 84 years,2,4,6
Westport Town,2010,85 years and over,7,3,10
Westport Town,2010,Under 1 year,0,1,1
Westport Town,2011,1 - 4 years,0,0,0
Westport Town,2011,10 - 14 years,0,0,0
Westport Town,2011,15 - 19 years,0,1,1
Westport Town,2011,20 - 24 years,0,0,0
Westport Town,2011,25 - 29 years,0,0,0
Westport Town,2011,30 - 34 years,0,0,0
Westport Town,2011,35 - 39 years,0,0,0
Westport Town,2011,40 - 44 years,0,0,0
Westport Town,2011,45 - 49 years,0,0,0
Westport Town,2011,5 - 9 years,0,0,0
Westport Town,2011,50 - 54 years,0,0,0
Westport Town,2011,55 - 59 years,0,0,0
Westport Town,2011,60 - 64 years,1,1,2
Westport Town,2011,65 - 69 years,0,1,1
Westport Town,2011,70 - 74 years,2,0,2
Westport Town,2011,75 - 79 years,3,1,4
Westport Town,2011,80 - 84 years,3,5,8
Westport Town,2011,85 years and over,5,7,12
Westport Town,2011,Under 1 year,0,0,0
Westport Town,2012,1 - 4 years,0,0,0
Westport Town,2012,10 - 14 years,0,0,0
Westport Town,2012,15 - 19 years,0,1,1
Westport Town,2012,20 - 24 years,0,0,0
Westport Town,2012,25 - 29 years,0,0,0
Westport Town,2012,30 - 34 years,0,1,1
Westport Town,2012,35 - 39 years,1,1,2
Westport Town,2012,40 - 44 years,0,0,0
Westport Town,2012,45 - 49 years,0,2,2
Westport Town,2012,5 - 9 years,0,0,0
Westport Town,2012,50 - 54 years,2,1,3
Westport Town,2012,55 - 59 years,1,2,3
Westport Town,2012,60 - 64 years,3,2,5
Westport Town,2012,65 - 69 years,2,2,4
Westport Town,2012,70 - 74 years,1,4,5
Westport Town,2012,75 - 79 years,3,4,7
Westport Town,2012,80 - 84 years,9,9,18
Westport Town,2012,85 years and over,15,6,21
Westport Town,2012,Under 1 year,0,0,0
Westport Town,2013,1 - 4 years,0,0,0
Westport Town,2013,10 - 14 years,0,0,0
Westport Town,2013,15 - 19 years,1,0,1
Westport Town,2013,20 - 24 years,1,1,2
Westport Town,2013,25 - 29 years,0,0,0
Westport Town,2013,30 - 34 years,0,0,0
Westport Town,2013,35 - 39 years,0,0,0
Westport Town,2013,40 - 44 years,0,0,0
Westport Town,2013,45 - 49 years,0,0,0
Westport Town,2013,5 - 9 years,0,0,0
Westport Town,2013,50 - 54 years,0,0,0
Westport Town,2013,55 - 59 years,1,1,2
Westport Town,2013,60 - 64 years,2,3,5
Westport Town,2013,65 - 69 years,1,1,2
Westport Town,2013,70 - 74 years,2,0,2
Westport Town,2013,75 - 79 years,2,2,4
Westport Town,2013,80 - 84 years,5,2,7
Westport Town,2013,85 years and over,11,4,15
Westport Town,2013,Under 1 year,0,1,1
Westport Town,2014,1 - 4 years,1,0,1
Westport Town,2014,10 - 14 years,0,0,0
Westport Town,2014,15 - 19 years,1,0,1
Westport Town,2014,20 - 24 years,1,1,2
Westport Town,2014,25 - 29 years,0,0,0
Westport Town,2014,30 - 34 years,0,1,1
Westport Town,2014,35 - 39 years,0,0,0
Westport Town,2014,40 - 44 years,1,1,2
Westport Town,2014,45 - 49 years,0,0,0
Westport Town,2014,5 - 9 years,0,0,0
Westport Town,2014,50 - 54 years,0,1,1
Westport Town,2014,55 - 59 years,1,1,2
Westport Town,2014,60 - 64 years,2,1,3
Westport Town,2014,65 - 69 years,1,3,4
Westport Town,2014,70 - 74 years,1,3,4
Westport Town,2014,75 - 79 years,2,1,3
Westport Town,2014,80 - 84 years,1,7,8
Westport Town,2014,85 years and over,7,7,14
Westport Town,2014,Under 1 year,0,1,1
Westport Town,2015,1 - 4 years,1,0,1
Westport Town,2015,10 - 14 years,0,0,0
Westport Town,2015,15 - 19 years,1,0,1
Westport Town,2015,20 - 24 years,1,1,2
Westport Town,2015,25 - 29 years,0,0,0
Westport Town,2015,30 - 34 years,0,1,1
Westport Town,2015,35 - 39 years,0,0,0
Westport Town,2015,40 - 44 years,1,1,2
Westport Town,2015,45 - 49 years,0,0,0
Westport Town,2015,5 - 9 years,0,0,0
Westport Town,2015,50 - 54 years,0,1,1
Westport Town,2015,55 - 59 years,1,1,2
Westport Town,2015,60 - 64 years,2,1,3
Westport Town,2015,65 - 69 years,1,3,4
Westport Town,2015,70 - 74 years,1,3,4
Westport Town,2015,75 - 79 years,2,1,3
Westport Town,2015,80 - 84 years,1,7,8
Westport Town,2015,85 years and over,7,7,14
Westport Town,2015,Under 1 year,0,1,1
Westport Town,2016,1 - 4 years,1,0,1
Westport Town,2016,10 - 14 years,0,0,0
Westport Town,2016,15 - 19 years,1,0,1
Westport Town,2016,20 - 24 years,1,1,2
Westport Town,2016,25 - 29 years,0,0,0
Westport Town,2016,30 - 34 years,0,1,1
Westport Town,2016,35 - 39 years,0,0,0
Westport Town,2016,40 - 44 years,1,1,2
Westport Town,2016,45 - 49 years,0,0,0
Westport Town,2016,5 - 9 years,0,0,0
Westport Town,2016,50 - 54 years,0,1,1
Westport Town,2016,55 - 59 years,1,1,2
Westport Town,2016,60 - 64 years,2,1,3
Westport Town,2016,65 - 69 years,1,3,4
Westport Town,2016,70 - 74 years,1,3,4
Westport Town,2016,75 - 79 years,2,1,3
Westport Town,2016,80 - 84 years,1,7,8
Westport Town,2016,85 years and over,7,7,14
Westport Town,2016,Under 1 year,0,1,1
Westport Town,2017,1 - 4 years,1,0,1
Westport Town,2017,10 - 14 years,0,0,0
Westport Town,2017,15 - 19 years,1,0,1
Westport Town,2017,20 - 24 years,1,1,2
Westport Town,2017,25 - 29 years,0,0,0
Westport Town,2017,30 - 34 years,0,1,1
Westport Town,2017,35 - 39 years,0,0,0
Westport Town,2017,40 - 44 years,1,1,2
Westport Town,2017,45 - 49 years,0,2,2
Westport Town,2017,5 - 9 years,0,0,0
Westport Town,2017,50 - 54 years,0,2,2
Westport Town,2017,55 - 59 years,1,2,3
Westport Town,2017,60 - 64 years,3,1,4
Westport Town,2017,65 - 69 years,2,4,6
Westport Town,2017,70 - 74 years,1,1,2
Westport Town,2017,75 - 79 years,3,5,8
Westport Town,2017,80 - 84 years,6,5,11
Westport Town,2017,85 years and over,9,10,19
Westport Town,2017,Under 1 year,0,1,1
Westport Town,2018,1 - 4 years,0,0,0
Westport Town,2018,10 - 14 years,0,0,0
Westport Town,2018,15 - 19 years,0,0,0
Westport Town,2018,20 - 24 years,0,0,0
Westport Town,2018,25 - 29 years,0,0,0
Westport Town,2018,30 - 34 years,0,0,0
Westport Town,2018,35 - 39 years,0,1,1
Westport Town,2018,40 - 44 years,1,1,2
Westport Town,2018,45 - 49 years,0,0,0
Westport Town,2018,5 - 9 years,0,0,0
Westport Town,2018,50 - 54 years,1,0,1
Westport Town,2018,55 - 59 years,1,3,4
Westport Town,2018,60 - 64 years,2,5,7
Westport Town,2018,65 - 69 years,2,6,8
Westport Town,2018,70 - 74 years,1,4,5
Westport Town,2018,75 - 79 years,1,1,2
Westport Town,2018,80 - 84 years,5,10,15
Westport Town,2018,85 years and over,10,7,17
Westport Town,2018,Under 1 year,0,0,0
Westport Town,2019,1 - 4 years,0,0,0
Westport Town,2019,10 - 14 years,0,0,0
Westport Town,2019,15 - 19 years,0,0,0
Westport Town,2019,20 - 24 years,0,0,0
Westport Town,2019,25 - 29 years,0,0,0
Westport Town,2019,30 - 34 years,0,0,0
Westport Town,2019,35 - 39 years,0,1,1
Westport Town,2019,40 - 44 years,1,1,2
Westport Town,2019,45 - 49 years,0,0,0
Westport Town,2019,5 - 9 years,0,0,0
Westport Town,2019,50 - 54 years,1,0,1
Westport Town,2019,55 - 59 years,1,3,4
Westport Town,2019,60 - 64 years,2,5,7
Westport Town,2019,65 - 69 years,2,6,8
Westport Town,2019,70 - 74 years,1,4,5
Westport Town,2019,75 - 79 years,1,1,2
Westport Town,2019,80 - 84 years,5,10,15
Westport Town,2019,85 years and over,10,7,17
Westport Town,2019,Under 1 year,0,0,0
Westport Town,2020,1 - 4 years,0,0,0
Westport Town,2020,10 - 14 years,0,0,0
Westport Town,2020,15 - 19 years,0,0,0
Westport Town,2020,20 - 24 years,0,0,0
Westport Town,2020,25 - 29 years,0,0,0
Westport Town,2020,30 - 34 years,0,0,0
Westport Town,2020,35 - 39 years,0,1,1
Westport Town,2020,40 - 44 years,1,1,2
Westport Town,2020,45 - 49 years,0,0,0
Westport Town,2020,5 - 9 years,0,0,0
Westport Town,2020,50 - 54 years,1,0,1
Westport Town,2020,55 - 59 years,1,3,4
Westport Town,2020,60 - 64 years,2,5,7
Westport Town,2020,65 - 69 years,2,6,8
Westport Town,2020,70 - 74 years,1,4,5
Westport Town,2020,75 - 79 years,1,1,2
Westport Town,2020,80 - 84 years,5,10,15
Westport Town,2020,85 years and over,10,7,17
Westport Town,2020,Under 1 year,0,0,0
Wexford,2007,1 - 4 years,0,1,1
Wexford,2007,10 - 14 years,1,2,3
Wexford,2007,15 - 19 years,3,6,9
Wexford,2007,20 - 24 years,2,4,6
Wexford,2007,25 - 29 years,0,7,7
Wexford,2007,30 - 34 years,2,6,8
Wexford,2007,35 - 39 years,3,8,11
Wexford,2007,40 - 44 years,4,8,12
Wexford,2007,45 - 49 years,9,14,23
Wexford,2007,5 - 9 years,1,0,1
Wexford,2007,50 - 54 years,8,9,17
Wexford,2007,55 - 59 years,14,29,43
Wexford,2007,60 - 64 years,22,45,67
Wexford,2007,65 - 69 years,30,52,82
Wexford,2007,70 - 74 years,37,58,95
Wexford,2007,75 - 79 years,47,71,118
Wexford,2007,80 - 84 years,85,73,158
Wexford,2007,85 years and over,142,89,231
Wexford,2007,Under 1 year,6,6,12
Wexford,2008,1 - 4 years,0,1,1
Wexford,2008,10 - 14 years,1,2,3
Wexford,2008,15 - 19 years,2,5,7
Wexford,2008,20 - 24 years,1,5,6
Wexford,2008,25 - 29 years,2,6,8
Wexford,2008,30 - 34 years,4,6,10
Wexford,2008,35 - 39 years,3,6,9
Wexford,2008,40 - 44 years,5,11,16
Wexford,2008,45 - 49 years,10,10,20
Wexford,2008,5 - 9 years,2,1,3
Wexford,2008,50 - 54 years,6,21,27
Wexford,2008,55 - 59 years,15,32,47
Wexford,2008,60 - 64 years,20,30,50
Wexford,2008,65 - 69 years,29,60,89
Wexford,2008,70 - 74 years,40,55,95
Wexford,2008,75 - 79 years,52,80,132
Wexford,2008,80 - 84 years,79,82,161
Wexford,2008,85 years and over,170,72,242
Wexford,2008,Under 1 year,9,3,12
Wexford,2009,1 - 4 years,1,3,4
Wexford,2009,10 - 14 years,1,2,3
Wexford,2009,15 - 19 years,1,5,6
Wexford,2009,20 - 24 years,1,3,4
Wexford,2009,25 - 29 years,5,6,11
Wexford,2009,30 - 34 years,2,3,5
Wexford,2009,35 - 39 years,8,4,12
Wexford,2009,40 - 44 years,6,11,17
Wexford,2009,45 - 49 years,14,10,24
Wexford,2009,5 - 9 years,1,1,2
Wexford,2009,50 - 54 years,12,16,28
Wexford,2009,55 - 59 years,13,22,35
Wexford,2009,60 - 64 years,26,37,63
Wexford,2009,65 - 69 years,30,55,85
Wexford,2009,70 - 74 years,43,70,113
Wexford,2009,75 - 79 years,57,74,131
Wexford,2009,80 - 84 years,83,89,172
Wexford,2009,85 years and over,151,96,247
Wexford,2009,Under 1 year,5,6,11
Wexford,2010,1 - 4 years,1,3,4
Wexford,2010,10 - 14 years,3,2,5
Wexford,2010,15 - 19 years,1,4,5
Wexford,2010,20 - 24 years,3,5,8
Wexford,2010,25 - 29 years,5,1,6
Wexford,2010,30 - 34 years,2,5,7
Wexford,2010,35 - 39 years,5,7,12
Wexford,2010,40 - 44 years,7,11,18
Wexford,2010,45 - 49 years,8,11,19
Wexford,2010,5 - 9 years,2,1,3
Wexford,2010,50 - 54 years,7,21,28
Wexford,2010,55 - 59 years,16,30,46
Wexford,2010,60 - 64 years,20,36,56
Wexford,2010,65 - 69 years,29,51,80
Wexford,2010,70 - 74 years,37,59,96
Wexford,2010,75 - 79 years,64,84,148
Wexford,2010,80 - 84 years,77,70,147
Wexford,2010,85 years and over,189,96,285
Wexford,2010,Under 1 year,2,5,7
Wexford,2011,1 - 4 years,0,1,1
Wexford,2011,10 - 14 years,0,1,1
Wexford,2011,15 - 19 years,0,7,7
Wexford,2011,20 - 24 years,1,4,5
Wexford,2011,25 - 29 years,3,9,12
Wexford,2011,30 - 34 years,3,6,9
Wexford,2011,35 - 39 years,6,5,11
Wexford,2011,40 - 44 years,8,16,24
Wexford,2011,45 - 49 years,12,7,19
Wexford,2011,5 - 9 years,0,2,2
Wexford,2011,50 - 54 years,10,13,23
Wexford,2011,55 - 59 years,10,15,25
Wexford,2011,60 - 64 years,22,33,55
Wexford,2011,65 - 69 years,35,53,88
Wexford,2011,70 - 74 years,30,56,86
Wexford,2011,75 - 79 years,70,82,152
Wexford,2011,80 - 84 years,68,82,150
Wexford,2011,85 years and over,173,105,278
Wexford,2011,Under 1 year,3,6,9
Wexford,2012,1 - 4 years,0,3,3
Wexford,2012,10 - 14 years,0,1,1
Wexford,2012,15 - 19 years,4,4,8
Wexford,2012,20 - 24 years,1,2,3
Wexford,2012,25 - 29 years,3,2,5
Wexford,2012,30 - 34 years,4,6,10
Wexford,2012,35 - 39 years,7,9,16
Wexford,2012,40 - 44 years,5,9,14
Wexford,2012,45 - 49 years,11,19,30
Wexford,2012,5 - 9 years,0,2,2
Wexford,2012,50 - 54 years,13,20,33
Wexford,2012,55 - 59 years,20,16,36
Wexford,2012,60 - 64 years,22,33,55
Wexford,2012,65 - 69 years,25,53,78
Wexford,2012,70 - 74 years,47,56,103
Wexford,2012,75 - 79 years,59,71,130
Wexford,2012,80 - 84 years,75,76,151
Wexford,2012,85 years and over,184,123,307
Wexford,2012,Under 1 year,6,4,10
Wexford,2013,1 - 4 years,0,1,1
Wexford,2013,10 - 14 years,0,2,2
Wexford,2013,15 - 19 years,0,2,2
Wexford,2013,20 - 24 years,2,1,3
Wexford,2013,25 - 29 years,0,4,4
Wexford,2013,30 - 34 years,3,9,12
Wexford,2013,35 - 39 years,1,2,3
Wexford,2013,40 - 44 years,5,8,13
Wexford,2013,45 - 49 years,10,11,21
Wexford,2013,5 - 9 years,3,1,4
Wexford,2013,50 - 54 years,7,19,26
Wexford,2013,55 - 59 years,15,32,47
Wexford,2013,60 - 64 years,19,37,56
Wexford,2013,65 - 69 years,43,36,79
Wexford,2013,70 - 74 years,35,69,104
Wexford,2013,75 - 79 years,53,86,139
Wexford,2013,80 - 84 years,85,84,169
Wexford,2013,85 years and over,184,113,297
Wexford,2013,Under 1 year,3,5,8
Wexford,2014,1 - 4 years,2,1,3
Wexford,2014,10 - 14 years,0,2,2
Wexford,2014,15 - 19 years,0,1,1
Wexford,2014,20 - 24 years,1,4,5
Wexford,2014,25 - 29 years,4,4,8
Wexford,2014,30 - 34 years,1,5,6
Wexford,2014,35 - 39 years,2,7,9
Wexford,2014,40 - 44 years,6,15,21
Wexford,2014,45 - 49 years,8,11,19
Wexford,2014,5 - 9 years,3,1,4
Wexford,2014,50 - 54 years,16,26,42
Wexford,2014,55 - 59 years,19,31,50
Wexford,2014,60 - 64 years,22,33,55
Wexford,2014,65 - 69 years,34,51,85
Wexford,2014,70 - 74 years,37,54,91
Wexford,2014,75 - 79 years,63,81,144
Wexford,2014,80 - 84 years,83,86,169
Wexford,2014,85 years and over,191,115,306
Wexford,2014,Under 1 year,5,4,9
Wexford,2015,1 - 4 years,1,1,2
Wexford,2015,10 - 14 years,0,2,2
Wexford,2015,15 - 19 years,1,1,2
Wexford,2015,20 - 24 years,1,5,6
Wexford,2015,25 - 29 years,4,6,10
Wexford,2015,30 - 34 years,9,6,15
Wexford,2015,35 - 39 years,2,7,9
Wexford,2015,40 - 44 years,2,12,14
Wexford,2015,45 - 49 years,5,12,17
Wexford,2015,5 - 9 years,3,1,4
Wexford,2015,50 - 54 years,7,19,26
Wexford,2015,55 - 59 years,14,16,30
Wexford,2015,60 - 64 years,25,29,54
Wexford,2015,65 - 69 years,37,51,88
Wexford,2015,70 - 74 years,42,71,113
Wexford,2015,75 - 79 years,63,85,148
Wexford,2015,80 - 84 years,72,72,144
Wexford,2015,85 years and over,181,119,300
Wexford,2015,Under 1 year,6,4,10
Wexford,2016,1 - 4 years,1,1,2
Wexford,2016,10 - 14 years,1,2,3
Wexford,2016,15 - 19 years,3,1,4
Wexford,2016,20 - 24 years,1,1,2
Wexford,2016,25 - 29 years,4,4,8
Wexford,2016,30 - 34 years,4,4,8
Wexford,2016,35 - 39 years,3,6,9
Wexford,2016,40 - 44 years,3,8,11
Wexford,2016,45 - 49 years,10,16,26
Wexford,2016,5 - 9 years,3,1,4
Wexford,2016,50 - 54 years,6,14,20
Wexford,2016,55 - 59 years,21,20,41
Wexford,2016,60 - 64 years,21,36,57
Wexford,2016,65 - 69 years,32,41,73
Wexford,2016,70 - 74 years,45,71,116
Wexford,2016,75 - 79 years,68,97,165
Wexford,2016,80 - 84 years,75,98,173
Wexford,2016,85 years and over,196,139,335
Wexford,2016,Under 1 year,2,5,7
Wexford,2017,1 - 4 years,1,1,2
Wexford,2017,10 - 14 years,1,2,3
Wexford,2017,15 - 19 years,3,2,5
Wexford,2017,20 - 24 years,1,1,2
Wexford,2017,25 - 29 years,3,5,8
Wexford,2017,30 - 34 years,2,5,7
Wexford,2017,35 - 39 years,4,6,10
Wexford,2017,40 - 44 years,4,9,13
Wexford,2017,45 - 49 years,5,13,18
Wexford,2017,5 - 9 years,3,1,4
Wexford,2017,50 - 54 years,9,14,23
Wexford,2017,55 - 59 years,18,29,47
Wexford,2017,60 - 64 years,23,31,54
Wexford,2017,65 - 69 years,41,49,90
Wexford,2017,70 - 74 years,52,71,123
Wexford,2017,75 - 79 years,55,95,150
Wexford,2017,80 - 84 years,74,108,182
Wexford,2017,85 years and over,197,124,321
Wexford,2017,Under 1 year,4,3,7
Wexford,2018,1 - 4 years,0,1,1
Wexford,2018,10 - 14 years,1,1,2
Wexford,2018,15 - 19 years,1,1,2
Wexford,2018,20 - 24 years,4,2,6
Wexford,2018,25 - 29 years,1,0,1
Wexford,2018,30 - 34 years,3,6,9
Wexford,2018,35 - 39 years,2,7,9
Wexford,2018,40 - 44 years,4,9,13
Wexford,2018,45 - 49 years,7,18,25
Wexford,2018,5 - 9 years,0,1,1
Wexford,2018,50 - 54 years,11,17,28
Wexford,2018,55 - 59 years,21,26,47
Wexford,2018,60 - 64 years,29,26,55
Wexford,2018,65 - 69 years,32,47,79
Wexford,2018,70 - 74 years,47,75,122
Wexford,2018,75 - 79 years,69,92,161
Wexford,2018,80 - 84 years,96,100,196
Wexford,2018,85 years and over,216,147,363
Wexford,2018,Under 1 year,5,4,9
Wexford,2019,1 - 4 years,0,1,1
Wexford,2019,10 - 14 years,0,1,1
Wexford,2019,15 - 19 years,3,2,5
Wexford,2019,20 - 24 years,1,3,4
Wexford,2019,25 - 29 years,1,4,5
Wexford,2019,30 - 34 years,3,3,6
Wexford,2019,35 - 39 years,4,7,11
Wexford,2019,40 - 44 years,5,11,16
Wexford,2019,45 - 49 years,5,17,22
Wexford,2019,5 - 9 years,0,0,0
Wexford,2019,50 - 54 years,9,13,22
Wexford,2019,55 - 59 years,13,30,43
Wexford,2019,60 - 64 years,23,53,76
Wexford,2019,65 - 69 years,33,50,83
Wexford,2019,70 - 74 years,49,62,111
Wexford,2019,75 - 79 years,56,76,132
Wexford,2019,80 - 84 years,86,109,195
Wexford,2019,85 years and over,201,165,366
Wexford,2019,Under 1 year,3,5,8
Wexford,2020,1 - 4 years,0,2,2
Wexford,2020,10 - 14 years,0,1,1
Wexford,2020,15 - 19 years,1,3,4
Wexford,2020,20 - 24 years,1,1,2
Wexford,2020,25 - 29 years,1,2,3
Wexford,2020,30 - 34 years,3,5,8
Wexford,2020,35 - 39 years,4,7,11
Wexford,2020,40 - 44 years,12,6,18
Wexford,2020,45 - 49 years,2,13,15
Wexford,2020,5 - 9 years,1,1,2
Wexford,2020,50 - 54 years,13,17,30
Wexford,2020,55 - 59 years,20,28,48
Wexford,2020,60 - 64 years,29,35,64
Wexford,2020,65 - 69 years,36,49,85
Wexford,2020,70 - 74 years,45,77,122
Wexford,2020,75 - 79 years,54,71,125
Wexford,2020,80 - 84 years,78,100,178
Wexford,2020,85 years and over,192,144,336
Wexford,2020,Under 1 year,3,3,6
Wexford Borough,2007,1 - 4 years,0,0,0
Wexford Borough,2007,10 - 14 years,1,0,1
Wexford Borough,2007,15 - 19 years,0,2,2
Wexford Borough,2007,20 - 24 years,1,1,2
Wexford Borough,2007,25 - 29 years,0,0,0
Wexford Borough,2007,30 - 34 years,1,2,3
Wexford Borough,2007,35 - 39 years,1,1,2
Wexford Borough,2007,40 - 44 years,1,0,1
Wexford Borough,2007,45 - 49 years,1,3,4
Wexford Borough,2007,5 - 9 years,0,0,0
Wexford Borough,2007,50 - 54 years,1,3,4
Wexford Borough,2007,55 - 59 years,4,7,11
Wexford Borough,2007,60 - 64 years,3,8,11
Wexford Borough,2007,65 - 69 years,2,3,5
Wexford Borough,2007,70 - 74 years,3,6,9
Wexford Borough,2007,75 - 79 years,9,7,16
Wexford Borough,2007,80 - 84 years,15,11,26
Wexford Borough,2007,85 years and over,27,11,38
Wexford Borough,2007,Under 1 year,0,1,1
Wexford Borough,2008,1 - 4 years,0,0,0
Wexford Borough,2008,10 - 14 years,1,0,1
Wexford Borough,2008,15 - 19 years,1,2,3
Wexford Borough,2008,20 - 24 years,1,1,2
Wexford Borough,2008,25 - 29 years,1,3,4
Wexford Borough,2008,30 - 34 years,1,2,3
Wexford Borough,2008,35 - 39 years,1,1,2
Wexford Borough,2008,40 - 44 years,1,2,3
Wexford Borough,2008,45 - 49 years,1,1,2
Wexford Borough,2008,5 - 9 years,0,0,0
Wexford Borough,2008,50 - 54 years,1,2,3
Wexford Borough,2008,55 - 59 years,4,7,11
Wexford Borough,2008,60 - 64 years,4,5,9
Wexford Borough,2008,65 - 69 years,5,12,17
Wexford Borough,2008,70 - 74 years,12,11,23
Wexford Borough,2008,75 - 79 years,10,6,16
Wexford Borough,2008,80 - 84 years,16,6,22
Wexford Borough,2008,85 years and over,17,8,25
Wexford Borough,2008,Under 1 year,1,1,2
Wexford Borough,2009,1 - 4 years,0,1,1
Wexford Borough,2009,10 - 14 years,1,0,1
Wexford Borough,2009,15 - 19 years,1,2,3
Wexford Borough,2009,20 - 24 years,1,1,2
Wexford Borough,2009,25 - 29 years,1,1,2
Wexford Borough,2009,30 - 34 years,1,2,3
Wexford Borough,2009,35 - 39 years,1,1,2
Wexford Borough,2009,40 - 44 years,1,2,3
Wexford Borough,2009,45 - 49 years,2,3,5
Wexford Borough,2009,5 - 9 years,0,0,0
Wexford Borough,2009,50 - 54 years,2,4,6
Wexford Borough,2009,55 - 59 years,4,2,6
Wexford Borough,2009,60 - 64 years,1,4,5
Wexford Borough,2009,65 - 69 years,4,8,12
Wexford Borough,2009,70 - 74 years,5,10,15
Wexford Borough,2009,75 - 79 years,8,10,18
Wexford Borough,2009,80 - 84 years,13,6,19
Wexford Borough,2009,85 years and over,22,22,44
Wexford Borough,2009,Under 1 year,1,1,2
Wexford Borough,2010,1 - 4 years,0,1,1
Wexford Borough,2010,10 - 14 years,1,0,1
Wexford Borough,2010,15 - 19 years,1,2,3
Wexford Borough,2010,20 - 24 years,1,1,2
Wexford Borough,2010,25 - 29 years,1,1,2
Wexford Borough,2010,30 - 34 years,1,2,3
Wexford Borough,2010,35 - 39 years,1,1,2
Wexford Borough,2010,40 - 44 years,1,2,3
Wexford Borough,2010,45 - 49 years,1,1,2
Wexford Borough,2010,5 - 9 years,0,0,0
Wexford Borough,2010,50 - 54 years,2,4,6
Wexford Borough,2010,55 - 59 years,5,5,10
Wexford Borough,2010,60 - 64 years,3,10,13
Wexford Borough,2010,65 - 69 years,7,10,17
Wexford Borough,2010,70 - 74 years,3,10,13
Wexford Borough,2010,75 - 79 years,7,11,18
Wexford Borough,2010,80 - 84 years,8,11,19
Wexford Borough,2010,85 years and over,31,9,40
Wexford Borough,2010,Under 1 year,1,1,2
Wexford Borough,2011,1 - 4 years,0,0,0
Wexford Borough,2011,10 - 14 years,0,0,0
Wexford Borough,2011,15 - 19 years,0,0,0
Wexford Borough,2011,20 - 24 years,1,1,2
Wexford Borough,2011,25 - 29 years,0,1,1
Wexford Borough,2011,30 - 34 years,0,1,1
Wexford Borough,2011,35 - 39 years,1,1,2
Wexford Borough,2011,40 - 44 years,1,3,4
Wexford Borough,2011,45 - 49 years,1,2,3
Wexford Borough,2011,5 - 9 years,0,1,1
Wexford Borough,2011,50 - 54 years,1,0,1
Wexford Borough,2011,55 - 59 years,0,0,0
Wexford Borough,2011,60 - 64 years,2,5,7
Wexford Borough,2011,65 - 69 years,5,10,15
Wexford Borough,2011,70 - 74 years,7,9,16
Wexford Borough,2011,75 - 79 years,8,7,15
Wexford Borough,2011,80 - 84 years,7,9,16
Wexford Borough,2011,85 years and over,21,9,30
Wexford Borough,2011,Under 1 year,0,0,0
Wexford Borough,2012,1 - 4 years,0,1,1
Wexford Borough,2012,10 - 14 years,0,0,0
Wexford Borough,2012,15 - 19 years,0,0,0
Wexford Borough,2012,20 - 24 years,1,1,2
Wexford Borough,2012,25 - 29 years,0,1,1
Wexford Borough,2012,30 - 34 years,1,2,3
Wexford Borough,2012,35 - 39 years,3,1,4
Wexford Borough,2012,40 - 44 years,2,4,6
Wexford Borough,2012,45 - 49 years,1,3,4
Wexford Borough,2012,5 - 9 years,0,1,1
Wexford Borough,2012,50 - 54 years,2,3,5
Wexford Borough,2012,55 - 59 years,5,2,7
Wexford Borough,2012,60 - 64 years,3,7,10
Wexford Borough,2012,65 - 69 years,3,10,13
Wexford Borough,2012,70 - 74 years,5,8,13
Wexford Borough,2012,75 - 79 years,6,9,15
Wexford Borough,2012,80 - 84 years,17,13,30
Wexford Borough,2012,85 years and over,25,18,43
Wexford Borough,2012,Under 1 year,0,1,1
Wexford Borough,2013,1 - 4 years,0,1,1
Wexford Borough,2013,10 - 14 years,0,0,0
Wexford Borough,2013,15 - 19 years,0,0,0
Wexford Borough,2013,20 - 24 years,0,0,0
Wexford Borough,2013,25 - 29 years,0,0,0
Wexford Borough,2013,30 - 34 years,0,1,1
Wexford Borough,2013,35 - 39 years,0,0,0
Wexford Borough,2013,40 - 44 years,2,2,4
Wexford Borough,2013,45 - 49 years,1,1,2
Wexford Borough,2013,5 - 9 years,0,0,0
Wexford Borough,2013,50 - 54 years,2,3,5
Wexford Borough,2013,55 - 59 years,3,2,5
Wexford Borough,2013,60 - 64 years,2,6,8
Wexford Borough,2013,65 - 69 years,3,4,7
Wexford Borough,2013,70 - 74 years,7,14,21
Wexford Borough,2013,75 - 79 years,7,14,21
Wexford Borough,2013,80 - 84 years,10,10,20
Wexford Borough,2013,85 years and over,28,4,32
Wexford Borough,2013,Under 1 year,1,1,2
Wexford Borough,2014,1 - 4 years,0,1,1
Wexford Borough,2014,10 - 14 years,0,0,0
Wexford Borough,2014,15 - 19 years,0,0,0
Wexford Borough,2014,20 - 24 years,0,0,0
Wexford Borough,2014,25 - 29 years,0,0,0
Wexford Borough,2014,30 - 34 years,0,1,1
Wexford Borough,2014,35 - 39 years,0,1,1
Wexford Borough,2014,40 - 44 years,2,2,4
Wexford Borough,2014,45 - 49 years,1,2,3
Wexford Borough,2014,5 - 9 years,0,0,0
Wexford Borough,2014,50 - 54 years,6,2,8
Wexford Borough,2014,55 - 59 years,3,5,8
Wexford Borough,2014,60 - 64 years,4,5,9
Wexford Borough,2014,65 - 69 years,1,6,7
Wexford Borough,2014,70 - 74 years,3,7,10
Wexford Borough,2014,75 - 79 years,11,15,26
Wexford Borough,2014,80 - 84 years,9,14,23
Wexford Borough,2014,85 years and over,26,18,44
Wexford Borough,2014,Under 1 year,1,1,2
Wexford Borough,2015,1 - 4 years,0,1,1
Wexford Borough,2015,10 - 14 years,0,0,0
Wexford Borough,2015,15 - 19 years,0,0,0
Wexford Borough,2015,20 - 24 years,0,0,0
Wexford Borough,2015,25 - 29 years,0,0,0
Wexford Borough,2015,30 - 34 years,0,1,1
Wexford Borough,2015,35 - 39 years,0,1,1
Wexford Borough,2015,40 - 44 years,2,2,4
Wexford Borough,2015,45 - 49 years,1,2,3
Wexford Borough,2015,5 - 9 years,0,0,0
Wexford Borough,2015,50 - 54 years,6,2,8
Wexford Borough,2015,55 - 59 years,3,5,8
Wexford Borough,2015,60 - 64 years,4,5,9
Wexford Borough,2015,65 - 69 years,1,6,7
Wexford Borough,2015,70 - 74 years,3,7,10
Wexford Borough,2015,75 - 79 years,11,15,26
Wexford Borough,2015,80 - 84 years,9,14,23
Wexford Borough,2015,85 years and over,26,18,44
Wexford Borough,2015,Under 1 year,1,1,2
Wexford Borough,2016,1 - 4 years,0,1,1
Wexford Borough,2016,10 - 14 years,0,0,0
Wexford Borough,2016,15 - 19 years,0,0,0
Wexford Borough,2016,20 - 24 years,0,0,0
Wexford Borough,2016,25 - 29 years,0,0,0
Wexford Borough,2016,30 - 34 years,0,1,1
Wexford Borough,2016,35 - 39 years,0,1,1
Wexford Borough,2016,40 - 44 years,2,2,4
Wexford Borough,2016,45 - 49 years,1,2,3
Wexford Borough,2016,5 - 9 years,0,0,0
Wexford Borough,2016,50 - 54 years,6,2,8
Wexford Borough,2016,55 - 59 years,3,5,8
Wexford Borough,2016,60 - 64 years,4,5,9
Wexford Borough,2016,65 - 69 years,1,6,7
Wexford Borough,2016,70 - 74 years,3,7,10
Wexford Borough,2016,75 - 79 years,11,15,26
Wexford Borough,2016,80 - 84 years,9,14,23
Wexford Borough,2016,85 years and over,26,18,44
Wexford Borough,2016,Under 1 year,1,1,2
Wexford Borough,2017,1 - 4 years,0,1,1
Wexford Borough,2017,10 - 14 years,0,0,0
Wexford Borough,2017,15 - 19 years,0,0,0
Wexford Borough,2017,20 - 24 years,0,0,0
Wexford Borough,2017,25 - 29 years,1,1,2
Wexford Borough,2017,30 - 34 years,0,1,1
Wexford Borough,2017,35 - 39 years,0,2,2
Wexford Borough,2017,40 - 44 years,1,2,3
Wexford Borough,2017,45 - 49 years,1,3,4
Wexford Borough,2017,5 - 9 years,0,0,0
Wexford Borough,2017,50 - 54 years,2,3,5
Wexford Borough,2017,55 - 59 years,3,7,10
Wexford Borough,2017,60 - 64 years,5,5,10
Wexford Borough,2017,65 - 69 years,8,9,17
Wexford Borough,2017,70 - 74 years,9,16,25
Wexford Borough,2017,75 - 79 years,9,17,26
Wexford Borough,2017,80 - 84 years,7,17,24
Wexford Borough,2017,85 years and over,34,17,51
Wexford Borough,2017,Under 1 year,1,2,3
Wexford Borough,2018,1 - 4 years,0,0,0
Wexford Borough,2018,10 - 14 years,0,0,0
Wexford Borough,2018,15 - 19 years,1,0,1
Wexford Borough,2018,20 - 24 years,0,1,1
Wexford Borough,2018,25 - 29 years,0,0,0
Wexford Borough,2018,30 - 34 years,0,0,0
Wexford Borough,2018,35 - 39 years,1,3,4
Wexford Borough,2018,40 - 44 years,2,1,3
Wexford Borough,2018,45 - 49 years,2,2,4
Wexford Borough,2018,5 - 9 years,0,0,0
Wexford Borough,2018,50 - 54 years,2,3,5
Wexford Borough,2018,55 - 59 years,5,4,9
Wexford Borough,2018,60 - 64 years,4,5,9
Wexford Borough,2018,65 - 69 years,5,10,15
Wexford Borough,2018,70 - 74 years,4,8,12
Wexford Borough,2018,75 - 79 years,18,12,30
Wexford Borough,2018,80 - 84 years,19,8,27
Wexford Borough,2018,85 years and over,38,16,54
Wexford Borough,2018,Under 1 year,1,1,2
Wexford Borough,2019,1 - 4 years,0,0,0
Wexford Borough,2019,10 - 14 years,0,0,0
Wexford Borough,2019,15 - 19 years,1,0,1
Wexford Borough,2019,20 - 24 years,0,1,1
Wexford Borough,2019,25 - 29 years,0,0,0
Wexford Borough,2019,30 - 34 years,0,0,0
Wexford Borough,2019,35 - 39 years,1,3,4
Wexford Borough,2019,40 - 44 years,2,1,3
Wexford Borough,2019,45 - 49 years,2,2,4
Wexford Borough,2019,5 - 9 years,0,0,0
Wexford Borough,2019,50 - 54 years,2,3,5
Wexford Borough,2019,55 - 59 years,5,4,9
Wexford Borough,2019,60 - 64 years,4,5,9
Wexford Borough,2019,65 - 69 years,5,10,15
Wexford Borough,2019,70 - 74 years,4,8,12
Wexford Borough,2019,75 - 79 years,18,12,30
Wexford Borough,2019,80 - 84 years,19,8,27
Wexford Borough,2019,85 years and over,38,16,54
Wexford Borough,2019,Under 1 year,1,1,2
Wexford Borough,2020,1 - 4 years,0,0,0
Wexford Borough,2020,10 - 14 years,0,0,0
Wexford Borough,2020,15 - 19 years,1,0,1
Wexford Borough,2020,20 - 24 years,0,1,1
Wexford Borough,2020,25 - 29 years,0,0,0
Wexford Borough,2020,30 - 34 years,0,0,0
Wexford Borough,2020,35 - 39 years,1,3,4
Wexford Borough,2020,40 - 44 years,2,1,3
Wexford Borough,2020,45 - 49 years,2,2,4
Wexford Borough,2020,5 - 9 years,0,0,0
Wexford Borough,2020,50 - 54 years,2,3,5
Wexford Borough,2020,55 - 59 years,5,4,9
Wexford Borough,2020,60 - 64 years,4,5,9
Wexford Borough,2020,65 - 69 years,5,10,15
Wexford Borough,2020,70 - 74 years,4,8,12
Wexford Borough,2020,75 - 79 years,18,12,30
Wexford Borough,2020,80 - 84 years,19,8,27
Wexford Borough,2020,85 years and over,38,16,54
Wexford Borough,2020,Under 1 year,1,1,2
Wicklow,2007,1 - 4 years,2,0,2
Wicklow,2007,10 - 14 years,0,1,1
Wicklow,2007,15 - 19 years,2,4,6
Wicklow,2007,20 - 24 years,1,5,6
Wicklow,2007,25 - 29 years,2,5,7
Wicklow,2007,30 - 34 years,3,6,9
Wicklow,2007,35 - 39 years,5,5,10
Wicklow,2007,40 - 44 years,6,5,11
Wicklow,2007,45 - 49 years,7,9,16
Wicklow,2007,5 - 9 years,0,1,1
Wicklow,2007,50 - 54 years,10,8,18
Wicklow,2007,55 - 59 years,10,24,34
Wicklow,2007,60 - 64 years,20,30,50
Wicklow,2007,65 - 69 years,23,44,67
Wicklow,2007,70 - 74 years,36,40,76
Wicklow,2007,75 - 79 years,73,58,131
Wicklow,2007,80 - 84 years,72,72,144
Wicklow,2007,85 years and over,145,78,223
Wicklow,2007,Under 1 year,2,5,7
Wicklow,2008,1 - 4 years,2,0,2
Wicklow,2008,10 - 14 years,0,2,2
Wicklow,2008,15 - 19 years,1,1,2
Wicklow,2008,20 - 24 years,2,1,3
Wicklow,2008,25 - 29 years,4,6,10
Wicklow,2008,30 - 34 years,2,3,5
Wicklow,2008,35 - 39 years,4,4,8
Wicklow,2008,40 - 44 years,6,11,17
Wicklow,2008,45 - 49 years,7,15,22
Wicklow,2008,5 - 9 years,0,2,2
Wicklow,2008,50 - 54 years,13,15,28
Wicklow,2008,55 - 59 years,16,14,30
Wicklow,2008,60 - 64 years,19,34,53
Wicklow,2008,65 - 69 years,26,27,53
Wicklow,2008,70 - 74 years,31,42,73
Wicklow,2008,75 - 79 years,38,54,92
Wicklow,2008,80 - 84 years,64,75,139
Wicklow,2008,85 years and over,119,70,189
Wicklow,2008,Under 1 year,3,6,9
Wicklow,2009,1 - 4 years,2,0,2
Wicklow,2009,10 - 14 years,1,2,3
Wicklow,2009,15 - 19 years,1,2,3
Wicklow,2009,20 - 24 years,2,3,5
Wicklow,2009,25 - 29 years,4,3,7
Wicklow,2009,30 - 34 years,1,3,4
Wicklow,2009,35 - 39 years,3,6,9
Wicklow,2009,40 - 44 years,4,8,12
Wicklow,2009,45 - 49 years,9,4,13
Wicklow,2009,5 - 9 years,0,2,2
Wicklow,2009,50 - 54 years,15,17,32
Wicklow,2009,55 - 59 years,12,19,31
Wicklow,2009,60 - 64 years,11,39,50
Wicklow,2009,65 - 69 years,20,39,59
Wicklow,2009,70 - 74 years,37,58,95
Wicklow,2009,75 - 79 years,51,53,104
Wicklow,2009,80 - 84 years,61,71,132
Wicklow,2009,85 years and over,134,89,223
Wicklow,2009,Under 1 year,4,2,6
Wicklow,2010,1 - 4 years,2,1,3
Wicklow,2010,10 - 14 years,1,1,2
Wicklow,2010,15 - 19 years,1,1,2
Wicklow,2010,20 - 24 years,1,5,6
Wicklow,2010,25 - 29 years,4,2,6
Wicklow,2010,30 - 34 years,1,6,7
Wicklow,2010,35 - 39 years,2,5,7
Wicklow,2010,40 - 44 years,1,6,7
Wicklow,2010,45 - 49 years,7,14,21
Wicklow,2010,5 - 9 years,0,1,1
Wicklow,2010,50 - 54 years,9,12,21
Wicklow,2010,55 - 59 years,3,14,17
Wicklow,2010,60 - 64 years,15,33,48
Wicklow,2010,65 - 69 years,23,36,59
Wicklow,2010,70 - 74 years,25,47,72
Wicklow,2010,75 - 79 years,37,57,94
Wicklow,2010,80 - 84 years,53,69,122
Wicklow,2010,85 years and over,140,63,203
Wicklow,2010,Under 1 year,7,9,16
Wicklow,2011,1 - 4 years,0,1,1
Wicklow,2011,10 - 14 years,1,0,1
Wicklow,2011,15 - 19 years,0,1,1
Wicklow,2011,20 - 24 years,1,7,8
Wicklow,2011,25 - 29 years,1,3,4
Wicklow,2011,30 - 34 years,3,4,7
Wicklow,2011,35 - 39 years,2,8,10
Wicklow,2011,40 - 44 years,5,8,13
Wicklow,2011,45 - 49 years,8,9,17
Wicklow,2011,5 - 9 years,0,1,1
Wicklow,2011,50 - 54 years,12,13,25
Wicklow,2011,55 - 59 years,16,31,47
Wicklow,2011,60 - 64 years,18,35,53
Wicklow,2011,65 - 69 years,25,41,66
Wicklow,2011,70 - 74 years,29,51,80
Wicklow,2011,75 - 79 years,37,57,94
Wicklow,2011,80 - 84 years,67,61,128
Wicklow,2011,85 years and over,155,84,239
Wicklow,2011,Under 1 year,4,8,12
Wicklow,2012,1 - 4 years,0,1,1
Wicklow,2012,10 - 14 years,1,0,1
Wicklow,2012,15 - 19 years,0,3,3
Wicklow,2012,20 - 24 years,1,3,4
Wicklow,2012,25 - 29 years,1,3,4
Wicklow,2012,30 - 34 years,4,3,7
Wicklow,2012,35 - 39 years,5,4,9
Wicklow,2012,40 - 44 years,5,8,13
Wicklow,2012,45 - 49 years,4,13,17
Wicklow,2012,5 - 9 years,0,1,1
Wicklow,2012,50 - 54 years,12,12,24
Wicklow,2012,55 - 59 years,16,18,34
Wicklow,2012,60 - 64 years,20,34,54
Wicklow,2012,65 - 69 years,26,53,79
Wicklow,2012,70 - 74 years,38,39,77
Wicklow,2012,75 - 79 years,48,65,113
Wicklow,2012,80 - 84 years,68,60,128
Wicklow,2012,85 years and over,166,71,237
Wicklow,2012,Under 1 year,4,2,6
Wicklow,2013,1 - 4 years,0,2,2
Wicklow,2013,10 - 14 years,1,0,1
Wicklow,2013,15 - 19 years,0,0,0
Wicklow,2013,20 - 24 years,1,0,1
Wicklow,2013,25 - 29 years,2,4,6
Wicklow,2013,30 - 34 years,0,2,2
Wicklow,2013,35 - 39 years,1,6,7
Wicklow,2013,40 - 44 years,4,6,10
Wicklow,2013,45 - 49 years,11,8,19
Wicklow,2013,5 - 9 years,0,0,0
Wicklow,2013,50 - 54 years,8,16,24
Wicklow,2013,55 - 59 years,18,19,37
Wicklow,2013,60 - 64 years,13,28,41
Wicklow,2013,65 - 69 years,29,46,75
Wicklow,2013,70 - 74 years,31,45,76
Wicklow,2013,75 - 79 years,36,55,91
Wicklow,2013,80 - 84 years,59,67,126
Wicklow,2013,85 years and over,188,84,272
Wicklow,2013,Under 1 year,2,4,6
Wicklow,2014,1 - 4 years,0,1,1
Wicklow,2014,10 - 14 years,1,1,2
Wicklow,2014,15 - 19 years,1,1,2
Wicklow,2014,20 - 24 years,1,5,6
Wicklow,2014,25 - 29 years,1,3,4
Wicklow,2014,30 - 34 years,1,4,5
Wicklow,2014,35 - 39 years,1,6,7
Wicklow,2014,40 - 44 years,3,8,11
Wicklow,2014,45 - 49 years,5,12,17
Wicklow,2014,5 - 9 years,0,0,0
Wicklow,2014,50 - 54 years,13,7,20
Wicklow,2014,55 - 59 years,22,17,39
Wicklow,2014,60 - 64 years,18,24,42
Wicklow,2014,65 - 69 years,31,40,71
Wicklow,2014,70 - 74 years,29,45,74
Wicklow,2014,75 - 79 years,44,47,91
Wicklow,2014,80 - 84 years,55,71,126
Wicklow,2014,85 years and over,177,91,268
Wicklow,2014,Under 1 year,4,4,8
Wicklow,2015,1 - 4 years,0,1,1
Wicklow,2015,10 - 14 years,1,1,2
Wicklow,2015,15 - 19 years,1,4,5
Wicklow,2015,20 - 24 years,1,5,6
Wicklow,2015,25 - 29 years,1,5,6
Wicklow,2015,30 - 34 years,2,4,6
Wicklow,2015,35 - 39 years,1,4,5
Wicklow,2015,40 - 44 years,3,6,9
Wicklow,2015,45 - 49 years,8,10,18
Wicklow,2015,5 - 9 years,0,0,0
Wicklow,2015,50 - 54 years,8,14,22
Wicklow,2015,55 - 59 years,20,21,41
Wicklow,2015,60 - 64 years,24,29,53
Wicklow,2015,65 - 69 years,33,44,77
Wicklow,2015,70 - 74 years,34,62,96
Wicklow,2015,75 - 79 years,39,58,97
Wicklow,2015,80 - 84 years,59,66,125
Wicklow,2015,85 years and over,177,90,267
Wicklow,2015,Under 1 year,5,3,8
Wicklow,2016,1 - 4 years,0,1,1
Wicklow,2016,10 - 14 years,1,1,2
Wicklow,2016,15 - 19 years,1,4,5
Wicklow,2016,20 - 24 years,1,2,3
Wicklow,2016,25 - 29 years,1,1,2
Wicklow,2016,30 - 34 years,4,5,9
Wicklow,2016,35 - 39 years,2,6,8
Wicklow,2016,40 - 44 years,3,5,8
Wicklow,2016,45 - 49 years,7,10,17
Wicklow,2016,5 - 9 years,0,0,0
Wicklow,2016,50 - 54 years,10,10,20
Wicklow,2016,55 - 59 years,15,19,34
Wicklow,2016,60 - 64 years,20,23,43
Wicklow,2016,65 - 69 years,25,42,67
Wicklow,2016,70 - 74 years,46,52,98
Wicklow,2016,75 - 79 years,49,62,111
Wicklow,2016,80 - 84 years,56,64,120
Wicklow,2016,85 years and over,186,111,297
Wicklow,2016,Under 1 year,2,4,6
Wicklow,2017,1 - 4 years,1,1,2
Wicklow,2017,10 - 14 years,1,1,2
Wicklow,2017,15 - 19 years,1,4,5
Wicklow,2017,20 - 24 years,1,2,3
Wicklow,2017,25 - 29 years,2,2,4
Wicklow,2017,30 - 34 years,1,6,7
Wicklow,2017,35 - 39 years,1,5,6
Wicklow,2017,40 - 44 years,6,15,21
Wicklow,2017,45 - 49 years,3,5,8
Wicklow,2017,5 - 9 years,0,1,1
Wicklow,2017,50 - 54 years,11,13,24
Wicklow,2017,55 - 59 years,11,28,39
Wicklow,2017,60 - 64 years,21,23,44
Wicklow,2017,65 - 69 years,31,40,71
Wicklow,2017,70 - 74 years,41,65,106
Wicklow,2017,75 - 79 years,39,68,107
Wicklow,2017,80 - 84 years,68,72,140
Wicklow,2017,85 years and over,160,116,276
Wicklow,2017,Under 1 year,5,5,10
Wicklow,2018,1 - 4 years,0,0,0
Wicklow,2018,10 - 14 years,0,1,1
Wicklow,2018,15 - 19 years,1,0,1
Wicklow,2018,20 - 24 years,2,2,4
Wicklow,2018,25 - 29 years,3,3,6
Wicklow,2018,30 - 34 years,7,3,10
Wicklow,2018,35 - 39 years,4,3,7
Wicklow,2018,40 - 44 years,3,5,8
Wicklow,2018,45 - 49 years,4,11,15
Wicklow,2018,5 - 9 years,0,0,0
Wicklow,2018,50 - 54 years,15,8,23
Wicklow,2018,55 - 59 years,17,15,32
Wicklow,2018,60 - 64 years,20,32,52
Wicklow,2018,65 - 69 years,27,45,72
Wicklow,2018,70 - 74 years,41,57,98
Wicklow,2018,75 - 79 years,60,50,110
Wicklow,2018,80 - 84 years,68,72,140
Wicklow,2018,85 years and over,164,123,287
Wicklow,2018,Under 1 year,2,4,6
Wicklow,2019,1 - 4 years,0,0,0
Wicklow,2019,10 - 14 years,0,0,0
Wicklow,2019,15 - 19 years,0,0,0
Wicklow,2019,20 - 24 years,1,2,3
Wicklow,2019,25 - 29 years,1,2,3
Wicklow,2019,30 - 34 years,3,2,5
Wicklow,2019,35 - 39 years,6,4,10
Wicklow,2019,40 - 44 years,8,2,10
Wicklow,2019,45 - 49 years,7,8,15
Wicklow,2019,5 - 9 years,1,1,2
Wicklow,2019,50 - 54 years,11,17,28
Wicklow,2019,55 - 59 years,15,21,36
Wicklow,2019,60 - 64 years,18,28,46
Wicklow,2019,65 - 69 years,21,48,69
Wicklow,2019,70 - 74 years,35,46,81
Wicklow,2019,75 - 79 years,63,69,132
Wicklow,2019,80 - 84 years,66,66,132
Wicklow,2019,85 years and over,191,134,325
Wicklow,2019,Under 1 year,6,2,8
Wicklow,2020,1 - 4 years,0,2,2
Wicklow,2020,10 - 14 years,1,0,1
Wicklow,2020,15 - 19 years,0,0,0
Wicklow,2020,20 - 24 years,1,1,2
Wicklow,2020,25 - 29 years,1,2,3
Wicklow,2020,30 - 34 years,1,3,4
Wicklow,2020,35 - 39 years,3,4,7
Wicklow,2020,40 - 44 years,3,1,4
Wicklow,2020,45 - 49 years,5,4,9
Wicklow,2020,5 - 9 years,1,2,3
Wicklow,2020,50 - 54 years,4,15,19
Wicklow,2020,55 - 59 years,8,13,21
Wicklow,2020,60 - 64 years,20,30,50
Wicklow,2020,65 - 69 years,27,36,63
Wicklow,2020,70 - 74 years,34,62,96
Wicklow,2020,75 - 79 years,54,63,117
Wicklow,2020,80 - 84 years,77,92,169
Wicklow,2020,85 years and over,168,126,294
Wicklow,2020,Under 1 year,1,3,4
Wicklow Town,2007,1 - 4 years,0,0,0
Wicklow Town,2007,10 - 14 years,0,0,0
Wicklow Town,2007,15 - 19 years,0,0,0
Wicklow Town,2007,20 - 24 years,0,0,0
Wicklow Town,2007,25 - 29 years,0,1,1
Wicklow Town,2007,30 - 34 years,0,1,1
Wicklow Town,2007,35 - 39 years,0,0,0
Wicklow Town,2007,40 - 44 years,0,1,1
Wicklow Town,2007,45 - 49 years,0,1,1
Wicklow Town,2007,5 - 9 years,0,0,0
Wicklow Town,2007,50 - 54 years,1,1,2
Wicklow Town,2007,55 - 59 years,0,2,2
Wicklow Town,2007,60 - 64 years,1,2,3
Wicklow Town,2007,65 - 69 years,1,1,2
Wicklow Town,2007,70 - 74 years,3,1,4
Wicklow Town,2007,75 - 79 years,7,5,12
Wicklow Town,2007,80 - 84 years,5,2,7
Wicklow Town,2007,85 years and over,10,4,14
Wicklow Town,2007,Under 1 year,1,1,2
Wicklow Town,2008,1 - 4 years,0,0,0
Wicklow Town,2008,10 - 14 years,0,0,0
Wicklow Town,2008,15 - 19 years,0,0,0
Wicklow Town,2008,20 - 24 years,0,0,0
Wicklow Town,2008,25 - 29 years,0,1,1
Wicklow Town,2008,30 - 34 years,0,1,1
Wicklow Town,2008,35 - 39 years,0,0,0
Wicklow Town,2008,40 - 44 years,0,2,2
Wicklow Town,2008,45 - 49 years,0,1,1
Wicklow Town,2008,5 - 9 years,0,0,0
Wicklow Town,2008,50 - 54 years,1,2,3
Wicklow Town,2008,55 - 59 years,2,1,3
Wicklow Town,2008,60 - 64 years,1,3,4
Wicklow Town,2008,65 - 69 years,1,2,3
Wicklow Town,2008,70 - 74 years,2,2,4
Wicklow Town,2008,75 - 79 years,2,8,10
Wicklow Town,2008,80 - 84 years,3,5,8
Wicklow Town,2008,85 years and over,6,6,12
Wicklow Town,2008,Under 1 year,1,1,2
Wicklow Town,2009,1 - 4 years,0,0,0
Wicklow Town,2009,10 - 14 years,0,0,0
Wicklow Town,2009,15 - 19 years,0,0,0
Wicklow Town,2009,20 - 24 years,0,0,0
Wicklow Town,2009,25 - 29 years,0,1,1
Wicklow Town,2009,30 - 34 years,0,1,1
Wicklow Town,2009,35 - 39 years,0,0,0
Wicklow Town,2009,40 - 44 years,0,2,2
Wicklow Town,2009,45 - 49 years,0,1,1
Wicklow Town,2009,5 - 9 years,0,0,0
Wicklow Town,2009,50 - 54 years,2,1,3
Wicklow Town,2009,55 - 59 years,2,1,3
Wicklow Town,2009,60 - 64 years,1,3,4
Wicklow Town,2009,65 - 69 years,1,4,5
Wicklow Town,2009,70 - 74 years,3,3,6
Wicklow Town,2009,75 - 79 years,1,8,9
Wicklow Town,2009,80 - 84 years,2,7,9
Wicklow Town,2009,85 years and over,10,4,14
Wicklow Town,2009,Under 1 year,1,1,2
Wicklow Town,2010,1 - 4 years,0,0,0
Wicklow Town,2010,10 - 14 years,0,0,0
Wicklow Town,2010,15 - 19 years,0,0,0
Wicklow Town,2010,20 - 24 years,0,0,0
Wicklow Town,2010,25 - 29 years,0,1,1
Wicklow Town,2010,30 - 34 years,0,1,1
Wicklow Town,2010,35 - 39 years,0,0,0
Wicklow Town,2010,40 - 44 years,0,1,1
Wicklow Town,2010,45 - 49 years,0,1,1
Wicklow Town,2010,5 - 9 years,0,0,0
Wicklow Town,2010,50 - 54 years,1,1,2
Wicklow Town,2010,55 - 59 years,2,1,3
Wicklow Town,2010,60 - 64 years,1,3,4
Wicklow Town,2010,65 - 69 years,4,2,6
Wicklow Town,2010,70 - 74 years,3,3,6
Wicklow Town,2010,75 - 79 years,1,5,6
Wicklow Town,2010,80 - 84 years,6,6,12
Wicklow Town,2010,85 years and over,12,4,16
Wicklow Town,2010,Under 1 year,1,1,2
Wicklow Town,2011,1 - 4 years,0,0,0
Wicklow Town,2011,10 - 14 years,0,0,0
Wicklow Town,2011,15 - 19 years,0,1,1
Wicklow Town,2011,20 - 24 years,0,0,0
Wicklow Town,2011,25 - 29 years,0,0,0
Wicklow Town,2011,30 - 34 years,0,0,0
Wicklow Town,2011,35 - 39 years,0,1,1
Wicklow Town,2011,40 - 44 years,1,3,4
Wicklow Town,2011,45 - 49 years,0,1,1
Wicklow Town,2011,5 - 9 years,0,0,0
Wicklow Town,2011,50 - 54 years,1,0,1
Wicklow Town,2011,55 - 59 years,0,3,3
Wicklow Town,2011,60 - 64 years,2,3,5
Wicklow Town,2011,65 - 69 years,4,2,6
Wicklow Town,2011,70 - 74 years,2,4,6
Wicklow Town,2011,75 - 79 years,4,4,8
Wicklow Town,2011,80 - 84 years,2,5,7
Wicklow Town,2011,85 years and over,7,5,12
Wicklow Town,2011,Under 1 year,0,1,1
Wicklow Town,2012,1 - 4 years,0,0,0
Wicklow Town,2012,10 - 14 years,0,0,0
Wicklow Town,2012,15 - 19 years,0,1,1
Wicklow Town,2012,20 - 24 years,0,0,0
Wicklow Town,2012,25 - 29 years,0,1,1
Wicklow Town,2012,30 - 34 years,0,0,0
Wicklow Town,2012,35 - 39 years,0,1,1
Wicklow Town,2012,40 - 44 years,1,1,2
Wicklow Town,2012,45 - 49 years,0,2,2
Wicklow Town,2012,5 - 9 years,0,0,0
Wicklow Town,2012,50 - 54 years,1,1,2
Wicklow Town,2012,55 - 59 years,1,2,3
Wicklow Town,2012,60 - 64 years,2,2,4
Wicklow Town,2012,65 - 69 years,3,2,5
Wicklow Town,2012,70 - 74 years,4,3,7
Wicklow Town,2012,75 - 79 years,1,5,6
Wicklow Town,2012,80 - 84 years,9,4,13
Wicklow Town,2012,85 years and over,9,1,10
Wicklow Town,2012,Under 1 year,0,1,1
Wicklow Town,2013,1 - 4 years,0,0,0
Wicklow Town,2013,10 - 14 years,0,0,0
Wicklow Town,2013,15 - 19 years,0,0,0
Wicklow Town,2013,20 - 24 years,0,0,0
Wicklow Town,2013,25 - 29 years,0,0,0
Wicklow Town,2013,30 - 34 years,0,0,0
Wicklow Town,2013,35 - 39 years,0,0,0
Wicklow Town,2013,40 - 44 years,0,1,1
Wicklow Town,2013,45 - 49 years,1,0,1
Wicklow Town,2013,5 - 9 years,0,0,0
Wicklow Town,2013,50 - 54 years,0,0,0
Wicklow Town,2013,55 - 59 years,1,0,1
Wicklow Town,2013,60 - 64 years,0,0,0
Wicklow Town,2013,65 - 69 years,4,5,9
Wicklow Town,2013,70 - 74 years,3,1,4
Wicklow Town,2013,75 - 79 years,0,4,4
Wicklow Town,2013,80 - 84 years,3,6,9
Wicklow Town,2013,85 years and over,9,5,14
Wicklow Town,2013,Under 1 year,0,0,0
Wicklow Town,2014,1 - 4 years,0,0,0
Wicklow Town,2014,10 - 14 years,0,0,0
Wicklow Town,2014,15 - 19 years,0,0,0
Wicklow Town,2014,20 - 24 years,0,1,1
Wicklow Town,2014,25 - 29 years,0,1,1
Wicklow Town,2014,30 - 34 years,0,0,0
Wicklow Town,2014,35 - 39 years,0,0,0
Wicklow Town,2014,40 - 44 years,0,1,1
Wicklow Town,2014,45 - 49 years,1,0,1
Wicklow Town,2014,5 - 9 years,0,0,0
Wicklow Town,2014,50 - 54 years,0,0,0
Wicklow Town,2014,55 - 59 years,1,0,1
Wicklow Town,2014,60 - 64 years,3,1,4
Wicklow Town,2014,65 - 69 years,1,1,2
Wicklow Town,2014,70 - 74 years,2,4,6
Wicklow Town,2014,75 - 79 years,7,4,11
Wicklow Town,2014,80 - 84 years,5,5,10
Wicklow Town,2014,85 years and over,12,4,16
Wicklow Town,2014,Under 1 year,0,0,0
Wicklow Town,2015,1 - 4 years,0,0,0
Wicklow Town,2015,10 - 14 years,0,0,0
Wicklow Town,2015,15 - 19 years,0,0,0
Wicklow Town,2015,20 - 24 years,0,1,1
Wicklow Town,2015,25 - 29 years,0,1,1
Wicklow Town,2015,30 - 34 years,0,0,0
Wicklow Town,2015,35 - 39 years,0,0,0
Wicklow Town,2015,40 - 44 years,0,1,1
Wicklow Town,2015,45 - 49 years,1,0,1
Wicklow Town,2015,5 - 9 years,0,0,0
Wicklow Town,2015,50 - 54 years,0,0,0
Wicklow Town,2015,55 - 59 years,1,0,1
Wicklow Town,2015,60 - 64 years,3,1,4
Wicklow Town,2015,65 - 69 years,1,1,2
Wicklow Town,2015,70 - 74 years,2,4,6
Wicklow Town,2015,75 - 79 years,7,4,11
Wicklow Town,2015,80 - 84 years,5,5,10
Wicklow Town,2015,85 years and over,12,4,16
Wicklow Town,2015,Under 1 year,0,0,0
Wicklow Town,2016,1 - 4 years,0,0,0
Wicklow Town,2016,10 - 14 years,0,0,0
Wicklow Town,2016,15 - 19 years,0,0,0
Wicklow Town,2016,20 - 24 years,0,1,1
Wicklow Town,2016,25 - 29 years,0,1,1
Wicklow Town,2016,30 - 34 years,0,0,0
Wicklow Town,2016,35 - 39 years,0,0,0
Wicklow Town,2016,40 - 44 years,0,1,1
Wicklow Town,2016,45 - 49 years,1,0,1
Wicklow Town,2016,5 - 9 years,0,0,0
Wicklow Town,2016,50 - 54 years,0,0,0
Wicklow Town,2016,55 - 59 years,1,0,1
Wicklow Town,2016,60 - 64 years,3,1,4
Wicklow Town,2016,65 - 69 years,1,1,2
Wicklow Town,2016,70 - 74 years,2,4,6
Wicklow Town,2016,75 - 79 years,7,4,11
Wicklow Town,2016,80 - 84 years,5,5,10
Wicklow Town,2016,85 years and over,12,4,16
Wicklow Town,2016,Under 1 year,0,0,0
Wicklow Town,2017,1 - 4 years,0,0,0
Wicklow Town,2017,10 - 14 years,0,0,0
Wicklow Town,2017,15 - 19 years,0,0,0
Wicklow Town,2017,20 - 24 years,0,1,1
Wicklow Town,2017,25 - 29 years,0,1,1
Wicklow Town,2017,30 - 34 years,0,0,0
Wicklow Town,2017,35 - 39 years,0,0,0
Wicklow Town,2017,40 - 44 years,0,1,1
Wicklow Town,2017,45 - 49 years,1,0,1
Wicklow Town,2017,5 - 9 years,0,0,0
Wicklow Town,2017,50 - 54 years,2,2,4
Wicklow Town,2017,55 - 59 years,1,1,2
Wicklow Town,2017,60 - 64 years,2,1,3
Wicklow Town,2017,65 - 69 years,1,1,2
Wicklow Town,2017,70 - 74 years,3,1,4
Wicklow Town,2017,75 - 79 years,2,1,3
Wicklow Town,2017,80 - 84 years,3,2,5
Wicklow Town,2017,85 years and over,9,6,15
Wicklow Town,2017,Under 1 year,0,0,0
Wicklow Town,2018,1 - 4 years,0,0,0
Wicklow Town,2018,10 - 14 years,0,0,0
Wicklow Town,2018,15 - 19 years,0,0,0
Wicklow Town,2018,20 - 24 years,0,0,0
Wicklow Town,2018,25 - 29 years,0,0,0
Wicklow Town,2018,30 - 34 years,1,0,1
Wicklow Town,2018,35 - 39 years,1,0,1
Wicklow Town,2018,40 - 44 years,0,0,0
Wicklow Town,2018,45 - 49 years,0,2,2
Wicklow Town,2018,5 - 9 years,0,0,0
Wicklow Town,2018,50 - 54 years,0,0,0
Wicklow Town,2018,55 - 59 years,0,1,1
Wicklow Town,2018,60 - 64 years,2,1,3
Wicklow Town,2018,65 - 69 years,1,1,2
Wicklow Town,2018,70 - 74 years,4,4,8
Wicklow Town,2018,75 - 79 years,9,3,12
Wicklow Town,2018,80 - 84 years,7,3,10
Wicklow Town,2018,85 years and over,6,10,16
Wicklow Town,2018,Under 1 year,0,0,0
Wicklow Town,2019,1 - 4 years,0,0,0
Wicklow Town,2019,10 - 14 years,0,0,0
Wicklow Town,2019,15 - 19 years,0,0,0
Wicklow Town,2019,20 - 24 years,0,0,0
Wicklow Town,2019,25 - 29 years,0,0,0
Wicklow Town,2019,30 - 34 years,1,0,1
Wicklow Town,2019,35 - 39 years,1,0,1
Wicklow Town,2019,40 - 44 years,0,0,0
Wicklow Town,2019,45 - 49 years,0,2,2
Wicklow Town,2019,5 - 9 years,0,0,0
Wicklow Town,2019,50 - 54 years,0,0,0
Wicklow Town,2019,55 - 59 years,0,1,1
Wicklow Town,2019,60 - 64 years,2,1,3
Wicklow Town,2019,65 - 69 years,1,1,2
Wicklow Town,2019,70 - 74 years,4,4,8
Wicklow Town,2019,75 - 79 years,9,3,12
Wicklow Town,2019,80 - 84 years,7,3,10
Wicklow Town,2019,85 years and over,6,10,16
Wicklow Town,2019,Under 1 year,0,0,0
Wicklow Town,2020,1 - 4 years,0,0,0
Wicklow Town,2020,10 - 14 years,0,0,0
Wicklow Town,2020,15 - 19 years,0,0,0
Wicklow Town,2020,20 - 24 years,0,0,0
Wicklow Town,2020,25 - 29 years,0,0,0
Wicklow Town,2020,30 - 34 years,1,0,1
Wicklow Town,2020,35 - 39 years,1,0,1
Wicklow Town,2020,40 - 44 years,0,0,0
Wicklow Town,2020,45 - 49 years,0,2,2
Wicklow Town,2020,5 - 9 years,0,0,0
Wicklow Town,2020,50 - 54 years,0,0,0
Wicklow Town,2020,55 - 59 years,0,1,1
Wicklow Town,2020,60 - 64 years,2,1,3
Wicklow Town,2020,65 - 69 years,1,1,2
Wicklow Town,2020,70 - 74 years,4,4,8
Wicklow Town,2020,75 - 79 years,9,3,12
Wicklow Town,2020,80 - 84 years,7,3,10
Wicklow Town,2020,85 years and over,6,10,16
Wicklow Town,2020,Under 1 year,0,0,0
Youghal Town,2007,1 - 4 years,0,0,0
Youghal Town,2007,10 - 14 years,0,0,0
Youghal Town,2007,15 - 19 years,0,0,0
Youghal Town,2007,20 - 24 years,0,0,0
Youghal Town,2007,25 - 29 years,0,1,1
Youghal Town,2007,30 - 34 years,0,0,0
Youghal Town,2007,35 - 39 years,0,0,0
Youghal Town,2007,40 - 44 years,0,0,0
Youghal Town,2007,45 - 49 years,1,0,1
Youghal Town,2007,5 - 9 years,0,0,0
Youghal Town,2007,50 - 54 years,1,2,3
Youghal Town,2007,55 - 59 years,2,3,5
Youghal Town,2007,60 - 64 years,3,4,7
Youghal Town,2007,65 - 69 years,2,1,3
Youghal Town,2007,70 - 74 years,4,1,5
Youghal Town,2007,75 - 79 years,5,11,16
Youghal Town,2007,80 - 84 years,6,3,9
Youghal Town,2007,85 years and over,5,6,11
Youghal Town,2007,Under 1 year,0,0,0
Youghal Town,2008,1 - 4 years,0,0,0
Youghal Town,2008,10 - 14 years,0,0,0
Youghal Town,2008,15 - 19 years,0,0,0
Youghal Town,2008,20 - 24 years,0,0,0
Youghal Town,2008,25 - 29 years,0,1,1
Youghal Town,2008,30 - 34 years,0,0,0
Youghal Town,2008,35 - 39 years,0,0,0
Youghal Town,2008,40 - 44 years,1,1,2
Youghal Town,2008,45 - 49 years,1,1,2
Youghal Town,2008,5 - 9 years,0,0,0
Youghal Town,2008,50 - 54 years,1,2,3
Youghal Town,2008,55 - 59 years,1,3,4
Youghal Town,2008,60 - 64 years,2,4,6
Youghal Town,2008,65 - 69 years,1,5,6
Youghal Town,2008,70 - 74 years,2,1,3
Youghal Town,2008,75 - 79 years,1,4,5
Youghal Town,2008,80 - 84 years,4,4,8
Youghal Town,2008,85 years and over,11,2,13
Youghal Town,2008,Under 1 year,0,1,1
Youghal Town,2009,1 - 4 years,0,0,0
Youghal Town,2009,10 - 14 years,0,0,0
Youghal Town,2009,15 - 19 years,0,0,0
Youghal Town,2009,20 - 24 years,0,0,0
Youghal Town,2009,25 - 29 years,0,1,1
Youghal Town,2009,30 - 34 years,2,0,2
Youghal Town,2009,35 - 39 years,0,0,0
Youghal Town,2009,40 - 44 years,1,1,2
Youghal Town,2009,45 - 49 years,1,2,3
Youghal Town,2009,5 - 9 years,0,0,0
Youghal Town,2009,50 - 54 years,1,2,3
Youghal Town,2009,55 - 59 years,1,1,2
Youghal Town,2009,60 - 64 years,2,3,5
Youghal Town,2009,65 - 69 years,1,1,2
Youghal Town,2009,70 - 74 years,2,1,3
Youghal Town,2009,75 - 79 years,4,2,6
Youghal Town,2009,80 - 84 years,2,3,5
Youghal Town,2009,85 years and over,4,4,8
Youghal Town,2009,Under 1 year,0,1,1
Youghal Town,2010,1 - 4 years,1,0,1
Youghal Town,2010,10 - 14 years,0,0,0
Youghal Town,2010,15 - 19 years,0,0,0
Youghal Town,2010,20 - 24 years,0,0,0
Youghal Town,2010,25 - 29 years,0,1,1
Youghal Town,2010,30 - 34 years,2,0,2
Youghal Town,2010,35 - 39 years,0,1,1
Youghal Town,2010,40 - 44 years,1,1,2
Youghal Town,2010,45 - 49 years,1,2,3
Youghal Town,2010,5 - 9 years,0,0,0
Youghal Town,2010,50 - 54 years,1,1,2
Youghal Town,2010,55 - 59 years,1,2,3
Youghal Town,2010,60 - 64 years,2,1,3
Youghal Town,2010,65 - 69 years,1,2,3
Youghal Town,2010,70 - 74 years,2,1,3
Youghal Town,2010,75 - 79 years,2,1,3
Youghal Town,2010,80 - 84 years,1,3,4
Youghal Town,2010,85 years and over,4,1,5
Youghal Town,2010,Under 1 year,0,1,1
Youghal Town,2011,1 - 4 years,0,0,0
Youghal Town,2011,10 - 14 years,0,0,0
Youghal Town,2011,15 - 19 years,0,0,0
Youghal Town,2011,20 - 24 years,0,0,0
Youghal Town,2011,25 - 29 years,0,2,2
Youghal Town,2011,30 - 34 years,0,3,3
Youghal Town,2011,35 - 39 years,0,0,0
Youghal Town,2011,40 - 44 years,3,1,4
Youghal Town,2011,45 - 49 years,0,1,1
Youghal Town,2011,5 - 9 years,0,0,0
Youghal Town,2011,50 - 54 years,1,1,2
Youghal Town,2011,55 - 59 years,0,2,2
Youghal Town,2011,60 - 64 years,1,2,3
Youghal Town,2011,65 - 69 years,4,7,11
Youghal Town,2011,70 - 74 years,2,3,5
Youghal Town,2011,75 - 79 years,1,3,4
Youghal Town,2011,80 - 84 years,2,3,5
Youghal Town,2011,85 years and over,11,4,15
Youghal Town,2011,Under 1 year,0,0,0
Youghal Town,2012,1 - 4 years,0,0,0
Youghal Town,2012,10 - 14 years,0,0,0
Youghal Town,2012,15 - 19 years,0,0,0
Youghal Town,2012,20 - 24 years,1,0,1
Youghal Town,2012,25 - 29 years,0,2,2
Youghal Town,2012,30 - 34 years,0,3,3
Youghal Town,2012,35 - 39 years,0,1,1
Youghal Town,2012,40 - 44 years,3,2,5
Youghal Town,2012,45 - 49 years,0,1,1
Youghal Town,2012,5 - 9 years,0,0,0
Youghal Town,2012,50 - 54 years,1,3,4
Youghal Town,2012,55 - 59 years,1,2,3
Youghal Town,2012,60 - 64 years,1,3,4
Youghal Town,2012,65 - 69 years,2,6,8
Youghal Town,2012,70 - 74 years,1,3,4
Youghal Town,2012,75 - 79 years,9,3,12
Youghal Town,2012,80 - 84 years,5,9,14
Youghal Town,2012,85 years and over,15,13,28
Youghal Town,2012,Under 1 year,0,0,0
Youghal Town,2013,1 - 4 years,0,0,0
Youghal Town,2013,10 - 14 years,0,1,1
Youghal Town,2013,15 - 19 years,0,0,0
Youghal Town,2013,20 - 24 years,0,0,0
Youghal Town,2013,25 - 29 years,0,0,0
Youghal Town,2013,30 - 34 years,1,1,2
Youghal Town,2013,35 - 39 years,0,2,2
Youghal Town,2013,40 - 44 years,1,3,4
Youghal Town,2013,45 - 49 years,1,0,1
Youghal Town,2013,5 - 9 years,0,0,0
Youghal Town,2013,50 - 54 years,0,0,0
Youghal Town,2013,55 - 59 years,1,1,2
Youghal Town,2013,60 - 64 years,1,2,3
Youghal Town,2013,65 - 69 years,1,3,4
Youghal Town,2013,70 - 74 years,4,2,6
Youghal Town,2013,75 - 79 years,4,3,7
Youghal Town,2013,80 - 84 years,5,5,10
Youghal Town,2013,85 years and over,13,4,17
Youghal Town,2013,Under 1 year,0,0,0
Youghal Town,2014,1 - 4 years,0,0,0
Youghal Town,2014,10 - 14 years,0,1,1
Youghal Town,2014,15 - 19 years,0,0,0
Youghal Town,2014,20 - 24 years,0,1,1
Youghal Town,2014,25 - 29 years,0,0,0
Youghal Town,2014,30 - 34 years,1,2,3
Youghal Town,2014,35 - 39 years,0,1,1
Youghal Town,2014,40 - 44 years,1,3,4
Youghal Town,2014,45 - 49 years,2,0,2
Youghal Town,2014,5 - 9 years,0,0,0
Youghal Town,2014,50 - 54 years,0,2,2
Youghal Town,2014,55 - 59 years,1,2,3
Youghal Town,2014,60 - 64 years,1,3,4
Youghal Town,2014,65 - 69 years,5,6,11
Youghal Town,2014,70 - 74 years,3,2,5
Youghal Town,2014,75 - 79 years,5,1,6
Youghal Town,2014,80 - 84 years,5,4,9
Youghal Town,2014,85 years and over,10,8,18
Youghal Town,2014,Under 1 year,0,0,0
Youghal Town,2015,1 - 4 years,0,0,0
Youghal Town,2015,10 - 14 years,0,1,1
Youghal Town,2015,15 - 19 years,0,0,0
Youghal Town,2015,20 - 24 years,0,1,1
Youghal Town,2015,25 - 29 years,0,0,0
Youghal Town,2015,30 - 34 years,1,2,3
Youghal Town,2015,35 - 39 years,0,1,1
Youghal Town,2015,40 - 44 years,1,3,4
Youghal Town,2015,45 - 49 years,2,0,2
Youghal Town,2015,5 - 9 years,0,0,0
Youghal Town,2015,50 - 54 years,0,2,2
Youghal Town,2015,55 - 59 years,1,2,3
Youghal Town,2015,60 - 64 years,1,3,4
Youghal Town,2015,65 - 69 years,5,6,11
Youghal Town,2015,70 - 74 years,3,2,5
Youghal Town,2015,75 - 79 years,5,1,6
Youghal Town,2015,80 - 84 years,5,4,9
Youghal Town,2015,85 years and over,10,8,18
Youghal Town,2015,Under 1 year,0,0,0
Youghal Town,2016,1 - 4 years,0,0,0
Youghal Town,2016,10 - 14 years,0,1,1
Youghal Town,2016,15 - 19 years,0,0,0
Youghal Town,2016,20 - 24 years,0,1,1
Youghal Town,2016,25 - 29 years,0,0,0
Youghal Town,2016,30 - 34 years,1,2,3
Youghal Town,2016,35 - 39 years,0,1,1
Youghal Town,2016,40 - 44 years,1,3,4
Youghal Town,2016,45 - 49 years,2,0,2
Youghal Town,2016,5 - 9 years,0,0,0
Youghal Town,2016,50 - 54 years,0,2,2
Youghal Town,2016,55 - 59 years,1,2,3
Youghal Town,2016,60 - 64 years,1,3,4
Youghal Town,2016,65 - 69 years,5,6,11
Youghal Town,2016,70 - 74 years,3,2,5
Youghal Town,2016,75 - 79 years,5,1,6
Youghal Town,2016,80 - 84 years,5,4,9
Youghal Town,2016,85 years and over,10,8,18
Youghal Town,2016,Under 1 year,0,0,0
Youghal Town,2017,1 - 4 years,0,0,0
Youghal Town,2017,10 - 14 years,0,1,1
Youghal Town,2017,15 - 19 years,0,0,0
Youghal Town,2017,20 - 24 years,0,1,1
Youghal Town,2017,25 - 29 years,0,1,1
Youghal Town,2017,30 - 34 years,1,2,3
Youghal Town,2017,35 - 39 years,0,1,1
Youghal Town,2017,40 - 44 years,1,3,4
Youghal Town,2017,45 - 49 years,2,1,3
Youghal Town,2017,5 - 9 years,0,0,0
Youghal Town,2017,50 - 54 years,0,1,1
Youghal Town,2017,55 - 59 years,2,2,4
Youghal Town,2017,60 - 64 years,4,2,6
Youghal Town,2017,65 - 69 years,4,3,7
Youghal Town,2017,70 - 74 years,2,2,4
Youghal Town,2017,75 - 79 years,4,7,11
Youghal Town,2017,80 - 84 years,10,4,14
Youghal Town,2017,85 years and over,7,12,19
Youghal Town,2017,Under 1 year,0,0,0
Youghal Town,2018,1 - 4 years,0,0,0
Youghal Town,2018,10 - 14 years,0,0,0
Youghal Town,2018,15 - 19 years,0,0,0
Youghal Town,2018,20 - 24 years,0,0,0
Youghal Town,2018,25 - 29 years,0,0,0
Youghal Town,2018,30 - 34 years,1,0,1
Youghal Town,2018,35 - 39 years,0,0,0
Youghal Town,2018,40 - 44 years,0,0,0
Youghal Town,2018,45 - 49 years,0,1,1
Youghal Town,2018,5 - 9 years,0,0,0
Youghal Town,2018,50 - 54 years,0,0,0
Youghal Town,2018,55 - 59 years,1,1,2
Youghal Town,2018,60 - 64 years,0,2,2
Youghal Town,2018,65 - 69 years,0,3,3
Youghal Town,2018,70 - 74 years,2,6,8
Youghal Town,2018,75 - 79 years,4,2,6
Youghal Town,2018,80 - 84 years,4,4,8
Youghal Town,2018,85 years and over,13,10,23
Youghal Town,2018,Under 1 year,0,0,0
Youghal Town,2019,1 - 4 years,0,0,0
Youghal Town,2019,10 - 14 years,0,0,0
Youghal Town,2019,15 - 19 years,0,0,0
Youghal Town,2019,20 - 24 years,0,0,0
Youghal Town,2019,25 - 29 years,0,0,0
Youghal Town,2019,30 - 34 years,1,0,1
Youghal Town,2019,35 - 39 years,0,0,0
Youghal Town,2019,40 - 44 years,0,0,0
Youghal Town,2019,45 - 49 years,0,1,1
Youghal Town,2019,5 - 9 years,0,0,0
Youghal Town,2019,50 - 54 years,0,0,0
Youghal Town,2019,55 - 59 years,1,1,2
Youghal Town,2019,60 - 64 years,0,2,2
Youghal Town,2019,65 - 69 years,0,3,3
Youghal Town,2019,70 - 74 years,2,6,8
Youghal Town,2019,75 - 79 years,4,2,6
Youghal Town,2019,80 - 84 years,4,4,8
Youghal Town,2019,85 years and over,13,10,23
Youghal Town,2019,Under 1 year,0,0,0
Youghal Town,2020,1 - 4 years,0,0,0
Youghal Town,2020,10 - 14 years,0,0,0
Youghal Town,2020,15 - 19 years,0,0,0
Youghal Town,2020,20 - 24 years,0,0,0
Youghal Town,2020,25 - 29 years,0,0,0
Youghal Town,2020,30 - 34 years,1,0,1
Youghal Town,2020,35 - 39 years,0,0,0
Youghal Town,2020,40 - 44 years,0,0,0
Youghal Town,2020,45 - 49 years,0,1,1
Youghal Town,2020,5 - 9 years,0,0,0
Youghal Town,2020,50 - 54 years,0,0,0
Youghal Town,2020,55 - 59 years,1,1,2
Youghal Town,2020,60 - 64 years,0,2,2
Youghal Town,2020,65 - 69 years,0,3,3
Youghal Town,2020,70 - 74 years,2,6,8
Youghal Town,2020,75 - 79 years,4,2,6
Youghal Town,2020,80 - 84 years,4,4,8
Youghal Town,2020,85 years and over,13,10,23
Youghal Town,2020,Under 1 year,0,0,0
